County FIPS,Test Date,POP_ESTIMATE_2018,sdi_score,New Positives,Cumulative Number of Positives,Total Number of Tests Performed,Cumulative Number of Tests Performed,Rolling Avg New Cases,Rolling Avg New Tests,Per Capita Rate - New Cases,Per Capita Rate - New Tests,sdi_quartile,sdi_quartile_label
36001,2020-03-02,307117,36,0,0,0,0,0.0,0.0,0.0,0.0,"(24.0, 37.5]",Q2
36001,2020-03-03,307117,36,0,0,0,0,0.0,0.0,0.0,0.0,"(24.0, 37.5]",Q2
36001,2020-03-04,307117,36,0,0,0,0,0.0,0.0,0.0,0.0,"(24.0, 37.5]",Q2
36001,2020-03-05,307117,36,0,0,3,3,0.0,3.0,0.0,0.9768264212010406,"(24.0, 37.5]",Q2
36001,2020-03-06,307117,36,0,0,0,3,0.0,0.0,0.0,0.0,"(24.0, 37.5]",Q2
36001,2020-03-07,307117,36,0,0,5,8,0.0,5.0,0.0,1.6280440353350676,"(24.0, 37.5]",Q2
36001,2020-03-08,307117,36,0,0,2,10,0.0,1.4285714285714286,0.0,0.46515543866716225,"(24.0, 37.5]",Q2
36001,2020-03-09,307117,36,0,0,3,13,0.0,1.8571428571428572,0.0,0.6047020702673109,"(24.0, 37.5]",Q2
36001,2020-03-10,307117,36,0,0,2,15,0.0,2.142857142857143,0.0,0.6977331580007433,"(24.0, 37.5]",Q2
36001,2020-03-11,307117,36,0,0,13,28,0.0,4.0,0.0,1.3024352282680542,"(24.0, 37.5]",Q2
36001,2020-03-12,307117,36,1,1,11,39,0.14285714285714285,5.142857142857143,0.04651554386671622,1.674559579201784,"(24.0, 37.5]",Q2
36001,2020-03-13,307117,36,2,3,26,65,0.42857142857142855,8.857142857142858,0.13954663160014866,2.883963719736406,"(24.0, 37.5]",Q2
36001,2020-03-14,307117,36,3,6,108,173,0.8571428571428571,23.571428571428573,0.2790932632002973,7.675064738008177,"(24.0, 37.5]",Q2
36001,2020-03-15,307117,36,6,12,108,281,1.7142857142857142,38.714285714285715,0.5581865264005946,12.605712387880097,"(24.0, 37.5]",Q2
36001,2020-03-16,307117,36,11,23,140,421,3.2857142857142856,58.285714285714285,1.069857508934473,18.97834189762022,"(24.0, 37.5]",Q2
36001,2020-03-17,307117,36,13,36,267,688,5.142857142857143,96.14285714285714,1.674559579201784,31.304961022300013,"(24.0, 37.5]",Q2
36001,2020-03-18,307117,36,7,43,331,1019,6.142857142857143,141.57142857142858,2.0001683862687973,46.09690397191578,"(24.0, 37.5]",Q2
36001,2020-03-19,307117,36,18,61,450,1469,8.571428571428571,204.28571428571428,2.7909326320029733,66.51722772940418,"(24.0, 37.5]",Q2
36001,2020-03-20,307117,36,27,88,499,1968,12.142857142857142,271.85714285714283,3.9538212286708787,88.51907997836096,"(24.0, 37.5]",Q2
36001,2020-03-21,307117,36,35,123,577,2545,16.714285714285715,338.85714285714283,5.442318632405798,110.33487005185087,"(24.0, 37.5]",Q2
36001,2020-03-22,307117,36,4,127,197,2742,16.428571428571427,351.57142857142856,5.3492875446723644,114.47475345598862,"(24.0, 37.5]",Q2
36001,2020-03-23,307117,36,19,146,144,2886,17.571428571428573,352.14285714285717,5.721411895606096,114.66081563145549,"(24.0, 37.5]",Q2
36001,2020-03-24,307117,36,6,152,198,3084,16.571428571428573,342.2857142857143,5.395803088539083,111.45124310465205,"(24.0, 37.5]",Q2
36001,2020-03-25,307117,36,19,171,93,3177,18.285714285714285,308.2857142857143,5.953989614939676,100.38054366437362,"(24.0, 37.5]",Q2
36001,2020-03-26,307117,36,16,187,112,3289,18.0,260.0,5.860958527206244,84.65828983742352,"(24.0, 37.5]",Q2
36001,2020-03-27,307117,36,8,195,101,3390,15.285714285714286,203.14285714285714,4.977163193738636,66.14510337847047,"(24.0, 37.5]",Q2
36001,2020-03-28,307117,36,10,205,73,3463,11.714285714285714,131.14285714285714,3.81427459707073,42.701269269645486,"(24.0, 37.5]",Q2
36001,2020-03-29,307117,36,12,217,61,3524,12.857142857142858,111.71428571428571,4.18639894800446,36.37515530377208,"(24.0, 37.5]",Q2
36001,2020-03-30,307117,36,9,226,72,3596,11.428571428571429,101.42857142857143,3.721243509337298,33.026036145368515,"(24.0, 37.5]",Q2
36001,2020-03-31,307117,36,14,240,108,3704,12.571428571428571,88.57142857142857,4.0933678602710275,28.83963719736406,"(24.0, 37.5]",Q2
36001,2020-04-01,307117,36,13,253,106,3810,11.714285714285714,90.42857142857143,3.81427459707073,29.44433926763137,"(24.0, 37.5]",Q2
36001,2020-04-02,307117,36,14,267,105,3915,11.428571428571429,89.42857142857143,3.721243509337298,29.118730460564354,"(24.0, 37.5]",Q2
36001,2020-04-03,307117,36,26,293,123,4038,14.0,92.57142857142857,4.55852329893819,30.142072425632108,"(24.0, 37.5]",Q2
36001,2020-04-04,307117,36,12,305,117,4155,14.285714285714286,98.85714285714286,4.651554386671622,32.18875635576762,"(24.0, 37.5]",Q2
36001,2020-04-05,307117,36,14,319,89,4244,14.571428571428571,102.85714285714286,4.744585474405055,33.49119158403568,"(24.0, 37.5]",Q2
36001,2020-04-06,307117,36,14,333,86,4330,15.285714285714286,104.85714285714286,4.977163193738636,34.14240919816971,"(24.0, 37.5]",Q2
36001,2020-04-07,307117,36,9,342,74,4404,14.571428571428571,100.0,4.744585474405055,32.560880706701354,"(24.0, 37.5]",Q2
36001,2020-04-08,307117,36,37,379,229,4633,18.0,117.57142857142857,5.860958527206244,38.28229260230745,"(24.0, 37.5]",Q2
36001,2020-04-09,307117,36,47,426,332,4965,22.714285714285715,150.0,7.3959714748078795,48.84132106005204,"(24.0, 37.5]",Q2
36001,2020-04-10,307117,36,20,446,159,5124,21.857142857142858,155.14285714285714,7.116878211607582,50.515880639253815,"(24.0, 37.5]",Q2
36001,2020-04-11,307117,36,32,478,223,5347,24.714285714285715,170.28571428571428,8.047189088941906,55.44652828912574,"(24.0, 37.5]",Q2
36001,2020-04-12,307117,36,21,499,193,5540,25.714285714285715,185.14285714285714,8.37279789600892,60.284144851264216,"(24.0, 37.5]",Q2
36001,2020-04-13,307117,36,36,535,216,5756,28.857142857142858,203.71428571428572,9.396139861076676,66.33116555393732,"(24.0, 37.5]",Q2
36001,2020-04-14,307117,36,13,548,106,5862,29.428571428571427,208.28571428571428,9.582202036543542,67.81966295767225,"(24.0, 37.5]",Q2
36001,2020-04-15,307117,36,33,581,301,6163,28.857142857142858,218.57142857142858,9.396139861076676,71.16878211607582,"(24.0, 37.5]",Q2
36001,2020-04-16,307117,36,38,619,273,6436,27.571428571428573,210.14285714285714,8.977499966276232,68.42436502793956,"(24.0, 37.5]",Q2
36001,2020-04-17,307117,36,29,648,291,6727,28.857142857142858,229.0,9.396139861076676,74.5644168183461,"(24.0, 37.5]",Q2
36001,2020-04-18,307117,36,34,682,305,7032,29.142857142857142,240.71428571428572,9.48917094881011,78.37869141541684,"(24.0, 37.5]",Q2
36001,2020-04-19,307117,36,5,687,103,7135,26.857142857142858,227.85714285714286,8.74492224694265,74.19229246741237,"(24.0, 37.5]",Q2
36001,2020-04-20,307117,36,17,704,164,7299,24.142857142857142,220.42857142857142,7.861126913475041,71.77348418634313,"(24.0, 37.5]",Q2
36001,2020-04-21,307117,36,33,737,236,7535,27.0,239.0,8.791437790809365,77.82050488901623,"(24.0, 37.5]",Q2
36001,2020-04-22,307117,36,21,758,178,7713,25.285714285714285,221.42857142857142,8.233251264408771,72.09909299341014,"(24.0, 37.5]",Q2
36001,2020-04-23,307117,36,47,805,319,8032,26.571428571428573,228.0,8.651891159209217,74.23880801127909,"(24.0, 37.5]",Q2
36001,2020-04-24,307117,36,94,899,626,8658,35.857142857142854,275.85714285714283,11.675401510545772,89.82151520662902,"(24.0, 37.5]",Q2
36001,2020-04-25,307117,36,49,948,402,9060,38.0,289.7142857142857,12.373134668546514,94.3335229617005,"(24.0, 37.5]",Q2
36001,2020-04-26,307117,36,31,979,263,9323,41.714285714285715,312.57142857142856,13.582538809081136,101.7760099803751,"(24.0, 37.5]",Q2
36001,2020-04-27,307117,36,30,1009,197,9520,43.57142857142857,317.2857142857143,14.187240879348447,103.31102292797674,"(24.0, 37.5]",Q2
36001,2020-04-28,307117,36,58,1067,351,9871,47.142857142857146,333.7142857142857,15.350129476016354,108.66031047264909,"(24.0, 37.5]",Q2
36001,2020-04-29,307117,36,98,1165,439,10310,58.142857142857146,371.0,18.931826353753504,120.80086742186202,"(24.0, 37.5]",Q2
36001,2020-04-30,307117,36,39,1204,378,10688,57.0,379.42857142857144,18.559702002819773,123.5452845099983,"(24.0, 37.5]",Q2
36001,2020-05-01,307117,36,34,1238,434,11122,48.42857142857143,352.0,15.7687693708168,114.61430008758877,"(24.0, 37.5]",Q2
36001,2020-05-02,307117,36,20,1258,441,11563,44.285714285714285,357.57142857142856,14.41981859868203,116.4284062983907,"(24.0, 37.5]",Q2
36001,2020-05-03,307117,36,29,1287,391,11954,44.0,375.85714285714283,14.326787510948597,122.38239591333038,"(24.0, 37.5]",Q2
36001,2020-05-04,307117,36,7,1294,130,12084,40.714285714285715,366.2857142857143,13.256930002014125,119.2658544742604,"(24.0, 37.5]",Q2
36001,2020-05-05,307117,36,27,1321,367,12451,36.285714285714285,368.57142857142856,11.81494814214592,120.01010317612784,"(24.0, 37.5]",Q2
36001,2020-05-06,307117,36,27,1348,407,12858,26.142857142857142,364.0,8.512344527609068,118.52160577239293,"(24.0, 37.5]",Q2
36001,2020-05-07,307117,36,36,1384,385,13243,25.714285714285715,365.0,8.37279789600892,118.84721457945993,"(24.0, 37.5]",Q2
36001,2020-05-08,307117,36,32,1416,488,13731,25.428571428571427,372.7142857142857,8.279766808275486,121.35905394826261,"(24.0, 37.5]",Q2
36001,2020-05-09,307117,36,16,1432,455,14186,24.857142857142858,374.7142857142857,8.093704632808622,122.01027156239665,"(24.0, 37.5]",Q2
36001,2020-05-10,307117,36,24,1456,384,14570,24.142857142857142,373.7142857142857,7.861126913475041,121.68466275532964,"(24.0, 37.5]",Q2
36001,2020-05-11,307117,36,23,1479,341,14911,26.428571428571427,403.85714285714283,8.605375615342501,131.49944251120675,"(24.0, 37.5]",Q2
36001,2020-05-12,307117,36,15,1494,335,15246,24.714285714285715,399.2857142857143,8.047189088941906,130.01094510747183,"(24.0, 37.5]",Q2
36001,2020-05-13,307117,36,15,1509,546,15792,23.0,419.14285714285717,7.4890025625413115,136.4766057049454,"(24.0, 37.5]",Q2
36001,2020-05-14,307117,36,29,1538,541,16333,22.0,441.42857142857144,7.163393755474298,143.73303054815312,"(24.0, 37.5]",Q2
36001,2020-05-15,307117,36,34,1572,482,16815,22.285714285714285,440.57142857142856,7.256424843207729,143.45393728495281,"(24.0, 37.5]",Q2
36001,2020-05-16,307117,36,7,1579,411,17226,21.0,434.2857142857143,6.837784948407284,141.4072533548173,"(24.0, 37.5]",Q2
36001,2020-05-17,307117,36,31,1610,342,17568,22.0,428.2857142857143,7.163393755474298,139.45360051241522,"(24.0, 37.5]",Q2
36001,2020-05-18,307117,36,45,1655,398,17966,25.142857142857142,436.42857142857144,8.186735720542055,142.10498651281807,"(24.0, 37.5]",Q2
36001,2020-05-19,307117,36,27,1682,697,18663,26.857142857142858,488.14285714285717,8.74492224694265,158.94361339256932,"(24.0, 37.5]",Q2
36001,2020-05-20,307117,36,18,1700,650,19313,27.285714285714285,503.0,8.884468878542798,163.7812299547078,"(24.0, 37.5]",Q2
36001,2020-05-21,307117,36,56,1756,920,20233,31.142857142857142,557.1428571428571,10.140388562944135,181.41062108019327,"(24.0, 37.5]",Q2
36001,2020-05-22,307117,36,14,1770,655,20888,28.285714285714285,581.8571428571429,9.21007768560981,189.45781016913517,"(24.0, 37.5]",Q2
36001,2020-05-23,307117,36,12,1782,438,21326,29.0,585.7142857142857,9.442655404943393,190.7137298535365,"(24.0, 37.5]",Q2
36001,2020-05-24,307117,36,9,1791,378,21704,25.857142857142858,590.8571428571429,8.419313439875637,192.3882894327383,"(24.0, 37.5]",Q2
36001,2020-05-25,307117,36,2,1793,328,22032,19.714285714285715,580.8571428571429,6.419145053606838,189.13220136206817,"(24.0, 37.5]",Q2
36001,2020-05-26,307117,36,3,1796,369,22401,16.285714285714285,534.0,5.302772000805649,173.87510297378523,"(24.0, 37.5]",Q2
36001,2020-05-27,307117,36,18,1814,666,23067,16.285714285714285,536.2857142857143,5.302772000805649,174.61935167565272,"(24.0, 37.5]",Q2
36001,2020-05-28,307117,36,20,1834,416,23483,11.142857142857142,464.2857142857143,3.6282124216038647,151.1755175668277,"(24.0, 37.5]",Q2
36001,2020-05-29,307117,36,9,1843,521,24004,10.428571428571429,445.14285714285717,3.395634702270284,144.94243468868774,"(24.0, 37.5]",Q2
36001,2020-05-30,307117,36,17,1860,760,24764,11.142857142857142,491.14285714285717,3.6282124216038647,159.92043981377037,"(24.0, 37.5]",Q2
36001,2020-05-31,307117,36,22,1882,537,25301,13.0,513.8571428571429,4.232914491871177,167.31641128857825,"(24.0, 37.5]",Q2
36001,2020-06-01,307117,36,18,1900,618,25919,15.285714285714286,555.2857142857143,4.977163193738636,180.805919009926,"(24.0, 37.5]",Q2
36001,2020-06-02,307117,36,20,1920,1170,27089,17.714285714285715,669.7142857142857,5.767927439472812,218.06486964716564,"(24.0, 37.5]",Q2
36001,2020-06-03,307117,36,10,1930,817,27906,16.571428571428573,691.2857142857143,5.395803088539083,225.0887167710398,"(24.0, 37.5]",Q2
36001,2020-06-04,307117,36,11,1941,1179,29085,15.285714285714286,800.2857142857143,4.977163193738636,260.58007674134427,"(24.0, 37.5]",Q2
36001,2020-06-05,307117,36,12,1953,1164,30249,15.714285714285714,892.1428571428571,5.116709825338784,290.4895714476428,"(24.0, 37.5]",Q2
36001,2020-06-06,307117,36,8,1961,751,31000,14.428571428571429,890.8571428571429,4.698069930538338,290.07093155284235,"(24.0, 37.5]",Q2
36001,2020-06-07,307117,36,17,1978,1194,32194,13.714285714285714,984.7142857142857,4.465492211204757,320.63164387327487,"(24.0, 37.5]",Q2
36003,2020-03-02,46430,44,0,0,0,0,0.0,0.0,0.0,0.0,"(37.5, 52.0]",Q3
36003,2020-03-03,46430,44,0,0,0,0,0.0,0.0,0.0,0.0,"(37.5, 52.0]",Q3
36003,2020-03-04,46430,44,0,0,0,0,0.0,0.0,0.0,0.0,"(37.5, 52.0]",Q3
36003,2020-03-05,46430,44,0,0,0,0,0.0,0.0,0.0,0.0,"(37.5, 52.0]",Q3
36003,2020-03-06,46430,44,0,0,0,0,0.0,0.0,0.0,0.0,"(37.5, 52.0]",Q3
36003,2020-03-07,46430,44,0,0,0,0,0.0,0.0,0.0,0.0,"(37.5, 52.0]",Q3
36003,2020-03-08,46430,44,0,0,0,0,0.0,0.0,0.0,0.0,"(37.5, 52.0]",Q3
36003,2020-03-09,46430,44,0,0,0,0,0.0,0.0,0.0,0.0,"(37.5, 52.0]",Q3
36003,2020-03-10,46430,44,0,0,0,0,0.0,0.0,0.0,0.0,"(37.5, 52.0]",Q3
36003,2020-03-11,46430,44,0,0,4,4,0.0,0.5714285714285714,0.0,1.230731362111935,"(37.5, 52.0]",Q3
36003,2020-03-12,46430,44,0,0,1,5,0.0,0.7142857142857143,0.0,1.5384142026399186,"(37.5, 52.0]",Q3
36003,2020-03-13,46430,44,0,0,0,5,0.0,0.7142857142857143,0.0,1.5384142026399186,"(37.5, 52.0]",Q3
36003,2020-03-14,46430,44,0,0,1,6,0.0,0.8571428571428571,0.0,1.8460970431679025,"(37.5, 52.0]",Q3
36003,2020-03-15,46430,44,2,2,5,11,0.2857142857142857,1.5714285714285714,0.6153656810559675,3.3845112458078215,"(37.5, 52.0]",Q3
36003,2020-03-16,46430,44,0,2,1,12,0.2857142857142857,1.7142857142857142,0.6153656810559675,3.692194086335805,"(37.5, 52.0]",Q3
36003,2020-03-17,46430,44,0,2,0,12,0.2857142857142857,1.7142857142857142,0.6153656810559675,3.692194086335805,"(37.5, 52.0]",Q3
36003,2020-03-18,46430,44,0,2,3,15,0.2857142857142857,1.5714285714285714,0.6153656810559675,3.3845112458078215,"(37.5, 52.0]",Q3
36003,2020-03-19,46430,44,0,2,2,17,0.2857142857142857,1.7142857142857142,0.6153656810559675,3.692194086335805,"(37.5, 52.0]",Q3
36003,2020-03-20,46430,44,0,2,10,27,0.2857142857142857,3.142857142857143,0.6153656810559675,6.769022491615643,"(37.5, 52.0]",Q3
36003,2020-03-21,46430,44,0,2,10,37,0.2857142857142857,4.428571428571429,0.6153656810559675,9.538168056367496,"(37.5, 52.0]",Q3
36003,2020-03-22,46430,44,0,2,39,76,0.0,9.285714285714286,0.0,19.999384634318947,"(37.5, 52.0]",Q3
36003,2020-03-23,46430,44,0,2,2,78,0.0,9.428571428571429,0.0,20.307067474846928,"(37.5, 52.0]",Q3
36003,2020-03-24,46430,44,0,2,5,83,0.0,10.142857142857142,0.0,21.845481677486845,"(37.5, 52.0]",Q3
36003,2020-03-25,46430,44,0,2,6,89,0.0,10.571428571428571,0.0,22.7685301990708,"(37.5, 52.0]",Q3
36003,2020-03-26,46430,44,0,2,9,98,0.0,11.571428571428571,0.0,24.922310082766682,"(37.5, 52.0]",Q3
36003,2020-03-27,46430,44,0,2,4,102,0.0,10.714285714285714,0.0,23.07621303959878,"(37.5, 52.0]",Q3
36003,2020-03-28,46430,44,4,6,12,114,0.5714285714285714,11.0,1.230731362111935,23.69157872065475,"(37.5, 52.0]",Q3
36003,2020-03-29,46430,44,1,7,7,121,0.7142857142857143,6.428571428571429,1.5384142026399186,13.845727823759269,"(37.5, 52.0]",Q3
36003,2020-03-30,46430,44,0,7,4,125,0.7142857142857143,6.714285714285714,1.5384142026399186,14.461093504815237,"(37.5, 52.0]",Q3
36003,2020-03-31,46430,44,2,9,10,135,1.0,7.428571428571429,2.1537798836958864,15.999507707455157,"(37.5, 52.0]",Q3
36003,2020-04-01,46430,44,3,12,14,149,1.4285714285714286,8.571428571428571,3.076828405279837,18.460970431679023,"(37.5, 52.0]",Q3
36003,2020-04-02,46430,44,2,14,18,167,1.7142857142857142,9.857142857142858,3.692194086335805,21.230115996430882,"(37.5, 52.0]",Q3
36003,2020-04-03,46430,44,2,16,13,180,2.0,11.142857142857142,4.307559767391773,23.99926156118273,"(37.5, 52.0]",Q3
36003,2020-04-04,46430,44,0,16,8,188,1.4285714285714286,10.571428571428571,3.076828405279837,22.7685301990708,"(37.5, 52.0]",Q3
36003,2020-04-05,46430,44,1,17,8,196,1.4285714285714286,10.714285714285714,3.076828405279837,23.07621303959878,"(37.5, 52.0]",Q3
36003,2020-04-06,46430,44,0,17,3,199,1.4285714285714286,10.571428571428571,3.076828405279837,22.7685301990708,"(37.5, 52.0]",Q3
36003,2020-04-07,46430,44,4,21,16,215,1.7142857142857142,11.428571428571429,3.692194086335805,24.614627242238697,"(37.5, 52.0]",Q3
36003,2020-04-08,46430,44,1,22,12,227,1.4285714285714286,11.142857142857142,3.076828405279837,23.99926156118273,"(37.5, 52.0]",Q3
36003,2020-04-09,46430,44,4,26,21,248,1.7142857142857142,11.571428571428571,3.692194086335805,24.922310082766682,"(37.5, 52.0]",Q3
36003,2020-04-10,46430,44,0,26,16,264,1.4285714285714286,12.0,3.076828405279837,25.845358604350636,"(37.5, 52.0]",Q3
36003,2020-04-11,46430,44,0,26,11,275,1.4285714285714286,12.428571428571429,3.076828405279837,26.768407125934587,"(37.5, 52.0]",Q3
36003,2020-04-12,46430,44,0,26,5,280,1.2857142857142858,12.0,2.7691455647518537,25.845358604350636,"(37.5, 52.0]",Q3
36003,2020-04-13,46430,44,2,28,14,294,1.5714285714285714,13.571428571428571,3.3845112458078215,29.229869850158455,"(37.5, 52.0]",Q3
36003,2020-04-14,46430,44,0,28,10,304,1.0,12.714285714285714,2.1537798836958864,27.38377280699055,"(37.5, 52.0]",Q3
36003,2020-04-15,46430,44,0,28,8,312,0.8571428571428571,12.142857142857142,1.8460970431679025,26.153041444878617,"(37.5, 52.0]",Q3
36003,2020-04-16,46430,44,1,29,21,333,0.42857142857142855,12.142857142857142,0.9230485215839512,26.153041444878617,"(37.5, 52.0]",Q3
36003,2020-04-17,46430,44,1,30,15,348,0.5714285714285714,12.0,1.230731362111935,25.845358604350636,"(37.5, 52.0]",Q3
36003,2020-04-18,46430,44,0,30,7,355,0.5714285714285714,11.428571428571429,1.230731362111935,24.614627242238697,"(37.5, 52.0]",Q3
36003,2020-04-19,46430,44,0,30,5,360,0.5714285714285714,11.428571428571429,1.230731362111935,24.614627242238697,"(37.5, 52.0]",Q3
36003,2020-04-20,46430,44,0,30,9,369,0.2857142857142857,10.714285714285714,0.6153656810559675,23.07621303959878,"(37.5, 52.0]",Q3
36003,2020-04-21,46430,44,0,30,10,379,0.2857142857142857,10.714285714285714,0.6153656810559675,23.07621303959878,"(37.5, 52.0]",Q3
36003,2020-04-22,46430,44,0,30,14,393,0.2857142857142857,11.571428571428571,0.6153656810559675,24.922310082766682,"(37.5, 52.0]",Q3
36003,2020-04-23,46430,44,1,31,10,403,0.2857142857142857,10.0,0.6153656810559675,21.537798836958864,"(37.5, 52.0]",Q3
36003,2020-04-24,46430,44,4,35,61,464,0.7142857142857143,16.571428571428573,1.5384142026399186,35.69120950124612,"(37.5, 52.0]",Q3
36003,2020-04-25,46430,44,0,35,12,476,0.7142857142857143,17.285714285714285,1.5384142026399186,37.229623703886034,"(37.5, 52.0]",Q3
36003,2020-04-26,46430,44,0,35,9,485,0.7142857142857143,17.857142857142858,1.5384142026399186,38.46035506599797,"(37.5, 52.0]",Q3
36003,2020-04-27,46430,44,0,35,14,499,0.7142857142857143,18.571428571428573,1.5384142026399186,39.99876926863789,"(37.5, 52.0]",Q3
36003,2020-04-28,46430,44,0,35,26,525,0.7142857142857143,20.857142857142858,1.5384142026399186,44.92169471708563,"(37.5, 52.0]",Q3
36003,2020-04-29,46430,44,0,35,18,543,0.7142857142857143,21.428571428571427,1.5384142026399186,46.15242607919756,"(37.5, 52.0]",Q3
36003,2020-04-30,46430,44,0,35,20,563,0.5714285714285714,22.857142857142858,1.230731362111935,49.229254484477394,"(37.5, 52.0]",Q3
36003,2020-05-01,46430,44,0,35,11,574,0.0,15.714285714285714,0.0,33.84511245807821,"(37.5, 52.0]",Q3
36003,2020-05-02,46430,44,0,35,18,592,0.0,16.571428571428573,0.0,35.69120950124612,"(37.5, 52.0]",Q3
36003,2020-05-03,46430,44,0,35,14,606,0.0,17.285714285714285,0.0,37.229623703886034,"(37.5, 52.0]",Q3
36003,2020-05-04,46430,44,0,35,31,637,0.0,19.714285714285715,0.0,42.460231992861765,"(37.5, 52.0]",Q3
36003,2020-05-05,46430,44,0,35,22,659,0.0,19.142857142857142,0.0,41.229500630749826,"(37.5, 52.0]",Q3
36003,2020-05-06,46430,44,0,35,40,699,0.0,22.285714285714285,0.0,47.99852312236546,"(37.5, 52.0]",Q3
36003,2020-05-07,46430,44,0,35,33,732,0.0,24.142857142857142,0.0,51.998400049229254,"(37.5, 52.0]",Q3
36003,2020-05-08,46430,44,0,35,18,750,0.0,25.142857142857142,0.0,54.152179932925144,"(37.5, 52.0]",Q3
36003,2020-05-09,46430,44,1,36,20,770,0.14285714285714285,25.428571428571427,0.3076828405279837,54.7675456139811,"(37.5, 52.0]",Q3
36003,2020-05-10,46430,44,2,38,35,805,0.42857142857142855,28.428571428571427,0.9230485215839512,61.22888526506877,"(37.5, 52.0]",Q3
36003,2020-05-11,46430,44,4,42,41,846,1.0,29.857142857142858,2.1537798836958864,64.30571367034861,"(37.5, 52.0]",Q3
36003,2020-05-12,46430,44,2,44,39,885,1.2857142857142858,32.285714285714285,2.7691455647518537,69.53632195932433,"(37.5, 52.0]",Q3
36003,2020-05-13,46430,44,0,44,53,938,1.2857142857142858,34.142857142857146,2.7691455647518537,73.53619888618813,"(37.5, 52.0]",Q3
36003,2020-05-14,46430,44,0,44,44,982,1.2857142857142858,35.714285714285715,2.7691455647518537,76.92071013199595,"(37.5, 52.0]",Q3
36003,2020-05-15,46430,44,0,44,27,1009,1.2857142857142858,37.0,2.7691455647518537,79.68985569674778,"(37.5, 52.0]",Q3
36003,2020-05-16,46430,44,0,44,36,1045,1.1428571428571428,39.285714285714285,2.46146272422387,84.61278114519553,"(37.5, 52.0]",Q3
36003,2020-05-17,46430,44,0,44,89,1134,0.8571428571428571,47.0,1.8460970431679025,101.22765453370667,"(37.5, 52.0]",Q3
36003,2020-05-18,46430,44,0,44,28,1162,0.2857142857142857,45.142857142857146,0.6153656810559675,97.22777760684288,"(37.5, 52.0]",Q3
36003,2020-05-19,46430,44,0,44,49,1211,0.0,46.57142857142857,0.0,100.3046060121227,"(37.5, 52.0]",Q3
36003,2020-05-20,46430,44,0,44,68,1279,0.0,48.714285714285715,0.0,104.91984862004246,"(37.5, 52.0]",Q3
36003,2020-05-21,46430,44,0,44,47,1326,0.0,49.142857142857146,0.0,105.84289714162642,"(37.5, 52.0]",Q3
36003,2020-05-22,46430,44,0,44,26,1352,0.0,49.0,0.0,105.53521430109842,"(37.5, 52.0]",Q3
36003,2020-05-23,46430,44,0,44,33,1385,0.0,48.57142857142857,0.0,104.61216577951447,"(37.5, 52.0]",Q3
36003,2020-05-24,46430,44,0,44,53,1438,0.0,43.42857142857143,0.0,93.53558352050707,"(37.5, 52.0]",Q3
36003,2020-05-25,46430,44,0,44,28,1466,0.0,43.42857142857143,0.0,93.53558352050707,"(37.5, 52.0]",Q3
36003,2020-05-26,46430,44,1,45,96,1562,0.14285714285714285,50.142857142857146,0.3076828405279837,107.99667702532231,"(37.5, 52.0]",Q3
36003,2020-05-27,46430,44,0,45,98,1660,0.14285714285714285,54.42857142857143,0.3076828405279837,117.22716224116182,"(37.5, 52.0]",Q3
36003,2020-05-28,46430,44,0,45,60,1720,0.14285714285714285,56.285714285714285,0.3076828405279837,121.2270391680256,"(37.5, 52.0]",Q3
36003,2020-05-29,46430,44,0,45,64,1784,0.14285714285714285,61.714285714285715,0.3076828405279837,132.918987108089,"(37.5, 52.0]",Q3
36003,2020-05-30,46430,44,0,45,51,1835,0.14285714285714285,64.28571428571429,0.3076828405279837,138.4572782375927,"(37.5, 52.0]",Q3
36003,2020-05-31,46430,44,3,48,100,1935,0.5714285714285714,71.0,1.230731362111935,152.91837174240794,"(37.5, 52.0]",Q3
36003,2020-06-01,46430,44,0,48,160,2095,0.5714285714285714,89.85714285714286,1.230731362111935,193.53250669210178,"(37.5, 52.0]",Q3
36003,2020-06-02,46430,44,1,49,181,2276,0.5714285714285714,102.0,1.230731362111935,219.6855481369804,"(37.5, 52.0]",Q3
36003,2020-06-03,46430,44,0,49,131,2407,0.5714285714285714,106.71428571428571,1.230731362111935,229.83908187440386,"(37.5, 52.0]",Q3
36003,2020-06-04,46430,44,2,51,154,2561,0.8571428571428571,120.14285714285714,1.8460970431679025,258.76126888403434,"(37.5, 52.0]",Q3
36003,2020-06-05,46430,44,0,51,309,2870,0.8571428571428571,155.14285714285714,1.8460970431679025,334.14356481339036,"(37.5, 52.0]",Q3
36003,2020-06-06,46430,44,0,51,98,2968,0.8571428571428571,161.85714285714286,1.8460970431679025,348.6046583182056,"(37.5, 52.0]",Q3
36003,2020-06-07,46430,44,0,51,149,3117,0.42857142857142855,168.85714285714286,0.9230485215839512,363.68111750407684,"(37.5, 52.0]",Q3
36005,2020-03-02,1432132,100,0,0,0,0,0.0,0.0,0.0,0.0,"(52.0, 100.0]",Q4
36005,2020-03-03,1432132,100,0,0,1,1,0.0,1.0,0.0,0.06982596576293247,"(52.0, 100.0]",Q4
36005,2020-03-04,1432132,100,0,0,0,1,0.0,0.0,0.0,0.0,"(52.0, 100.0]",Q4
36005,2020-03-05,1432132,100,0,0,5,6,0.0,5.0,0.0,0.3491298288146623,"(52.0, 100.0]",Q4
36005,2020-03-06,1432132,100,0,0,6,12,0.0,6.0,0.0,0.4189557945775948,"(52.0, 100.0]",Q4
36005,2020-03-07,1432132,100,0,0,17,29,0.0,17.0,0.0,1.187041417969852,"(52.0, 100.0]",Q4
36005,2020-03-08,1432132,100,1,1,16,45,0.14285714285714285,6.428571428571429,0.00997513796613321,0.4488812084759945,"(52.0, 100.0]",Q4
36005,2020-03-09,1432132,100,4,5,31,76,0.7142857142857143,10.857142857142858,0.049875689830666044,0.7581104854261239,"(52.0, 100.0]",Q4
36005,2020-03-10,1432132,100,0,5,47,123,0.7142857142857143,17.428571428571427,0.049875689830666044,1.2169668318682514,"(52.0, 100.0]",Q4
36005,2020-03-11,1432132,100,2,7,31,154,1.0,21.857142857142858,0.06982596576293247,1.526196108818381,"(52.0, 100.0]",Q4
36005,2020-03-12,1432132,100,3,10,36,190,1.4285714285714286,26.285714285714285,0.09975137966133209,1.8354253857685103,"(52.0, 100.0]",Q4
36005,2020-03-13,1432132,100,10,20,99,289,2.857142857142857,39.57142857142857,0.19950275932266417,2.763113216618899,"(52.0, 100.0]",Q4
36005,2020-03-14,1432132,100,8,28,80,369,4.0,48.57142857142857,0.2793038630517299,3.3915469084852914,"(52.0, 100.0]",Q4
36005,2020-03-15,1432132,100,29,57,116,485,8.0,62.857142857142854,0.5586077261034598,4.389060705098612,"(52.0, 100.0]",Q4
36005,2020-03-16,1432132,100,29,86,151,636,11.571428571428571,80.0,0.80798617525679,5.586077261034597,"(52.0, 100.0]",Q4
36005,2020-03-17,1432132,100,123,209,433,1069,29.142857142857142,135.14285714285714,2.034928145091175,9.436480515962016,"(52.0, 100.0]",Q4
36005,2020-03-18,1432132,100,154,363,597,1666,50.857142857142854,216.0,3.551149115943422,15.082408604793414,"(52.0, 100.0]",Q4
36005,2020-03-19,1432132,100,191,554,605,2271,77.71428571428571,297.2857142857143,5.426475053576466,20.75826210752321,"(52.0, 100.0]",Q4
36005,2020-03-20,1432132,100,297,851,884,3155,118.71428571428571,409.42857142857144,8.289339649856696,28.58874541093778,"(52.0, 100.0]",Q4
36005,2020-03-21,1432132,100,367,1218,1044,4199,170.0,547.1428571428571,11.87041417969852,38.20477841029019,"(52.0, 100.0]",Q4
36005,2020-03-22,1432132,100,606,1824,1276,5475,252.42857142857142,712.8571428571429,17.62606878615738,49.77593845100471,"(52.0, 100.0]",Q4
36005,2020-03-23,1432132,100,455,2279,970,6445,313.2857142857143,829.8571428571429,21.875477559730125,57.94557644526781,"(52.0, 100.0]",Q4
36005,2020-03-24,1432132,100,611,2890,1188,7633,383.0,937.7142857142857,26.743344887203136,65.47680560969839,"(52.0, 100.0]",Q4
36005,2020-03-25,1432132,100,838,3728,1770,9403,480.7142857142857,1105.2857142857142,33.566339256038255,77.17764244397264,"(52.0, 100.0]",Q4
36005,2020-03-26,1432132,100,829,4557,1428,10831,571.8571428571429,1222.857142857143,39.93047727843124,85.38718099010028,"(52.0, 100.0]",Q4
36005,2020-03-27,1432132,100,846,5403,1478,12309,650.2857142857143,1307.7142857142858,45.40682802183837,91.31241294198341,"(52.0, 100.0]",Q4
36005,2020-03-28,1432132,100,901,6304,1529,13838,726.5714285714286,1377.0,50.733551695753505,96.150354855558,"(52.0, 100.0]",Q4
36005,2020-03-29,1432132,100,658,6962,1160,14998,734.0,1360.4285714285713,51.252258869992424,94.99323885148655,"(52.0, 100.0]",Q4
36005,2020-03-30,1432132,100,804,7766,1341,16339,783.8571428571429,1413.4285714285713,54.733582020172925,98.69401503692197,"(52.0, 100.0]",Q4
36005,2020-03-31,1432132,100,1095,8861,1818,18157,853.0,1503.4285714285713,59.5615487957814,104.9783519555859,"(52.0, 100.0]",Q4
36005,2020-04-01,1432132,100,1066,9927,1754,19911,885.5714285714286,1501.142857142857,61.835880252059766,104.81874974812777,"(52.0, 100.0]",Q4
36005,2020-04-02,1432132,100,1159,11086,1946,21857,932.7142857142857,1575.142857142857,65.12767578088372,109.98587121458478,"(52.0, 100.0]",Q4
36005,2020-04-03,1432132,100,1229,12315,2108,23965,987.4285714285714,1665.142857142857,68.94815362191275,116.27020813324869,"(52.0, 100.0]",Q4
36005,2020-04-04,1432132,100,1053,13368,1778,25743,1009.1428571428571,1700.7142857142858,70.46437459276498,118.75401748681587,"(52.0, 100.0]",Q4
36005,2020-04-05,1432132,100,959,14327,1628,27371,1052.142857142857,1767.5714285714287,73.46689112057109,123.4223820549662,"(52.0, 100.0]",Q4
36005,2020-04-06,1432132,100,1021,15348,1996,29367,1083.142857142857,1861.142857142857,75.63149605922199,129.95609742278344,"(52.0, 100.0]",Q4
36005,2020-04-07,1432132,100,1278,16626,2562,31929,1109.2857142857142,1967.4285714285713,77.45694630702437,137.37760006958655,"(52.0, 100.0]",Q4
36005,2020-04-08,1432132,100,1166,17792,2348,34277,1123.5714285714287,2052.285714285714,78.4544601036377,143.30283202146967,"(52.0, 100.0]",Q4
36005,2020-04-09,1432132,100,1368,19160,2637,36914,1153.4285714285713,2151.0,80.53926393855953,150.19565235606774,"(52.0, 100.0]",Q4
36005,2020-04-10,1432132,100,1317,20477,2580,39494,1166.0,2218.4285714285716,81.41707607957926,154.90391747608263,"(52.0, 100.0]",Q4
36005,2020-04-11,1432132,100,964,21441,2081,41575,1153.2857142857142,2261.714285714286,80.52928880059339,157.92638427982098,"(52.0, 100.0]",Q4
36005,2020-04-12,1432132,100,764,22205,1623,43198,1125.4285714285713,2261.0,78.58413689719742,157.8765085899903,"(52.0, 100.0]",Q4
36005,2020-04-13,1432132,100,1061,23266,2294,45492,1131.142857142857,2303.5714285714284,78.98314241584275,160.849099703898,"(52.0, 100.0]",Q4
36005,2020-04-14,1432132,100,1387,24653,2622,48114,1146.7142857142858,2312.1428571428573,80.07043245415127,161.447607981866,"(52.0, 100.0]",Q4
36005,2020-04-15,1432132,100,1279,25932,2939,51053,1162.857142857143,2396.5714285714284,81.19762304432433,167.34291451985072,"(52.0, 100.0]",Q4
36005,2020-04-16,1432132,100,1103,27035,2793,53846,1125.0,2418.8571428571427,78.55421148329903,168.8990360425675,"(52.0, 100.0]",Q4
36005,2020-04-17,1432132,100,984,28019,2597,56443,1077.4285714285713,2421.285714285714,75.23249054057666,169.06861338799177,"(52.0, 100.0]",Q4
36005,2020-04-18,1432132,100,804,28823,2162,58605,1054.5714285714287,2432.8571428571427,73.63646846599536,169.87659956324853,"(52.0, 100.0]",Q4
36005,2020-04-19,1432132,100,549,29372,1707,60312,1023.8571428571429,2444.8571428571427,71.49181380327671,170.71451115240373,"(52.0, 100.0]",Q4
36005,2020-04-20,1432132,100,617,29989,2050,62362,960.4285714285714,2410.0,67.06285254631358,168.28057748866726,"(52.0, 100.0]",Q4
36005,2020-04-21,1432132,100,879,30868,2942,65304,887.8571428571429,2455.714285714286,61.995482459517895,171.47262163782986,"(52.0, 100.0]",Q4
36005,2020-04-22,1432132,100,791,31659,3084,68388,818.1428571428571,2476.4285714285716,57.127615132044895,172.91901664291922,"(52.0, 100.0]",Q4
36005,2020-04-23,1432132,100,1042,32701,3691,72079,809.4285714285714,2604.714285714286,56.51913171611076,181.87669053650683,"(52.0, 100.0]",Q4
36005,2020-04-24,1432132,100,1482,34183,4800,76879,880.5714285714286,2919.4285714285716,61.4867504232451,203.85191947589828,"(52.0, 100.0]",Q4
36005,2020-04-25,1432132,100,787,34970,2967,79846,878.1428571428571,3034.4285714285716,61.31717307782084,211.88190553863552,"(52.0, 100.0]",Q4
36005,2020-04-26,1432132,100,586,35556,2363,82209,883.4285714285714,3128.1428571428573,61.68625318256777,218.4255960444189,"(52.0, 100.0]",Q4
36005,2020-04-27,1432132,100,438,35994,2107,84316,857.8571428571429,3136.285714285714,59.90070348662992,218.99417890848846,"(52.0, 100.0]",Q4
36005,2020-04-28,1432132,100,606,36600,2938,87254,818.8571428571429,3135.714285714286,57.17749082187556,218.95427835662397,"(52.0, 100.0]",Q4
36005,2020-04-29,1432132,100,644,37244,2977,90231,797.8571428571429,3120.4285714285716,55.71114554085398,217.8869385942477,"(52.0, 100.0]",Q4
36005,2020-04-30,1432132,100,541,37785,2824,93055,726.2857142857143,2996.5714285714284,50.713601419821245,209.2384939776102,"(52.0, 100.0]",Q4
36005,2020-05-01,1432132,100,665,38450,3694,96749,609.5714285714286,2838.5714285714284,42.56391370149041,198.2059913870669,"(52.0, 100.0]",Q4
36005,2020-05-02,1432132,100,466,38916,2857,99606,563.7142857142857,2822.8571428571427,39.36189441436164,197.1087262107922,"(52.0, 100.0]",Q4
36005,2020-05-03,1432132,100,307,39223,1869,101475,523.8571428571429,2752.285714285714,36.57883092181048,192.1810080555224,"(52.0, 100.0]",Q4
36005,2020-05-04,1432132,100,253,39476,2001,103476,497.42857142857144,2737.1428571428573,34.73343039807583,191.1236434311123,"(52.0, 100.0]",Q4
36005,2020-05-05,1432132,100,363,39839,2657,106133,462.7142857142857,2697.0,32.309471872305465,188.32062966262885,"(52.0, 100.0]",Q4
36005,2020-05-06,1432132,100,342,40181,2786,108919,419.57142857142856,2669.714285714286,29.296980206533235,186.4153783110974,"(52.0, 100.0]",Q4
36005,2020-05-07,1432132,100,352,40533,3078,111997,392.57142857142856,2706.0,27.411679130934058,188.94906335449525,"(52.0, 100.0]",Q4
36005,2020-05-08,1432132,100,271,40804,2873,114870,336.2857142857143,2588.714285714286,23.481474772277576,180.75947508429988,"(52.0, 100.0]",Q4
36005,2020-05-09,1432132,100,255,41059,2935,117805,306.14285714285717,2599.8571428571427,21.37672066142347,181.53753584565828,"(52.0, 100.0]",Q4
36005,2020-05-10,1432132,100,237,41296,2140,119945,296.14285714285717,2638.5714285714284,20.678461003794144,184.24079823448037,"(52.0, 100.0]",Q4
36005,2020-05-11,1432132,100,145,41441,1510,121455,280.7142857142857,2568.4285714285716,19.601146103451757,179.343005493109,"(52.0, 100.0]",Q4
36005,2020-05-12,1432132,100,236,41677,2678,124133,262.57142857142856,2571.4285714285716,18.334303581752838,179.55248339039778,"(52.0, 100.0]",Q4
36005,2020-05-13,1432132,100,303,41980,3338,127471,257.0,2650.285714285714,17.945273201073647,185.0587595477033,"(52.0, 100.0]",Q4
36005,2020-05-14,1432132,100,539,42519,4408,131879,283.7142857142857,2840.285714285714,19.810624000740557,198.32569304266048,"(52.0, 100.0]",Q4
36005,2020-05-15,1432132,100,293,42812,3632,135511,286.85714285714283,2948.714285714286,20.030077035995483,205.89682275895558,"(52.0, 100.0]",Q4
36005,2020-05-16,1432132,100,210,43022,2861,138372,280.42857142857144,2938.1428571428573,19.581195827519494,205.15866254946172,"(52.0, 100.0]",Q4
36005,2020-05-17,1432132,100,136,43158,2126,140498,266.0,2936.1428571428573,18.573706892940034,205.01901061793586,"(52.0, 100.0]",Q4
36005,2020-05-18,1432132,100,112,43270,2102,142600,261.2857142857143,3020.714285714286,18.24452734005764,210.9242922938867,"(52.0, 100.0]",Q4
36005,2020-05-19,1432132,100,148,43418,2682,145282,248.71428571428572,3021.285714285714,17.366715199037916,210.96419284575126,"(52.0, 100.0]",Q4
36005,2020-05-20,1432132,100,185,43603,3618,148900,231.85714285714286,3061.285714285714,16.189648919034198,213.75723147626854,"(52.0, 100.0]",Q4
36005,2020-05-21,1432132,100,163,43766,3421,152321,178.14285714285714,2920.285714285714,12.438997043768111,203.91177030369508,"(52.0, 100.0]",Q4
36005,2020-05-22,1432132,100,155,43921,3518,155839,158.42857142857142,2904.0,11.06242800444173,202.7746045755559,"(52.0, 100.0]",Q4
36005,2020-05-23,1432132,100,216,44137,4575,160414,159.28571428571428,3148.8571428571427,11.122278832238527,219.8719910495082,"(52.0, 100.0]",Q4
36005,2020-05-24,1432132,100,110,44247,2445,162859,155.57142857142858,3194.4285714285716,10.862925245119065,223.05406006070473,"(52.0, 100.0]",Q4
36005,2020-05-25,1432132,100,117,44364,2233,165092,156.28571428571428,3213.1428571428573,10.91280093494973,224.36080313426817,"(52.0, 100.0]",Q4
36005,2020-05-26,1432132,100,139,44503,3064,168156,155.0,3267.714285714286,10.823024693254531,228.17130583733103,"(52.0, 100.0]",Q4
36005,2020-05-27,1432132,100,250,44753,5657,173813,164.28571428571428,3559.0,11.471408661053191,248.51061215027664,"(52.0, 100.0]",Q4
36005,2020-05-28,1432132,100,221,44974,5781,179594,172.57142857142858,3896.1428571428573,12.049966663088917,272.05193775035104,"(52.0, 100.0]",Q4
36005,2020-05-29,1432132,100,142,45116,4817,184411,170.71428571428572,4081.714285714286,11.920289869529187,285.0096419683581,"(52.0, 100.0]",Q4
36005,2020-05-30,1432132,100,137,45253,4338,188749,159.42857142857142,4047.8571428571427,11.13225397020466,282.6455342703845,"(52.0, 100.0]",Q4
36005,2020-05-31,1432132,100,106,45359,3997,192746,158.85714285714286,4269.571428571428,11.09235341834013,298.1269483938232,"(52.0, 100.0]",Q4
36005,2020-06-01,1432132,100,107,45466,4069,196815,157.42857142857142,4531.857142857143,10.992602038678797,316.4413016996438,"(52.0, 100.0]",Q4
36005,2020-06-02,1432132,100,105,45571,3579,200394,152.57142857142858,4605.428571428572,10.65344734783027,321.5784977522024,"(52.0, 100.0]",Q4
36005,2020-06-03,1432132,100,117,45688,4303,204697,133.57142857142858,4412.0,9.326753998334551,308.07216094605803,"(52.0, 100.0]",Q4
36005,2020-06-04,1432132,100,90,45778,4606,209303,114.85714285714286,4244.142857142857,8.020010924771102,296.3513738358515,"(52.0, 100.0]",Q4
36005,2020-06-05,1432132,100,104,45882,5144,214447,109.42857142857143,4290.857142857143,7.640955682058038,299.61324395077713,"(52.0, 100.0]",Q4
36005,2020-06-06,1432132,100,98,45980,4164,218611,103.85714285714286,4266.0,7.2519253013788445,297.8775699446699,"(52.0, 100.0]",Q4
36005,2020-06-07,1432132,100,72,46052,3718,222329,99.0,4226.142857142857,6.9127706105303135,295.09450645211876,"(52.0, 100.0]",Q4
36007,2020-03-02,191659,52,0,0,0,0,0.0,0.0,0.0,0.0,"(37.5, 52.0]",Q3
36007,2020-03-03,191659,52,0,0,0,0,0.0,0.0,0.0,0.0,"(37.5, 52.0]",Q3
36007,2020-03-04,191659,52,0,0,0,0,0.0,0.0,0.0,0.0,"(37.5, 52.0]",Q3
36007,2020-03-05,191659,52,0,0,0,0,0.0,0.0,0.0,0.0,"(37.5, 52.0]",Q3
36007,2020-03-06,191659,52,0,0,0,0,0.0,0.0,0.0,0.0,"(37.5, 52.0]",Q3
36007,2020-03-07,191659,52,0,0,0,0,0.0,0.0,0.0,0.0,"(37.5, 52.0]",Q3
36007,2020-03-08,191659,52,0,0,2,2,0.0,0.2857142857142857,0.0,0.14907428595280456,"(37.5, 52.0]",Q3
36007,2020-03-09,191659,52,0,0,1,3,0.0,0.42857142857142855,0.0,0.22361142892920685,"(37.5, 52.0]",Q3
36007,2020-03-10,191659,52,0,0,1,4,0.0,0.5714285714285714,0.0,0.2981485719056091,"(37.5, 52.0]",Q3
36007,2020-03-11,191659,52,0,0,1,5,0.0,0.7142857142857143,0.0,0.37268571488201147,"(37.5, 52.0]",Q3
36007,2020-03-12,191659,52,1,1,2,7,0.14285714285714285,1.0,0.07453714297640228,0.521760000834816,"(37.5, 52.0]",Q3
36007,2020-03-13,191659,52,0,1,2,9,0.14285714285714285,1.2857142857142858,0.07453714297640228,0.6708342867876206,"(37.5, 52.0]",Q3
36007,2020-03-14,191659,52,0,1,3,12,0.14285714285714285,1.7142857142857142,0.07453714297640228,0.8944457157168274,"(37.5, 52.0]",Q3
36007,2020-03-15,191659,52,0,1,2,14,0.14285714285714285,1.7142857142857142,0.07453714297640228,0.8944457157168274,"(37.5, 52.0]",Q3
36007,2020-03-16,191659,52,0,1,1,15,0.14285714285714285,1.7142857142857142,0.07453714297640228,0.8944457157168274,"(37.5, 52.0]",Q3
36007,2020-03-17,191659,52,0,1,6,21,0.14285714285714285,2.4285714285714284,0.07453714297640228,1.2671314305988388,"(37.5, 52.0]",Q3
36007,2020-03-18,191659,52,1,2,9,30,0.2857142857142857,3.5714285714285716,0.14907428595280456,1.8634285744100574,"(37.5, 52.0]",Q3
36007,2020-03-19,191659,52,0,2,3,33,0.14285714285714285,3.7142857142857144,0.07453714297640228,1.9379657173864595,"(37.5, 52.0]",Q3
36007,2020-03-20,191659,52,0,2,16,49,0.14285714285714285,5.714285714285714,0.07453714297640228,2.9814857190560917,"(37.5, 52.0]",Q3
36007,2020-03-21,191659,52,1,3,5,54,0.2857142857142857,6.0,0.14907428595280456,3.130560005008896,"(37.5, 52.0]",Q3
36007,2020-03-22,191659,52,4,7,20,74,0.8571428571428571,8.571428571428571,0.4472228578584137,4.472228578584137,"(37.5, 52.0]",Q3
36007,2020-03-23,191659,52,2,9,18,92,1.1428571428571428,11.0,0.5962971438112182,5.739360009182976,"(37.5, 52.0]",Q3
36007,2020-03-24,191659,52,2,11,13,105,1.4285714285714286,12.0,0.7453714297640229,6.261120010017792,"(37.5, 52.0]",Q3
36007,2020-03-25,191659,52,5,16,37,142,2.0,16.0,1.043520001669632,8.348160013357056,"(37.5, 52.0]",Q3
36007,2020-03-26,191659,52,2,18,25,167,2.2857142857142856,19.142857142857142,1.1925942876224365,9.987977158837905,"(37.5, 52.0]",Q3
36007,2020-03-27,191659,52,5,23,37,204,3.0,22.142857142857142,1.565280002504448,11.553257161342353,"(37.5, 52.0]",Q3
36007,2020-03-28,191659,52,6,29,45,249,3.7142857142857144,27.857142857142858,1.9379657173864595,14.534742880398447,"(37.5, 52.0]",Q3
36007,2020-03-29,191659,52,6,35,36,285,4.0,30.142857142857142,2.087040003339264,15.727337168020881,"(37.5, 52.0]",Q3
36007,2020-03-30,191659,52,3,38,48,333,4.142857142857143,34.42857142857143,2.1615771463156666,17.963451457312953,"(37.5, 52.0]",Q3
36007,2020-03-31,191659,52,4,42,35,368,4.428571428571429,37.57142857142857,2.3106514322684713,19.6032686027938,"(37.5, 52.0]",Q3
36007,2020-04-01,191659,52,4,46,43,411,4.285714285714286,38.42857142857143,2.2361142892920687,20.050491460652218,"(37.5, 52.0]",Q3
36007,2020-04-02,191659,52,10,56,72,483,5.428571428571429,45.142857142857146,2.832411433103287,23.553737180543123,"(37.5, 52.0]",Q3
36007,2020-04-03,191659,52,9,65,55,538,6.0,47.714285714285715,3.130560005008896,24.895405754118364,"(37.5, 52.0]",Q3
36007,2020-04-04,191659,52,6,71,36,574,6.0,46.42857142857143,3.130560005008896,24.224571467330744,"(37.5, 52.0]",Q3
36007,2020-04-05,191659,52,5,76,33,607,5.857142857142857,46.0,3.0560228620324934,24.000960038401537,"(37.5, 52.0]",Q3
36007,2020-04-06,191659,52,10,86,47,654,6.857142857142857,45.857142857142854,3.5777828628673096,23.926422895425134,"(37.5, 52.0]",Q3
36007,2020-04-07,191659,52,2,88,24,678,6.571428571428571,44.285714285714285,3.428708576914505,23.106514322684706,"(37.5, 52.0]",Q3
36007,2020-04-08,191659,52,17,105,82,760,8.428571428571429,49.857142857142854,4.397691435607735,26.013462898764395,"(37.5, 52.0]",Q3
36007,2020-04-09,191659,52,7,112,58,818,8.0,47.857142857142854,4.174080006678528,24.969942897094768,"(37.5, 52.0]",Q3
36007,2020-04-10,191659,52,5,117,31,849,7.428571428571429,44.42857142857143,3.875931434772919,23.181051465661113,"(37.5, 52.0]",Q3
36007,2020-04-11,191659,52,9,126,60,909,7.857142857142857,47.857142857142854,4.099542863702125,24.969942897094768,"(37.5, 52.0]",Q3
36007,2020-04-12,191659,52,7,133,39,948,8.142857142857142,48.714285714285715,4.2486171496549305,25.417165754953178,"(37.5, 52.0]",Q3
36007,2020-04-13,191659,52,13,146,90,1038,8.571428571428571,54.857142857142854,4.472228578584137,28.622262902938477,"(37.5, 52.0]",Q3
36007,2020-04-14,191659,52,7,153,73,1111,9.285714285714286,61.857142857142854,4.844914293466149,32.274582908782186,"(37.5, 52.0]",Q3
36007,2020-04-15,191659,52,14,167,74,1185,8.857142857142858,60.714285714285715,4.6213028645369425,31.67828576497097,"(37.5, 52.0]",Q3
36007,2020-04-16,191659,52,11,178,82,1267,9.428571428571429,64.14285714285714,4.919451436442551,33.46717719640462,"(37.5, 52.0]",Q3
36007,2020-04-17,191659,52,8,186,64,1331,9.857142857142858,68.85714285714286,5.143062865371758,35.926902914625906,"(37.5, 52.0]",Q3
36007,2020-04-18,191659,52,6,192,52,1383,9.428571428571429,67.71428571428571,4.919451436442551,35.33060577081468,"(37.5, 52.0]",Q3
36007,2020-04-19,191659,52,7,199,43,1426,9.428571428571429,68.28571428571429,4.919451436442551,35.6287543427203,"(37.5, 52.0]",Q3
36007,2020-04-20,191659,52,6,205,47,1473,8.428571428571429,62.142857142857146,4.397691435607735,32.423657194735,"(37.5, 52.0]",Q3
36007,2020-04-21,191659,52,14,219,54,1527,9.428571428571429,59.42857142857143,4.919451436442551,31.007451478183352,"(37.5, 52.0]",Q3
36007,2020-04-22,191659,52,5,224,102,1629,8.142857142857142,63.42857142857143,4.2486171496549305,33.09449148152262,"(37.5, 52.0]",Q3
36007,2020-04-23,191659,52,8,232,85,1714,7.714285714285714,63.857142857142854,4.025005720725724,33.31810291045182,"(37.5, 52.0]",Q3
36007,2020-04-24,191659,52,19,251,212,1926,9.285714285714286,85.0,4.844914293466149,44.34960007095936,"(37.5, 52.0]",Q3
36007,2020-04-25,191659,52,6,257,105,2031,9.285714285714286,92.57142857142857,4.844914293466149,48.30006864870868,"(37.5, 52.0]",Q3
36007,2020-04-26,191659,52,4,261,69,2100,8.857142857142858,96.28571428571429,4.6213028645369425,50.23803436609514,"(37.5, 52.0]",Q3
36007,2020-04-27,191659,52,5,266,60,2160,8.714285714285714,98.14285714285714,4.546765721560539,51.20701722478837,"(37.5, 52.0]",Q3
36007,2020-04-28,191659,52,7,273,87,2247,7.714285714285714,102.85714285714286,4.025005720725724,53.66674294300965,"(37.5, 52.0]",Q3
36007,2020-04-29,191659,52,11,284,114,2361,8.571428571428571,104.57142857142857,4.472228578584137,54.56118865872647,"(37.5, 52.0]",Q3
36007,2020-04-30,191659,52,15,299,110,2471,9.571428571428571,108.14285714285714,4.993988579418953,56.42461723313652,"(37.5, 52.0]",Q3
36007,2020-05-01,191659,52,6,305,114,2585,7.714285714285714,94.14285714285714,4.025005720725724,49.119977221449105,"(37.5, 52.0]",Q3
36007,2020-05-02,191659,52,22,327,415,3000,10.0,138.42857142857142,5.2176000083481595,72.22649154413381,"(37.5, 52.0]",Q3
36007,2020-05-03,191659,52,7,334,353,3353,10.428571428571429,179.0,5.441211437277367,93.39504014943206,"(37.5, 52.0]",Q3
36007,2020-05-04,191659,52,4,338,180,3533,10.285714285714286,196.14285714285714,5.366674294300965,102.33949730660034,"(37.5, 52.0]",Q3
36007,2020-05-05,191659,52,7,345,273,3806,10.285714285714286,222.71428571428572,5.366674294300965,116.20340590021117,"(37.5, 52.0]",Q3
36007,2020-05-06,191659,52,15,360,333,4139,10.857142857142858,254.0,5.664822866206574,132.52704021204326,"(37.5, 52.0]",Q3
36007,2020-05-07,191659,52,4,364,214,4353,9.285714285714286,268.85714285714283,4.844914293466149,140.27890308158908,"(37.5, 52.0]",Q3
36007,2020-05-08,191659,52,8,372,252,4605,9.571428571428571,288.57142857142856,4.993988579418953,150.5650288123326,"(37.5, 52.0]",Q3
36007,2020-05-09,191659,52,1,373,317,4922,6.571428571428571,274.57142857142856,3.428708576914505,143.2603888006452,"(37.5, 52.0]",Q3
36007,2020-05-10,191659,52,5,378,319,5241,6.285714285714286,269.7142857142857,3.2796342909617002,140.7261259394475,"(37.5, 52.0]",Q3
36007,2020-05-11,191659,52,1,379,271,5512,5.857142857142857,282.7142857142857,3.0560228620324934,147.50900595030012,"(37.5, 52.0]",Q3
36007,2020-05-12,191659,52,3,382,291,5803,5.285714285714286,285.2857142857143,2.7578742901268845,148.85067452387537,"(37.5, 52.0]",Q3
36007,2020-05-13,191659,52,1,383,343,6146,3.2857142857142856,286.7142857142857,1.7143542884572525,149.5960459536394,"(37.5, 52.0]",Q3
36007,2020-05-14,191659,52,7,390,343,6489,3.7142857142857144,305.14285714285717,1.9379657173864595,159.2113373975953,"(37.5, 52.0]",Q3
36007,2020-05-15,191659,52,23,413,458,6947,5.857142857142857,334.57142857142856,3.0560228620324934,174.56598885073413,"(37.5, 52.0]",Q3
36007,2020-05-16,191659,52,1,414,486,7433,5.857142857142857,358.7142857142857,3.0560228620324934,187.16276601374614,"(37.5, 52.0]",Q3
36007,2020-05-17,191659,52,9,423,379,7812,6.428571428571429,367.2857142857143,3.3541714339381032,191.63499459233026,"(37.5, 52.0]",Q3
36007,2020-05-18,191659,52,6,429,295,8107,7.142857142857143,370.7142857142857,3.7268571488201148,193.42388602376394,"(37.5, 52.0]",Q3
36007,2020-05-19,191659,52,7,436,639,8746,7.714285714285714,420.42857142857144,4.025005720725724,219.36281177955195,"(37.5, 52.0]",Q3
36007,2020-05-20,191659,52,15,451,419,9165,9.714285714285714,431.2857142857143,5.068525722395355,225.02763464575852,"(37.5, 52.0]",Q3
36007,2020-05-21,191659,52,17,468,820,9985,11.142857142857142,499.42857142857144,5.813897152159378,260.5818518455024,"(37.5, 52.0]",Q3
36007,2020-05-22,191659,52,17,485,645,10630,10.285714285714286,526.1428571428571,5.366674294300965,274.5202975820896,"(37.5, 52.0]",Q3
36007,2020-05-23,191659,52,16,501,629,11259,12.428571428571429,546.5714285714286,6.484731438947,285.1791090277151,"(37.5, 52.0]",Q3
36007,2020-05-24,191659,52,18,519,669,11928,13.714285714285714,588.0,7.155565725734619,306.79488049087183,"(37.5, 52.0]",Q3
36007,2020-05-25,191659,52,3,522,536,12464,13.285714285714286,622.4285714285714,6.931954296805413,324.7583319481848,"(37.5, 52.0]",Q3
36007,2020-05-26,191659,52,6,528,369,12833,13.142857142857142,583.8571428571429,6.85741715382901,304.63330334455617,"(37.5, 52.0]",Q3
36007,2020-05-27,191659,52,17,545,523,13356,13.428571428571429,598.7142857142857,7.006491439781815,312.38516621410196,"(37.5, 52.0]",Q3
36007,2020-05-28,191659,52,12,557,614,13970,12.714285714285714,569.2857142857143,6.633805724899804,297.0305147609632,"(37.5, 52.0]",Q3
36007,2020-05-29,191659,52,4,561,531,14501,10.857142857142858,553.0,5.664822866206574,288.53328046165325,"(37.5, 52.0]",Q3
36007,2020-05-30,191659,52,5,566,1002,15503,9.285714285714286,606.2857142857143,4.844914293466149,316.33563479185136,"(37.5, 52.0]",Q3
36007,2020-05-31,191659,52,8,574,777,16280,7.857142857142857,621.7142857142857,4.099542863702125,324.38564623330274,"(37.5, 52.0]",Q3
36007,2020-06-01,191659,52,4,578,629,16909,8.0,635.0,4.174080006678528,331.31760053010817,"(37.5, 52.0]",Q3
36007,2020-06-02,191659,52,11,589,826,17735,8.714285714285714,700.2857142857143,4.546765721560539,365.381074870324,"(37.5, 52.0]",Q3
36007,2020-06-03,191659,52,4,593,631,18366,6.857142857142857,715.7142857142857,3.5777828628673096,373.4310863117754,"(37.5, 52.0]",Q3
36007,2020-06-04,191659,52,12,605,1417,19783,6.857142857142857,830.4285714285714,3.5777828628673096,433.2844121218265,"(37.5, 52.0]",Q3
36007,2020-06-05,191659,52,8,613,1311,21094,7.428571428571429,941.8571428571429,3.875931434772919,491.42338364342027,"(37.5, 52.0]",Q3
36007,2020-06-06,191659,52,7,620,950,22044,7.714285714285714,934.4285714285714,4.025005720725724,487.5474522086473,"(37.5, 52.0]",Q3
36007,2020-06-07,191659,52,4,624,745,22789,7.142857142857143,929.8571428571429,3.7268571488201148,485.1622636334025,"(37.5, 52.0]",Q3
36009,2020-03-02,76840,54,0,0,0,0,0.0,0.0,0.0,0.0,"(52.0, 100.0]",Q4
36009,2020-03-03,76840,54,0,0,0,0,0.0,0.0,0.0,0.0,"(52.0, 100.0]",Q4
36009,2020-03-04,76840,54,0,0,0,0,0.0,0.0,0.0,0.0,"(52.0, 100.0]",Q4
36009,2020-03-05,76840,54,0,0,0,0,0.0,0.0,0.0,0.0,"(52.0, 100.0]",Q4
36009,2020-03-06,76840,54,0,0,0,0,0.0,0.0,0.0,0.0,"(52.0, 100.0]",Q4
36009,2020-03-07,76840,54,0,0,0,0,0.0,0.0,0.0,0.0,"(52.0, 100.0]",Q4
36009,2020-03-08,76840,54,0,0,0,0,0.0,0.0,0.0,0.0,"(52.0, 100.0]",Q4
36009,2020-03-09,76840,54,0,0,0,0,0.0,0.0,0.0,0.0,"(52.0, 100.0]",Q4
36009,2020-03-10,76840,54,0,0,0,0,0.0,0.0,0.0,0.0,"(52.0, 100.0]",Q4
36009,2020-03-11,76840,54,0,0,0,0,0.0,0.0,0.0,0.0,"(52.0, 100.0]",Q4
36009,2020-03-12,76840,54,0,0,2,2,0.0,0.2857142857142857,0.0,0.37183014798839886,"(52.0, 100.0]",Q4
36009,2020-03-13,76840,54,0,0,2,4,0.0,0.5714285714285714,0.0,0.7436602959767977,"(52.0, 100.0]",Q4
36009,2020-03-14,76840,54,0,0,1,5,0.0,0.7142857142857143,0.0,0.9295753699709972,"(52.0, 100.0]",Q4
36009,2020-03-15,76840,54,0,0,2,7,0.0,1.0,0.0,1.3014055179593962,"(52.0, 100.0]",Q4
36009,2020-03-16,76840,54,0,0,0,7,0.0,1.0,0.0,1.3014055179593962,"(52.0, 100.0]",Q4
36009,2020-03-17,76840,54,0,0,0,7,0.0,1.0,0.0,1.3014055179593962,"(52.0, 100.0]",Q4
36009,2020-03-18,76840,54,0,0,5,12,0.0,1.7142857142857142,0.0,2.2309808879303934,"(52.0, 100.0]",Q4
36009,2020-03-19,76840,54,0,0,2,14,0.0,1.7142857142857142,0.0,2.2309808879303934,"(52.0, 100.0]",Q4
36009,2020-03-20,76840,54,0,0,10,24,0.0,2.857142857142857,0.0,3.718301479883989,"(52.0, 100.0]",Q4
36009,2020-03-21,76840,54,0,0,23,47,0.0,6.0,0.0,7.808433107756377,"(52.0, 100.0]",Q4
36009,2020-03-22,76840,54,0,0,14,61,0.0,7.714285714285714,0.0,10.039413995686772,"(52.0, 100.0]",Q4
36009,2020-03-23,76840,54,0,0,12,73,0.0,9.428571428571429,0.0,12.270394883617163,"(52.0, 100.0]",Q4
36009,2020-03-24,76840,54,0,0,3,76,0.0,9.857142857142858,0.0,12.828140105599763,"(52.0, 100.0]",Q4
36009,2020-03-25,76840,54,0,0,12,88,0.0,10.857142857142858,0.0,14.129545623559158,"(52.0, 100.0]",Q4
36009,2020-03-26,76840,54,0,0,13,101,0.0,12.428571428571429,0.0,16.17461143749535,"(52.0, 100.0]",Q4
36009,2020-03-27,76840,54,1,1,25,126,0.14285714285714285,14.571428571428571,0.18591507399419943,18.963337547408344,"(52.0, 100.0]",Q4
36009,2020-03-28,76840,54,3,4,13,139,0.5714285714285714,13.142857142857142,0.7436602959767977,17.10418680746635,"(52.0, 100.0]",Q4
36009,2020-03-29,76840,54,2,6,7,146,0.8571428571428571,12.142857142857142,1.1154904439651967,15.802781289506951,"(52.0, 100.0]",Q4
36009,2020-03-30,76840,54,0,6,5,151,0.8571428571428571,11.142857142857142,1.1154904439651967,14.501375771547556,"(52.0, 100.0]",Q4
36009,2020-03-31,76840,54,1,7,12,163,1.0,12.428571428571429,1.3014055179593962,16.17461143749535,"(52.0, 100.0]",Q4
36009,2020-04-01,76840,54,1,8,28,191,1.1428571428571428,14.714285714285714,1.4873205919535955,19.149252621402542,"(52.0, 100.0]",Q4
36009,2020-04-02,76840,54,1,9,24,215,1.2857142857142858,16.285714285714285,1.6732356659477952,21.194318435338733,"(52.0, 100.0]",Q4
36009,2020-04-03,76840,54,0,9,8,223,1.1428571428571428,13.857142857142858,1.4873205919535955,18.033762177437346,"(52.0, 100.0]",Q4
36009,2020-04-04,76840,54,1,10,12,235,0.8571428571428571,13.714285714285714,1.1154904439651967,17.847847103443147,"(52.0, 100.0]",Q4
36009,2020-04-05,76840,54,2,12,16,251,0.8571428571428571,15.0,1.1154904439651967,19.521082769390944,"(52.0, 100.0]",Q4
36009,2020-04-06,76840,54,1,13,14,265,1.0,16.285714285714285,1.3014055179593962,21.194318435338733,"(52.0, 100.0]",Q4
36009,2020-04-07,76840,54,2,15,19,284,1.1428571428571428,17.285714285714285,1.4873205919535955,22.495723953298132,"(52.0, 100.0]",Q4
36009,2020-04-08,76840,54,2,17,15,299,1.2857142857142858,15.428571428571429,1.6732356659477952,20.078827991373544,"(52.0, 100.0]",Q4
36009,2020-04-09,76840,54,1,18,26,325,1.2857142857142858,15.714285714285714,1.6732356659477952,20.450658139361938,"(52.0, 100.0]",Q4
36009,2020-04-10,76840,54,1,19,7,332,1.4285714285714286,15.571428571428571,1.8591507399419944,20.26474306536774,"(52.0, 100.0]",Q4
36009,2020-04-11,76840,54,9,28,32,364,2.5714285714285716,18.428571428571427,3.3464713318955903,23.98304454525173,"(52.0, 100.0]",Q4
36009,2020-04-12,76840,54,0,28,6,370,2.2857142857142856,17.0,2.974641183907191,22.123893805309734,"(52.0, 100.0]",Q4
36009,2020-04-13,76840,54,4,32,13,383,2.7142857142857144,16.857142857142858,3.5323864058897896,21.937978731315535,"(52.0, 100.0]",Q4
36009,2020-04-14,76840,54,0,32,11,394,2.4285714285714284,15.714285714285714,3.1605562579013906,20.450658139361938,"(52.0, 100.0]",Q4
36009,2020-04-15,76840,54,0,32,14,408,2.142857142857143,15.571428571428571,2.7887261099129916,20.26474306536774,"(52.0, 100.0]",Q4
36009,2020-04-16,76840,54,2,34,31,439,2.2857142857142856,16.285714285714285,2.974641183907191,21.194318435338733,"(52.0, 100.0]",Q4
36009,2020-04-17,76840,54,0,34,15,454,2.142857142857143,17.428571428571427,2.7887261099129916,22.68163902729233,"(52.0, 100.0]",Q4
36009,2020-04-18,76840,54,0,34,17,471,0.8571428571428571,15.285714285714286,1.1154904439651967,19.89291291737934,"(52.0, 100.0]",Q4
36009,2020-04-19,76840,54,0,34,1,472,0.8571428571428571,14.571428571428571,1.1154904439651967,18.963337547408344,"(52.0, 100.0]",Q4
36009,2020-04-20,76840,54,1,35,8,480,0.42857142857142855,13.857142857142858,0.5577452219825983,18.033762177437346,"(52.0, 100.0]",Q4
36009,2020-04-21,76840,54,2,37,34,514,0.7142857142857143,17.142857142857142,0.9295753699709972,22.309808879303933,"(52.0, 100.0]",Q4
36009,2020-04-22,76840,54,0,37,40,554,0.7142857142857143,20.857142857142858,0.9295753699709972,27.143600803153117,"(52.0, 100.0]",Q4
36009,2020-04-23,76840,54,2,39,32,586,0.7142857142857143,21.0,0.9295753699709972,27.32951587714732,"(52.0, 100.0]",Q4
36009,2020-04-24,76840,54,6,45,102,688,1.5714285714285714,33.42857142857143,2.045065813936194,43.50412731464267,"(52.0, 100.0]",Q4
36009,2020-04-25,76840,54,0,45,24,712,1.5714285714285714,34.42857142857143,2.045065813936194,44.80553283260207,"(52.0, 100.0]",Q4
36009,2020-04-26,76840,54,0,45,21,733,1.5714285714285714,37.285714285714285,2.045065813936194,48.52383431248605,"(52.0, 100.0]",Q4
36009,2020-04-27,76840,54,0,45,15,748,1.4285714285714286,38.285714285714285,1.8591507399419944,49.825239830445454,"(52.0, 100.0]",Q4
36009,2020-04-28,76840,54,2,47,76,824,1.4285714285714286,44.285714285714285,1.8591507399419944,57.63367293820183,"(52.0, 100.0]",Q4
36009,2020-04-29,76840,54,0,47,85,909,1.4285714285714286,50.714285714285715,1.8591507399419944,65.9998512679408,"(52.0, 100.0]",Q4
36009,2020-04-30,76840,54,2,49,78,987,1.4285714285714286,57.285714285714285,1.8591507399419944,74.55194467167398,"(52.0, 100.0]",Q4
36009,2020-05-01,76840,54,1,50,80,1067,0.7142857142857143,54.142857142857146,0.9295753699709972,70.4618130438016,"(52.0, 100.0]",Q4
36009,2020-05-02,76840,54,3,53,54,1121,1.1428571428571428,58.42857142857143,1.4873205919535955,76.03926526362758,"(52.0, 100.0]",Q4
36009,2020-05-03,76840,54,0,53,7,1128,1.1428571428571428,56.42857142857143,1.4873205919535955,73.43645422770878,"(52.0, 100.0]",Q4
36009,2020-05-04,76840,54,0,53,14,1142,1.1428571428571428,56.285714285714285,1.4873205919535955,73.25053915371458,"(52.0, 100.0]",Q4
36009,2020-05-05,76840,54,1,54,47,1189,1.0,52.142857142857146,1.3014055179593962,67.8590020078828,"(52.0, 100.0]",Q4
36009,2020-05-06,76840,54,5,59,65,1254,1.7142857142857142,49.285714285714285,2.2309808879303934,64.14070052799882,"(52.0, 100.0]",Q4
36009,2020-05-07,76840,54,0,59,36,1290,1.4285714285714286,43.285714285714285,1.8591507399419944,56.33226742024244,"(52.0, 100.0]",Q4
36009,2020-05-08,76840,54,1,60,54,1344,1.4285714285714286,39.57142857142857,1.8591507399419944,51.49847549639324,"(52.0, 100.0]",Q4
36009,2020-05-09,76840,54,0,60,21,1365,1.0,34.857142857142854,1.3014055179593962,45.36327805458466,"(52.0, 100.0]",Q4
36009,2020-05-10,76840,54,1,61,103,1468,1.1428571428571428,48.57142857142857,1.4873205919535955,63.211125158027805,"(52.0, 100.0]",Q4
36009,2020-05-11,76840,54,0,61,29,1497,1.1428571428571428,50.714285714285715,1.4873205919535955,65.9998512679408,"(52.0, 100.0]",Q4
36009,2020-05-12,76840,54,0,61,77,1574,1.0,55.0,1.3014055179593962,71.57730348776678,"(52.0, 100.0]",Q4
36009,2020-05-13,76840,54,3,64,134,1708,0.7142857142857143,64.85714285714286,0.9295753699709972,84.40544359336656,"(52.0, 100.0]",Q4
36009,2020-05-14,76840,54,0,64,173,1881,0.7142857142857143,84.42857142857143,0.9295753699709972,109.87580873057186,"(52.0, 100.0]",Q4
36009,2020-05-15,76840,54,1,65,186,2067,0.7142857142857143,103.28571428571429,0.9295753699709972,134.4165984978062,"(52.0, 100.0]",Q4
36009,2020-05-16,76840,54,0,65,142,2209,0.7142857142857143,120.57142857142857,0.9295753699709972,156.91232245110433,"(52.0, 100.0]",Q4
36009,2020-05-17,76840,54,2,67,207,2416,0.8571428571428571,135.42857142857142,1.1154904439651967,176.24749014650106,"(52.0, 100.0]",Q4
36009,2020-05-18,76840,54,2,69,24,2440,1.1428571428571428,134.71428571428572,1.4873205919535955,175.3179147765301,"(52.0, 100.0]",Q4
36009,2020-05-19,76840,54,1,70,152,2592,1.2857142857142858,145.42857142857142,1.6732356659477952,189.26154532609502,"(52.0, 100.0]",Q4
36009,2020-05-20,76840,54,1,71,186,2778,1.0,152.85714285714286,1.3014055179593962,198.9291291737934,"(52.0, 100.0]",Q4
36009,2020-05-21,76840,54,3,74,125,2903,1.4285714285714286,146.0,1.8591507399419944,190.00520562207183,"(52.0, 100.0]",Q4
36009,2020-05-22,76840,54,4,78,176,3079,1.8571428571428572,144.57142857142858,2.416895961924593,188.14605488212987,"(52.0, 100.0]",Q4
36009,2020-05-23,76840,54,0,78,172,3251,1.8571428571428572,148.85714285714286,2.416895961924593,193.72350710195585,"(52.0, 100.0]",Q4
36009,2020-05-24,76840,54,3,81,311,3562,2.0,163.71428571428572,2.6028110359187924,213.05867479735258,"(52.0, 100.0]",Q4
36009,2020-05-25,76840,54,0,81,136,3698,1.7142857142857142,179.71428571428572,2.2309808879303934,233.88116308470293,"(52.0, 100.0]",Q4
36009,2020-05-26,76840,54,1,82,162,3860,1.7142857142857142,181.14285714285714,2.2309808879303934,235.74031382464491,"(52.0, 100.0]",Q4
36009,2020-05-27,76840,54,3,85,286,4146,2.0,195.42857142857142,2.6028110359187924,254.33182122406484,"(52.0, 100.0]",Q4
36009,2020-05-28,76840,54,1,86,147,4293,1.7142857142857142,198.57142857142858,2.2309808879303934,258.42195285193725,"(52.0, 100.0]",Q4
36009,2020-05-29,76840,54,1,87,189,4482,1.2857142857142858,200.42857142857142,1.6732356659477952,260.83884881386183,"(52.0, 100.0]",Q4
36009,2020-05-30,76840,54,1,88,183,4665,1.4285714285714286,202.0,1.8591507399419944,262.883914627798,"(52.0, 100.0]",Q4
36009,2020-05-31,76840,54,1,89,215,4880,1.1428571428571428,188.28571428571428,1.4873205919535955,245.03606752435485,"(52.0, 100.0]",Q4
36009,2020-06-01,76840,54,0,89,333,5213,1.1428571428571428,216.42857142857142,1.4873205919535955,281.66133710121215,"(52.0, 100.0]",Q4
36009,2020-06-02,76840,54,1,90,375,5588,1.1428571428571428,246.85714285714286,1.4873205919535955,321.2612478619767,"(52.0, 100.0]",Q4
36009,2020-06-03,76840,54,1,91,290,5878,0.8571428571428571,247.42857142857142,1.1154904439651967,322.0049081579534,"(52.0, 100.0]",Q4
36009,2020-06-04,76840,54,1,92,304,6182,0.8571428571428571,269.85714285714283,1.1154904439651967,351.19357477504275,"(52.0, 100.0]",Q4
36009,2020-06-05,76840,54,0,92,416,6598,0.7142857142857143,302.2857142857143,0.9295753699709972,393.39629657172605,"(52.0, 100.0]",Q4
36009,2020-06-06,76840,54,2,94,193,6791,0.8571428571428571,303.7142857142857,1.1154904439651967,395.255447311668,"(52.0, 100.0]",Q4
36009,2020-06-07,76840,54,1,95,245,7036,0.8571428571428571,308.0,1.1154904439651967,400.83289953149404,"(52.0, 100.0]",Q4
36011,2020-03-02,77145,40,0,0,0,0,0.0,0.0,0.0,0.0,"(37.5, 52.0]",Q3
36011,2020-03-03,77145,40,0,0,0,0,0.0,0.0,0.0,0.0,"(37.5, 52.0]",Q3
36011,2020-03-04,77145,40,0,0,0,0,0.0,0.0,0.0,0.0,"(37.5, 52.0]",Q3
36011,2020-03-05,77145,40,0,0,0,0,0.0,0.0,0.0,0.0,"(37.5, 52.0]",Q3
36011,2020-03-06,77145,40,0,0,0,0,0.0,0.0,0.0,0.0,"(37.5, 52.0]",Q3
36011,2020-03-07,77145,40,0,0,0,0,0.0,0.0,0.0,0.0,"(37.5, 52.0]",Q3
36011,2020-03-08,77145,40,0,0,0,0,0.0,0.0,0.0,0.0,"(37.5, 52.0]",Q3
36011,2020-03-09,77145,40,0,0,0,0,0.0,0.0,0.0,0.0,"(37.5, 52.0]",Q3
36011,2020-03-10,77145,40,0,0,0,0,0.0,0.0,0.0,0.0,"(37.5, 52.0]",Q3
36011,2020-03-11,77145,40,0,0,0,0,0.0,0.0,0.0,0.0,"(37.5, 52.0]",Q3
36011,2020-03-12,77145,40,0,0,0,0,0.0,0.0,0.0,0.0,"(37.5, 52.0]",Q3
36011,2020-03-13,77145,40,0,0,0,0,0.0,0.0,0.0,0.0,"(37.5, 52.0]",Q3
36011,2020-03-14,77145,40,0,0,3,3,0.0,0.42857142857142855,0.0,0.5555401238854476,"(37.5, 52.0]",Q3
36011,2020-03-15,77145,40,0,0,1,4,0.0,0.5714285714285714,0.0,0.7407201651805968,"(37.5, 52.0]",Q3
36011,2020-03-16,77145,40,0,0,2,6,0.0,0.8571428571428571,0.0,1.1110802477708952,"(37.5, 52.0]",Q3
36011,2020-03-17,77145,40,0,0,2,8,0.0,1.1428571428571428,0.0,1.4814403303611936,"(37.5, 52.0]",Q3
36011,2020-03-18,77145,40,0,0,2,10,0.0,1.4285714285714286,0.0,1.851800412951492,"(37.5, 52.0]",Q3
36011,2020-03-19,77145,40,0,0,3,13,0.0,1.8571428571428572,0.0,2.40734053683694,"(37.5, 52.0]",Q3
36011,2020-03-20,77145,40,0,0,8,21,0.0,3.0,0.0,3.8887808671981334,"(37.5, 52.0]",Q3
36011,2020-03-21,77145,40,0,0,25,46,0.0,6.142857142857143,0.0,7.962741775691416,"(37.5, 52.0]",Q3
36011,2020-03-22,77145,40,2,2,33,79,0.2857142857142857,10.714285714285714,0.3703600825902984,13.888503097136189,"(37.5, 52.0]",Q3
36011,2020-03-23,77145,40,0,2,10,89,0.2857142857142857,11.857142857142858,0.3703600825902984,15.369943427497384,"(37.5, 52.0]",Q3
36011,2020-03-24,77145,40,0,2,5,94,0.2857142857142857,12.285714285714286,0.3703600825902984,15.925483551382833,"(37.5, 52.0]",Q3
36011,2020-03-25,77145,40,0,2,13,107,0.2857142857142857,13.857142857142858,0.3703600825902984,17.962464005629474,"(37.5, 52.0]",Q3
36011,2020-03-26,77145,40,0,2,25,132,0.2857142857142857,17.0,0.3703600825902984,22.036424914122755,"(37.5, 52.0]",Q3
36011,2020-03-27,77145,40,0,2,26,158,0.2857142857142857,19.571428571428573,0.3703600825902984,25.369665657435444,"(37.5, 52.0]",Q3
36011,2020-03-28,77145,40,0,2,32,190,0.2857142857142857,20.571428571428573,0.3703600825902984,26.66592594650149,"(37.5, 52.0]",Q3
36011,2020-03-29,77145,40,1,3,37,227,0.14285714285714285,21.142857142857142,0.1851800412951492,27.406646111682083,"(37.5, 52.0]",Q3
36011,2020-03-30,77145,40,0,3,10,237,0.14285714285714285,21.142857142857142,0.1851800412951492,27.406646111682083,"(37.5, 52.0]",Q3
36011,2020-03-31,77145,40,0,3,9,246,0.14285714285714285,21.714285714285715,0.1851800412951492,28.14736627686268,"(37.5, 52.0]",Q3
36011,2020-04-01,77145,40,1,4,25,271,0.2857142857142857,23.428571428571427,0.3703600825902984,30.36952677240447,"(37.5, 52.0]",Q3
36011,2020-04-02,77145,40,2,6,36,307,0.5714285714285714,25.0,0.7407201651805968,32.40650722665111,"(37.5, 52.0]",Q3
36011,2020-04-03,77145,40,1,7,15,322,0.7142857142857143,23.428571428571427,0.925900206475746,30.36952677240447,"(37.5, 52.0]",Q3
36011,2020-04-04,77145,40,1,8,32,354,0.8571428571428571,23.428571428571427,1.1110802477708952,30.36952677240447,"(37.5, 52.0]",Q3
36011,2020-04-05,77145,40,3,11,31,385,1.1428571428571428,22.571428571428573,1.4814403303611936,29.25844652463358,"(37.5, 52.0]",Q3
36011,2020-04-06,77145,40,3,14,33,418,1.5714285714285714,25.857142857142858,2.036980454246641,33.51758747442201,"(37.5, 52.0]",Q3
36011,2020-04-07,77145,40,0,14,11,429,1.5714285714285714,26.142857142857142,2.036980454246641,33.8879475570123,"(37.5, 52.0]",Q3
36011,2020-04-08,77145,40,2,16,37,466,1.7142857142857142,27.857142857142858,2.2221604955417904,36.1101080525541,"(37.5, 52.0]",Q3
36011,2020-04-09,77145,40,11,27,31,497,3.0,27.142857142857142,3.8887808671981334,35.18420784607835,"(37.5, 52.0]",Q3
36011,2020-04-10,77145,40,1,28,5,502,3.0,25.714285714285715,3.8887808671981334,33.33240743312686,"(37.5, 52.0]",Q3
36011,2020-04-11,77145,40,1,29,8,510,3.0,22.285714285714285,3.8887808671981334,28.888086442043274,"(37.5, 52.0]",Q3
36011,2020-04-12,77145,40,1,30,5,515,2.7142857142857144,18.571428571428573,3.518420784607835,24.073405368369396,"(37.5, 52.0]",Q3
36011,2020-04-13,77145,40,3,33,52,567,2.7142857142857144,21.285714285714285,3.518420784607835,27.591826152977227,"(37.5, 52.0]",Q3
36011,2020-04-14,77145,40,3,36,10,577,3.142857142857143,21.142857142857142,4.073960908493282,27.406646111682083,"(37.5, 52.0]",Q3
36011,2020-04-15,77145,40,0,36,10,587,2.857142857142857,17.285714285714285,3.703600825902984,22.406784996713053,"(37.5, 52.0]",Q3
36011,2020-04-16,77145,40,0,36,1,588,1.2857142857142858,13.0,1.666620371656343,16.851383757858578,"(37.5, 52.0]",Q3
36011,2020-04-17,77145,40,0,36,9,597,1.1428571428571428,13.571428571428571,1.4814403303611936,17.592103923039176,"(37.5, 52.0]",Q3
36011,2020-04-18,77145,40,0,36,9,606,1.0,13.714285714285714,1.2962602890660446,17.777283964334323,"(37.5, 52.0]",Q3
36011,2020-04-19,77145,40,0,36,12,618,0.8571428571428571,14.714285714285714,1.1110802477708952,19.073544253400367,"(37.5, 52.0]",Q3
36011,2020-04-20,77145,40,0,36,1,619,0.42857142857142855,7.428571428571429,0.5555401238854476,9.62936214734776,"(37.5, 52.0]",Q3
36011,2020-04-21,77145,40,0,36,3,622,0.0,6.428571428571429,0.0,8.333101858281715,"(37.5, 52.0]",Q3
36011,2020-04-22,77145,40,1,37,12,634,0.14285714285714285,6.714285714285714,0.1851800412951492,8.703461940872012,"(37.5, 52.0]",Q3
36011,2020-04-23,77145,40,2,39,14,648,0.42857142857142855,8.571428571428571,0.5555401238854476,11.110802477708953,"(37.5, 52.0]",Q3
36011,2020-04-24,77145,40,8,47,191,839,1.5714285714285714,34.57142857142857,2.036980454246641,44.81356999342611,"(37.5, 52.0]",Q3
36011,2020-04-25,77145,40,0,47,19,858,1.5714285714285714,36.0,2.036980454246641,46.6653704063776,"(37.5, 52.0]",Q3
36011,2020-04-26,77145,40,1,48,20,878,1.7142857142857142,37.142857142857146,2.2221604955417904,48.14681073673879,"(37.5, 52.0]",Q3
36011,2020-04-27,77145,40,0,48,20,898,1.7142857142857142,39.857142857142854,2.2221604955417904,51.66523152134663,"(37.5, 52.0]",Q3
36011,2020-04-28,77145,40,0,48,34,932,1.7142857142857142,44.285714285714285,2.2221604955417904,57.40581280149626,"(37.5, 52.0]",Q3
36011,2020-04-29,77145,40,0,48,25,957,1.5714285714285714,46.142857142857146,2.036980454246641,59.8131533383332,"(37.5, 52.0]",Q3
36011,2020-04-30,77145,40,3,51,28,985,1.7142857142857142,48.142857142857146,2.2221604955417904,62.40567391646529,"(37.5, 52.0]",Q3
36011,2020-05-01,77145,40,0,51,17,1002,0.5714285714285714,23.285714285714285,0.7407201651805968,30.18434673110932,"(37.5, 52.0]",Q3
36011,2020-05-02,77145,40,0,51,14,1016,0.5714285714285714,22.571428571428573,0.7407201651805968,29.25844652463358,"(37.5, 52.0]",Q3
36011,2020-05-03,77145,40,0,51,10,1026,0.42857142857142855,21.142857142857142,0.5555401238854476,27.406646111682083,"(37.5, 52.0]",Q3
36011,2020-05-04,77145,40,0,51,22,1048,0.42857142857142855,21.428571428571427,0.5555401238854476,27.777006194272378,"(37.5, 52.0]",Q3
36011,2020-05-05,77145,40,0,51,19,1067,0.42857142857142855,19.285714285714285,0.5555401238854476,24.999305574845142,"(37.5, 52.0]",Q3
36011,2020-05-06,77145,40,1,52,25,1092,0.5714285714285714,19.285714285714285,0.7407201651805968,24.999305574845142,"(37.5, 52.0]",Q3
36011,2020-05-07,77145,40,0,52,20,1112,0.14285714285714285,18.142857142857142,0.1851800412951492,23.517865244483946,"(37.5, 52.0]",Q3
36011,2020-05-08,77145,40,1,53,61,1173,0.2857142857142857,24.428571428571427,0.3703600825902984,31.665787061470514,"(37.5, 52.0]",Q3
36011,2020-05-09,77145,40,5,58,23,1196,1.0,25.714285714285715,1.2962602890660446,33.33240743312686,"(37.5, 52.0]",Q3
36011,2020-05-10,77145,40,2,60,48,1244,1.2857142857142858,31.142857142857142,1.666620371656343,40.36924900234253,"(37.5, 52.0]",Q3
36011,2020-05-11,77145,40,0,60,23,1267,1.2857142857142858,31.285714285714285,1.666620371656343,40.554429043637676,"(37.5, 52.0]",Q3
36011,2020-05-12,77145,40,0,60,45,1312,1.2857142857142858,35.0,1.666620371656343,45.36911011731156,"(37.5, 52.0]",Q3
36011,2020-05-13,77145,40,0,60,104,1416,1.1428571428571428,46.285714285714285,1.4814403303611936,59.998333379628335,"(37.5, 52.0]",Q3
36011,2020-05-14,77145,40,1,61,261,1677,1.2857142857142858,80.71428571428571,1.666620371656343,104.6267233317593,"(37.5, 52.0]",Q3
36011,2020-05-15,77145,40,2,63,111,1788,1.4285714285714286,87.85714285714286,1.851800412951492,113.88572539651678,"(37.5, 52.0]",Q3
36011,2020-05-16,77145,40,0,63,79,1867,0.7142857142857143,95.85714285714286,0.925900206475746,124.25580770904511,"(37.5, 52.0]",Q3
36011,2020-05-17,77145,40,2,65,189,2056,0.7142857142857143,116.0,0.925900206475746,150.36619353166117,"(37.5, 52.0]",Q3
36011,2020-05-18,77145,40,3,68,68,2124,1.1428571428571428,122.42857142857143,1.4814403303611936,158.69929538994288,"(37.5, 52.0]",Q3
36011,2020-05-19,77145,40,0,68,106,2230,1.1428571428571428,131.14285714285714,1.4814403303611936,169.99527790894697,"(37.5, 52.0]",Q3
36011,2020-05-20,77145,40,4,72,105,2335,1.7142857142857142,131.28571428571428,2.2221604955417904,170.18045795024213,"(37.5, 52.0]",Q3
36011,2020-05-21,77145,40,1,73,245,2580,1.7142857142857142,129.0,2.2221604955417904,167.21757728951974,"(37.5, 52.0]",Q3
36011,2020-05-22,77145,40,3,76,356,2936,1.8571428571428572,164.0,2.40734053683694,212.58668740683132,"(37.5, 52.0]",Q3
36011,2020-05-23,77145,40,1,77,143,3079,2.0,173.14285714285714,2.5925205781320892,224.43821004972082,"(37.5, 52.0]",Q3
36011,2020-05-24,77145,40,0,77,176,3255,1.7142857142857142,171.28571428571428,2.2221604955417904,222.0308695128839,"(37.5, 52.0]",Q3
36011,2020-05-25,77145,40,1,78,76,3331,1.4285714285714286,172.42857142857142,1.851800412951492,223.51230984324508,"(37.5, 52.0]",Q3
36011,2020-05-26,77145,40,2,80,117,3448,1.7142857142857142,174.0,2.2221604955417904,225.54929029749175,"(37.5, 52.0]",Q3
36011,2020-05-27,77145,40,4,84,101,3549,1.7142857142857142,173.42857142857142,2.2221604955417904,224.8085701323111,"(37.5, 52.0]",Q3
36011,2020-05-28,77145,40,5,89,383,3932,2.2857142857142856,193.14285714285714,2.962880660722387,250.36341583104172,"(37.5, 52.0]",Q3
36011,2020-05-29,77145,40,1,90,374,4306,2.0,195.71428571428572,2.5925205781320892,253.69665657435442,"(37.5, 52.0]",Q3
36011,2020-05-30,77145,40,1,91,249,4555,2.0,210.85714285714286,2.5925205781320892,273.3257409516402,"(37.5, 52.0]",Q3
36011,2020-05-31,77145,40,1,92,289,4844,2.142857142857143,227.0,2.7777006194272382,294.2510856179921,"(37.5, 52.0]",Q3
36011,2020-06-01,77145,40,1,93,250,5094,2.142857142857143,251.85714285714286,2.7777006194272382,326.47241280334805,"(37.5, 52.0]",Q3
36011,2020-06-02,77145,40,3,96,288,5382,2.2857142857142856,276.2857142857143,2.962880660722387,358.13819986481855,"(37.5, 52.0]",Q3
36011,2020-06-03,77145,40,0,96,375,5757,1.7142857142857142,315.42857142857144,2.2221604955417904,408.87753117968947,"(37.5, 52.0]",Q3
36011,2020-06-04,77145,40,2,98,375,6132,1.2857142857142858,314.2857142857143,1.666620371656343,407.39609084932823,"(37.5, 52.0]",Q3
36011,2020-06-05,77145,40,2,100,299,6431,1.4285714285714286,303.57142857142856,1.851800412951492,393.507587752192,"(37.5, 52.0]",Q3
36011,2020-06-06,77145,40,1,101,233,6664,1.4285714285714286,301.2857142857143,1.851800412951492,390.54470709146966,"(37.5, 52.0]",Q3
36011,2020-06-07,77145,40,0,101,465,7129,1.2857142857142858,326.42857142857144,1.666620371656343,423.13639435941593,"(37.5, 52.0]",Q3
36013,2020-03-02,127939,53,0,0,0,0,0.0,0.0,0.0,0.0,"(52.0, 100.0]",Q4
36013,2020-03-03,127939,53,0,0,0,0,0.0,0.0,0.0,0.0,"(52.0, 100.0]",Q4
36013,2020-03-04,127939,53,0,0,0,0,0.0,0.0,0.0,0.0,"(52.0, 100.0]",Q4
36013,2020-03-05,127939,53,0,0,0,0,0.0,0.0,0.0,0.0,"(52.0, 100.0]",Q4
36013,2020-03-06,127939,53,0,0,0,0,0.0,0.0,0.0,0.0,"(52.0, 100.0]",Q4
36013,2020-03-07,127939,53,0,0,0,0,0.0,0.0,0.0,0.0,"(52.0, 100.0]",Q4
36013,2020-03-08,127939,53,0,0,0,0,0.0,0.0,0.0,0.0,"(52.0, 100.0]",Q4
36013,2020-03-09,127939,53,0,0,0,0,0.0,0.0,0.0,0.0,"(52.0, 100.0]",Q4
36013,2020-03-10,127939,53,0,0,0,0,0.0,0.0,0.0,0.0,"(52.0, 100.0]",Q4
36013,2020-03-11,127939,53,0,0,0,0,0.0,0.0,0.0,0.0,"(52.0, 100.0]",Q4
36013,2020-03-12,127939,53,0,0,1,1,0.0,0.14285714285714285,0.0,0.11166035599554698,"(52.0, 100.0]",Q4
36013,2020-03-13,127939,53,0,0,1,2,0.0,0.2857142857142857,0.0,0.22332071199109396,"(52.0, 100.0]",Q4
36013,2020-03-14,127939,53,0,0,0,2,0.0,0.2857142857142857,0.0,0.22332071199109396,"(52.0, 100.0]",Q4
36013,2020-03-15,127939,53,0,0,1,3,0.0,0.42857142857142855,0.0,0.3349810679866409,"(52.0, 100.0]",Q4
36013,2020-03-16,127939,53,0,0,0,3,0.0,0.42857142857142855,0.0,0.3349810679866409,"(52.0, 100.0]",Q4
36013,2020-03-17,127939,53,0,0,0,3,0.0,0.42857142857142855,0.0,0.3349810679866409,"(52.0, 100.0]",Q4
36013,2020-03-18,127939,53,0,0,3,6,0.0,0.8571428571428571,0.0,0.6699621359732818,"(52.0, 100.0]",Q4
36013,2020-03-19,127939,53,0,0,1,7,0.0,0.8571428571428571,0.0,0.6699621359732818,"(52.0, 100.0]",Q4
36013,2020-03-20,127939,53,0,0,2,9,0.0,1.0,0.0,0.7816224919688289,"(52.0, 100.0]",Q4
36013,2020-03-21,127939,53,0,0,4,13,0.0,1.5714285714285714,0.0,1.228263915951017,"(52.0, 100.0]",Q4
36013,2020-03-22,127939,53,0,0,12,25,0.0,3.142857142857143,0.0,2.456527831902034,"(52.0, 100.0]",Q4
36013,2020-03-23,127939,53,0,0,4,29,0.0,3.7142857142857144,0.0,2.903169255884222,"(52.0, 100.0]",Q4
36013,2020-03-24,127939,53,1,1,3,32,0.14285714285714285,4.142857142857143,0.11166035599554698,3.2381503238708627,"(52.0, 100.0]",Q4
36013,2020-03-25,127939,53,0,1,4,36,0.14285714285714285,4.285714285714286,0.11166035599554698,3.349810679866409,"(52.0, 100.0]",Q4
36013,2020-03-26,127939,53,0,1,20,56,0.14285714285714285,7.0,0.11166035599554698,5.471357443781802,"(52.0, 100.0]",Q4
36013,2020-03-27,127939,53,4,5,19,75,0.7142857142857143,9.428571428571429,0.558301779977735,7.3695834957061015,"(52.0, 100.0]",Q4
36013,2020-03-28,127939,53,0,5,20,95,0.7142857142857143,11.714285714285714,0.558301779977735,9.156149191634851,"(52.0, 100.0]",Q4
36013,2020-03-29,127939,53,0,5,3,98,0.7142857142857143,10.428571428571429,0.558301779977735,8.15120598767493,"(52.0, 100.0]",Q4
36013,2020-03-30,127939,53,1,6,9,107,0.8571428571428571,11.142857142857142,0.6699621359732818,8.709507767652665,"(52.0, 100.0]",Q4
36013,2020-03-31,127939,53,0,6,9,116,0.7142857142857143,12.0,0.558301779977735,9.379469903625946,"(52.0, 100.0]",Q4
36013,2020-04-01,127939,53,2,8,8,124,1.0,12.571428571428571,0.7816224919688289,9.826111327608135,"(52.0, 100.0]",Q4
36013,2020-04-02,127939,53,1,9,15,139,1.1428571428571428,11.857142857142858,0.8932828479643758,9.2678095476304,"(52.0, 100.0]",Q4
36013,2020-04-03,127939,53,1,10,20,159,0.7142857142857143,12.0,0.558301779977735,9.379469903625946,"(52.0, 100.0]",Q4
36013,2020-04-04,127939,53,1,11,28,187,0.8571428571428571,13.142857142857142,0.6699621359732818,10.272752751590323,"(52.0, 100.0]",Q4
36013,2020-04-05,127939,53,4,15,50,237,1.4285714285714286,19.857142857142858,1.11660355995547,15.52078948338103,"(52.0, 100.0]",Q4
36013,2020-04-06,127939,53,1,16,37,274,1.4285714285714286,23.857142857142858,1.11660355995547,18.647279451256345,"(52.0, 100.0]",Q4
36013,2020-04-07,127939,53,1,17,6,280,1.5714285714285714,23.428571428571427,1.228263915951017,18.312298383269702,"(52.0, 100.0]",Q4
36013,2020-04-08,127939,53,1,18,32,312,1.4285714285714286,26.857142857142858,1.11660355995547,20.992146927162832,"(52.0, 100.0]",Q4
36013,2020-04-09,127939,53,2,20,54,366,1.5714285714285714,32.42857142857143,1.228263915951017,25.346900810989165,"(52.0, 100.0]",Q4
36013,2020-04-10,127939,53,1,21,67,433,1.5714285714285714,39.142857142857146,1.228263915951017,30.594937542779878,"(52.0, 100.0]",Q4
36013,2020-04-11,127939,53,1,22,39,472,1.5714285714285714,40.714285714285715,1.228263915951017,31.82320145873089,"(52.0, 100.0]",Q4
36013,2020-04-12,127939,53,1,23,25,497,1.1428571428571428,37.142857142857146,0.8932828479643758,29.03169255884222,"(52.0, 100.0]",Q4
36013,2020-04-13,127939,53,0,23,8,505,1.0,33.0,0.7816224919688289,25.79354223497135,"(52.0, 100.0]",Q4
36013,2020-04-14,127939,53,1,24,19,524,1.0,34.857142857142854,0.7816224919688289,27.245126862913462,"(52.0, 100.0]",Q4
36013,2020-04-15,127939,53,0,24,29,553,0.8571428571428571,34.42857142857143,0.6699621359732818,26.910145794926823,"(52.0, 100.0]",Q4
36013,2020-04-16,127939,53,1,25,32,585,0.7142857142857143,31.285714285714285,0.558301779977735,24.45361796302479,"(52.0, 100.0]",Q4
36013,2020-04-17,127939,53,0,25,22,607,0.5714285714285714,24.857142857142858,0.4466414239821879,19.428901943225174,"(52.0, 100.0]",Q4
36013,2020-04-18,127939,53,0,25,20,627,0.42857142857142855,22.142857142857142,0.3349810679866409,17.307355179309784,"(52.0, 100.0]",Q4
36013,2020-04-19,127939,53,0,25,9,636,0.2857142857142857,19.857142857142858,0.22332071199109396,15.52078948338103,"(52.0, 100.0]",Q4
36013,2020-04-20,127939,53,0,25,3,639,0.2857142857142857,19.142857142857142,0.22332071199109396,14.962487703403296,"(52.0, 100.0]",Q4
36013,2020-04-21,127939,53,1,26,26,665,0.2857142857142857,20.142857142857142,0.22332071199109396,15.744110195372123,"(52.0, 100.0]",Q4
36013,2020-04-22,127939,53,0,26,38,703,0.2857142857142857,21.428571428571427,0.22332071199109396,16.74905339933205,"(52.0, 100.0]",Q4
36013,2020-04-23,127939,53,1,27,74,777,0.2857142857142857,27.428571428571427,0.22332071199109396,21.438788351145018,"(52.0, 100.0]",Q4
36013,2020-04-24,127939,53,0,27,97,874,0.2857142857142857,38.142857142857146,0.22332071199109396,29.81331505081105,"(52.0, 100.0]",Q4
36013,2020-04-25,127939,53,2,29,56,930,0.5714285714285714,43.285714285714285,0.4466414239821879,33.833087866650736,"(52.0, 100.0]",Q4
36013,2020-04-26,127939,53,1,30,101,1031,0.7142857142857143,56.42857142857143,0.558301779977735,44.10584061824106,"(52.0, 100.0]",Q4
36013,2020-04-27,127939,53,0,30,26,1057,0.7142857142857143,59.714285714285715,0.558301779977735,46.674028806138644,"(52.0, 100.0]",Q4
36013,2020-04-28,127939,53,1,31,64,1121,0.7142857142857143,65.14285714285714,0.558301779977735,50.91712233396942,"(52.0, 100.0]",Q4
36013,2020-04-29,127939,53,2,33,39,1160,1.0,65.28571428571429,0.7816224919688289,51.02878268996498,"(52.0, 100.0]",Q4
36013,2020-04-30,127939,53,2,35,47,1207,1.1428571428571428,61.42857142857143,0.8932828479643758,48.0139530780852,"(52.0, 100.0]",Q4
36013,2020-05-01,127939,53,0,35,53,1260,1.1428571428571428,55.142857142857146,0.8932828479643758,43.100897414281135,"(52.0, 100.0]",Q4
36013,2020-05-02,127939,53,1,36,18,1278,1.0,49.714285714285715,0.7816224919688289,38.85780388645035,"(52.0, 100.0]",Q4
36013,2020-05-03,127939,53,1,37,9,1287,1.0,36.57142857142857,0.7816224919688289,28.585051134860027,"(52.0, 100.0]",Q4
36013,2020-05-04,127939,53,0,37,54,1341,1.0,40.57142857142857,0.7816224919688289,31.71154110273534,"(52.0, 100.0]",Q4
36013,2020-05-05,127939,53,1,38,88,1429,1.0,44.0,0.7816224919688289,34.391389646628475,"(52.0, 100.0]",Q4
36013,2020-05-06,127939,53,2,40,80,1509,1.0,49.857142857142854,0.7816224919688289,38.969464242445895,"(52.0, 100.0]",Q4
36013,2020-05-07,127939,53,0,40,51,1560,0.7142857142857143,50.42857142857143,0.558301779977735,39.41610566642809,"(52.0, 100.0]",Q4
36013,2020-05-08,127939,53,0,40,97,1657,0.7142857142857143,56.714285714285715,0.558301779977735,44.329161330232154,"(52.0, 100.0]",Q4
36013,2020-05-09,127939,53,1,41,58,1715,0.7142857142857143,62.42857142857143,0.558301779977735,48.795575570054034,"(52.0, 100.0]",Q4
36013,2020-05-10,127939,53,0,41,27,1742,0.5714285714285714,65.0,0.4466414239821879,50.80546197797388,"(52.0, 100.0]",Q4
36013,2020-05-11,127939,53,1,42,49,1791,0.7142857142857143,64.28571428571429,0.558301779977735,50.24716019799615,"(52.0, 100.0]",Q4
36013,2020-05-12,127939,53,1,43,125,1916,0.7142857142857143,69.57142857142857,0.558301779977735,54.378593369831385,"(52.0, 100.0]",Q4
36013,2020-05-13,127939,53,1,44,125,2041,0.5714285714285714,76.0,0.4466414239821879,59.403309389631,"(52.0, 100.0]",Q4
36013,2020-05-14,127939,53,1,45,139,2180,0.7142857142857143,88.57142857142857,0.558301779977735,69.22942071723914,"(52.0, 100.0]",Q4
36013,2020-05-15,127939,53,3,48,60,2240,1.1428571428571428,83.28571428571429,0.8932828479643758,65.0979875454039,"(52.0, 100.0]",Q4
36013,2020-05-16,127939,53,0,48,91,2331,1.0,88.0,0.7816224919688289,68.78277929325695,"(52.0, 100.0]",Q4
36013,2020-05-17,127939,53,1,49,63,2394,1.1428571428571428,93.14285714285714,0.8932828479643758,72.80255210909662,"(52.0, 100.0]",Q4
36013,2020-05-18,127939,53,0,49,98,2492,1.0,100.14285714285714,0.7816224919688289,78.27390955287842,"(52.0, 100.0]",Q4
36013,2020-05-19,127939,53,1,50,90,2582,1.0,95.14285714285714,0.7816224919688289,74.36579709303429,"(52.0, 100.0]",Q4
36013,2020-05-20,127939,53,8,58,273,2855,2.0,116.28571428571429,1.5632449839376579,90.89152978037525,"(52.0, 100.0]",Q4
36013,2020-05-21,127939,53,5,63,190,3045,2.5714285714285716,123.57142857142857,2.0098864079198457,96.58620793614814,"(52.0, 100.0]",Q4
36013,2020-05-22,127939,53,9,72,217,3262,3.4285714285714284,146.0,2.679848543893127,114.11688382744902,"(52.0, 100.0]",Q4
36013,2020-05-23,127939,53,3,75,134,3396,3.857142857142857,152.14285714285714,3.0148296118797684,118.91827913525752,"(52.0, 100.0]",Q4
36013,2020-05-24,127939,53,0,75,38,3434,3.7142857142857144,148.57142857142858,2.903169255884222,116.12677023536888,"(52.0, 100.0]",Q4
36013,2020-05-25,127939,53,2,77,94,3528,4.0,148.0,3.1264899678753157,115.68012881138668,"(52.0, 100.0]",Q4
36013,2020-05-26,127939,53,1,78,145,3673,4.0,155.85714285714286,3.1264899678753157,121.82144839114177,"(52.0, 100.0]",Q4
36013,2020-05-27,127939,53,3,81,129,3802,3.2857142857142856,135.28571428571428,2.5681881878975807,105.742357127783,"(52.0, 100.0]",Q4
36013,2020-05-28,127939,53,1,82,637,4439,2.7142857142857144,199.14285714285714,2.1215467639153927,155.6545362577925,"(52.0, 100.0]",Q4
36013,2020-05-29,127939,53,1,83,272,4711,1.5714285714285714,207.0,1.228263915951017,161.7958558375476,"(52.0, 100.0]",Q4
36013,2020-05-30,127939,53,1,84,637,5348,1.2857142857142858,278.85714285714283,1.0049432039599229,217.9610149033077,"(52.0, 100.0]",Q4
36013,2020-05-31,127939,53,1,85,253,5601,1.4285714285714286,309.57142857142856,1.11660355995547,241.96799144235032,"(52.0, 100.0]",Q4
36013,2020-06-01,127939,53,1,86,184,5785,1.2857142857142858,322.42857142857144,1.0049432039599229,252.01742348194955,"(52.0, 100.0]",Q4
36013,2020-06-02,127939,53,3,89,277,6062,1.5714285714285714,341.2857142857143,1.228263915951017,266.7565904733617,"(52.0, 100.0]",Q4
36013,2020-06-03,127939,53,6,95,604,6666,2.0,409.14285714285717,1.5632449839376579,319.7952595712466,"(52.0, 100.0]",Q4
36013,2020-06-04,127939,53,2,97,522,7188,2.142857142857143,392.7142857142857,1.6749053399332046,306.95431863175867,"(52.0, 100.0]",Q4
36013,2020-06-05,127939,53,2,99,364,7552,2.2857142857142856,405.85714285714283,1.7865656959287517,317.22707138334897,"(52.0, 100.0]",Q4
36013,2020-06-06,127939,53,2,101,1131,8683,2.4285714285714284,476.42857142857144,1.8982260519242988,372.3872872451492,"(52.0, 100.0]",Q4
36013,2020-06-07,127939,53,0,101,343,9026,2.2857142857142856,489.2857142857143,1.7865656959287517,382.4367192847484,"(52.0, 100.0]",Q4
36015,2020-03-02,84254,38,0,0,0,0,0.0,0.0,0.0,0.0,"(37.5, 52.0]",Q3
36015,2020-03-03,84254,38,0,0,0,0,0.0,0.0,0.0,0.0,"(37.5, 52.0]",Q3
36015,2020-03-04,84254,38,0,0,0,0,0.0,0.0,0.0,0.0,"(37.5, 52.0]",Q3
36015,2020-03-05,84254,38,0,0,0,0,0.0,0.0,0.0,0.0,"(37.5, 52.0]",Q3
36015,2020-03-06,84254,38,0,0,0,0,0.0,0.0,0.0,0.0,"(37.5, 52.0]",Q3
36015,2020-03-07,84254,38,0,0,0,0,0.0,0.0,0.0,0.0,"(37.5, 52.0]",Q3
36015,2020-03-08,84254,38,0,0,0,0,0.0,0.0,0.0,0.0,"(37.5, 52.0]",Q3
36015,2020-03-09,84254,38,0,0,0,0,0.0,0.0,0.0,0.0,"(37.5, 52.0]",Q3
36015,2020-03-10,84254,38,0,0,1,1,0.0,0.14285714285714285,0.0,0.1695553242067354,"(37.5, 52.0]",Q3
36015,2020-03-11,84254,38,0,0,0,1,0.0,0.14285714285714285,0.0,0.1695553242067354,"(37.5, 52.0]",Q3
36015,2020-03-12,84254,38,0,0,0,1,0.0,0.14285714285714285,0.0,0.1695553242067354,"(37.5, 52.0]",Q3
36015,2020-03-13,84254,38,0,0,0,1,0.0,0.14285714285714285,0.0,0.1695553242067354,"(37.5, 52.0]",Q3
36015,2020-03-14,84254,38,0,0,0,1,0.0,0.14285714285714285,0.0,0.1695553242067354,"(37.5, 52.0]",Q3
36015,2020-03-15,84254,38,0,0,1,2,0.0,0.2857142857142857,0.0,0.3391106484134708,"(37.5, 52.0]",Q3
36015,2020-03-16,84254,38,0,0,0,2,0.0,0.2857142857142857,0.0,0.3391106484134708,"(37.5, 52.0]",Q3
36015,2020-03-17,84254,38,0,0,0,2,0.0,0.14285714285714285,0.0,0.1695553242067354,"(37.5, 52.0]",Q3
36015,2020-03-18,84254,38,0,0,2,4,0.0,0.42857142857142855,0.0,0.5086659726202062,"(37.5, 52.0]",Q3
36015,2020-03-19,84254,38,0,0,6,10,0.0,1.2857142857142858,0.0,1.525997917860619,"(37.5, 52.0]",Q3
36015,2020-03-20,84254,38,0,0,10,20,0.0,2.7142857142857144,0.0,3.2215511599279734,"(37.5, 52.0]",Q3
36015,2020-03-21,84254,38,0,0,2,22,0.0,3.0,0.0,3.5606618083414436,"(37.5, 52.0]",Q3
36015,2020-03-22,84254,38,0,0,17,39,0.0,5.285714285714286,0.0,6.27354699564921,"(37.5, 52.0]",Q3
36015,2020-03-23,84254,38,1,1,17,56,0.14285714285714285,7.714285714285714,0.1695553242067354,9.155987507163712,"(37.5, 52.0]",Q3
36015,2020-03-24,84254,38,0,1,5,61,0.14285714285714285,8.428571428571429,0.1695553242067354,10.003764128197389,"(37.5, 52.0]",Q3
36015,2020-03-25,84254,38,6,7,57,118,1.0,16.285714285714285,1.186887269447148,19.329306959567834,"(37.5, 52.0]",Q3
36015,2020-03-26,84254,38,4,11,48,166,1.5714285714285714,22.285714285714285,1.8651085662740896,26.450630576250724,"(37.5, 52.0]",Q3
36015,2020-03-27,84254,38,1,12,48,214,1.7142857142857142,27.714285714285715,2.0346638904808247,32.89373289610667,"(37.5, 52.0]",Q3
36015,2020-03-28,84254,38,3,15,25,239,2.142857142857143,31.0,2.543329863101031,36.79350535286159,"(37.5, 52.0]",Q3
36015,2020-03-29,84254,38,0,15,7,246,2.142857142857143,29.571428571428573,2.543329863101031,35.09795211079423,"(37.5, 52.0]",Q3
36015,2020-03-30,84254,38,5,20,47,293,2.7142857142857144,33.857142857142854,3.2215511599279734,40.18461183699629,"(37.5, 52.0]",Q3
36015,2020-03-31,84254,38,2,22,42,335,3.0,39.142857142857146,3.5606618083414436,46.45815883264551,"(37.5, 52.0]",Q3
36015,2020-04-01,84254,38,0,22,14,349,2.142857142857143,33.0,2.543329863101031,39.16727989175588,"(37.5, 52.0]",Q3
36015,2020-04-02,84254,38,13,35,84,433,3.4285714285714284,38.142857142857146,4.0693277809616495,45.27127156319836,"(37.5, 52.0]",Q3
36015,2020-04-03,84254,38,1,36,28,461,3.4285714285714284,35.285714285714285,4.0693277809616495,41.880165079063644,"(37.5, 52.0]",Q3
36015,2020-04-04,84254,38,2,38,35,496,3.2857142857142856,36.714285714285715,3.899772456754914,43.575718321131006,"(37.5, 52.0]",Q3
36015,2020-04-05,84254,38,9,47,50,546,4.571428571428571,42.857142857142854,5.425770374615533,50.86659726202062,"(37.5, 52.0]",Q3
36015,2020-04-06,84254,38,2,49,22,568,4.142857142857143,39.285714285714285,4.917104401995328,46.62771415685224,"(37.5, 52.0]",Q3
36015,2020-04-07,84254,38,6,55,56,624,4.714285714285714,41.285714285714285,5.595325698822268,49.00148869574654,"(37.5, 52.0]",Q3
36015,2020-04-08,84254,38,4,59,38,662,5.285714285714286,44.714285714285715,6.27354699564921,53.07081647670819,"(37.5, 52.0]",Q3
36015,2020-04-09,84254,38,0,59,39,701,3.4285714285714284,38.285714285714285,4.0693277809616495,45.44082688740509,"(37.5, 52.0]",Q3
36015,2020-04-10,84254,38,1,60,26,727,3.4285714285714284,38.0,4.0693277809616495,45.10171623899162,"(37.5, 52.0]",Q3
36015,2020-04-11,84254,38,0,60,6,733,3.142857142857143,33.857142857142854,3.730217132548179,40.18461183699629,"(37.5, 52.0]",Q3
36015,2020-04-12,84254,38,0,60,9,742,1.8571428571428572,28.0,2.2042192146875608,33.23284354452014,"(37.5, 52.0]",Q3
36015,2020-04-13,84254,38,4,64,40,782,2.142857142857143,30.571428571428573,2.543329863101031,36.28483938024139,"(37.5, 52.0]",Q3
36015,2020-04-14,84254,38,5,69,43,825,2.0,28.714285714285715,2.373774538894296,34.080620165553825,"(37.5, 52.0]",Q3
36015,2020-04-15,84254,38,1,70,18,843,1.5714285714285714,25.857142857142858,1.8651085662740896,30.68951368141911,"(37.5, 52.0]",Q3
36015,2020-04-16,84254,38,1,71,9,852,1.7142857142857142,21.571428571428573,2.0346638904808247,25.60285395521705,"(37.5, 52.0]",Q3
36015,2020-04-17,84254,38,1,72,32,884,1.7142857142857142,22.428571428571427,2.0346638904808247,26.62018590045746,"(37.5, 52.0]",Q3
36015,2020-04-18,84254,38,1,73,15,899,1.8571428571428572,23.714285714285715,2.2042192146875608,28.14618381831808,"(37.5, 52.0]",Q3
36015,2020-04-19,84254,38,0,73,17,916,1.8571428571428572,24.857142857142858,2.2042192146875608,29.502626411971963,"(37.5, 52.0]",Q3
36015,2020-04-20,84254,38,2,75,32,948,1.5714285714285714,23.714285714285715,1.8651085662740896,28.14618381831808,"(37.5, 52.0]",Q3
36015,2020-04-21,84254,38,0,75,38,986,0.8571428571428571,23.0,1.0173319452404124,27.2984071972844,"(37.5, 52.0]",Q3
36015,2020-04-22,84254,38,1,76,29,1015,0.8571428571428571,24.571428571428573,1.0173319452404124,29.163515763558493,"(37.5, 52.0]",Q3
36015,2020-04-23,84254,38,3,79,39,1054,1.1428571428571428,28.857142857142858,1.3564425936538833,34.25017548976055,"(37.5, 52.0]",Q3
36015,2020-04-24,84254,38,24,103,228,1282,4.428571428571429,56.857142857142854,5.256215050408798,67.48301903428069,"(37.5, 52.0]",Q3
36015,2020-04-25,84254,38,3,106,17,1299,4.714285714285714,57.142857142857146,5.595325698822268,67.82212968269417,"(37.5, 52.0]",Q3
36015,2020-04-26,84254,38,2,108,20,1319,5.0,57.57142857142857,5.9344363472357395,68.33079565531438,"(37.5, 52.0]",Q3
36015,2020-04-27,84254,38,5,113,64,1383,5.428571428571429,62.142857142857146,6.443102319855947,73.75656602992991,"(37.5, 52.0]",Q3
36015,2020-04-28,84254,38,6,119,96,1479,6.285714285714286,70.42857142857143,7.460434265096358,83.59077483392056,"(37.5, 52.0]",Q3
36015,2020-04-29,84254,38,3,122,84,1563,6.571428571428571,78.28571428571429,7.799544913509828,92.91631766529102,"(37.5, 52.0]",Q3
36015,2020-04-30,84254,38,1,123,54,1617,6.285714285714286,80.42857142857143,7.460434265096358,95.45964752839204,"(37.5, 52.0]",Q3
36015,2020-05-01,84254,38,1,124,36,1653,3.0,53.0,3.5606618083414436,62.90502528069884,"(37.5, 52.0]",Q3
36015,2020-05-02,84254,38,1,125,26,1679,2.7142857142857144,54.285714285714285,3.2215511599279734,64.43102319855946,"(37.5, 52.0]",Q3
36015,2020-05-03,84254,38,1,126,244,1923,2.5714285714285716,86.28571428571429,3.051995835721238,102.4114158208682,"(37.5, 52.0]",Q3
36015,2020-05-04,84254,38,0,126,154,2077,1.8571428571428572,99.14285714285714,2.2042192146875608,117.67139499947437,"(37.5, 52.0]",Q3
36015,2020-05-05,84254,38,2,128,143,2220,1.2857142857142858,105.85714285714286,1.525997917860619,125.64049523719095,"(37.5, 52.0]",Q3
36015,2020-05-06,84254,38,1,129,89,2309,1.0,106.57142857142857,1.186887269447148,126.48827185822462,"(37.5, 52.0]",Q3
36015,2020-05-07,84254,38,1,130,46,2355,1.0,105.42857142857143,1.186887269447148,125.13182926457073,"(37.5, 52.0]",Q3
36015,2020-05-08,84254,38,1,131,108,2463,1.0,115.71428571428571,1.186887269447148,137.33981260745568,"(37.5, 52.0]",Q3
36015,2020-05-09,84254,38,0,131,125,2588,0.8571428571428571,129.85714285714286,1.0173319452404124,154.1257897039225,"(37.5, 52.0]",Q3
36015,2020-05-10,84254,38,0,131,174,2762,0.7142857142857143,119.85714285714286,0.847776621033677,142.256917009451,"(37.5, 52.0]",Q3
36015,2020-05-11,84254,38,0,131,68,2830,0.7142857142857143,107.57142857142857,0.847776621033677,127.67515912767178,"(37.5, 52.0]",Q3
36015,2020-05-12,84254,38,1,132,282,3112,0.5714285714285714,127.42857142857143,0.6782212968269417,151.243349192408,"(37.5, 52.0]",Q3
36015,2020-05-13,84254,38,0,132,312,3424,0.42857142857142855,159.28571428571428,0.5086659726202062,189.05418649050998,"(37.5, 52.0]",Q3
36015,2020-05-14,84254,38,1,133,234,3658,0.42857142857142855,186.14285714285714,0.5086659726202062,220.93058744137622,"(37.5, 52.0]",Q3
36015,2020-05-15,84254,38,1,134,240,3898,0.42857142857142855,205.0,0.5086659726202062,243.31189023666533,"(37.5, 52.0]",Q3
36015,2020-05-16,84254,38,0,134,106,4004,0.42857142857142855,202.28571428571428,0.5086659726202062,240.09033907673737,"(37.5, 52.0]",Q3
36015,2020-05-17,84254,38,0,134,68,4072,0.42857142857142855,187.14285714285714,0.5086659726202062,222.11747471082342,"(37.5, 52.0]",Q3
36015,2020-05-18,84254,38,0,134,118,4190,0.42857142857142855,194.28571428571428,0.5086659726202062,230.59524092116015,"(37.5, 52.0]",Q3
36015,2020-05-19,84254,38,0,134,113,4303,0.2857142857142857,170.14285714285714,0.3391106484134708,201.94039113022188,"(37.5, 52.0]",Q3
36015,2020-05-20,84254,38,0,134,91,4394,0.2857142857142857,138.57142857142858,0.3391106484134708,164.46866448053336,"(37.5, 52.0]",Q3
36015,2020-05-21,84254,38,1,135,141,4535,0.2857142857142857,125.28571428571429,0.3391106484134708,148.70001932930697,"(37.5, 52.0]",Q3
36015,2020-05-22,84254,38,1,136,233,4768,0.2857142857142857,124.28571428571429,0.3391106484134708,147.51313205985983,"(37.5, 52.0]",Q3
36015,2020-05-23,84254,38,0,136,215,4983,0.2857142857142857,139.85714285714286,0.3391106484134708,165.99466239839398,"(37.5, 52.0]",Q3
36015,2020-05-24,84254,38,0,136,196,5179,0.2857142857142857,158.14285714285714,0.3391106484134708,187.6977438968561,"(37.5, 52.0]",Q3
36015,2020-05-25,84254,38,0,136,96,5275,0.2857142857142857,155.0,0.3391106484134708,183.9675267643079,"(37.5, 52.0]",Q3
36015,2020-05-26,84254,38,0,136,295,5570,0.2857142857142857,181.0,0.3391106484134708,214.82659576993376,"(37.5, 52.0]",Q3
36015,2020-05-27,84254,38,0,136,63,5633,0.2857142857142857,177.0,0.3391106484134708,210.0790466921452,"(37.5, 52.0]",Q3
36015,2020-05-28,84254,38,1,137,99,5732,0.2857142857142857,171.0,0.3391106484134708,202.95772307546227,"(37.5, 52.0]",Q3
36015,2020-05-29,84254,38,0,137,451,6183,0.14285714285714285,202.14285714285714,0.1695553242067354,239.9207837525306,"(37.5, 52.0]",Q3
36015,2020-05-30,84254,38,0,137,337,6520,0.14285714285714285,219.57142857142858,0.1695553242067354,260.60653330575235,"(37.5, 52.0]",Q3
36015,2020-05-31,84254,38,0,137,73,6593,0.14285714285714285,202.0,0.1695553242067354,239.75122842832388,"(37.5, 52.0]",Q3
36015,2020-06-01,84254,38,0,137,145,6738,0.14285714285714285,209.0,0.1695553242067354,248.0594393144539,"(37.5, 52.0]",Q3
36015,2020-06-02,84254,38,0,137,247,6985,0.14285714285714285,202.14285714285714,0.1695553242067354,239.9207837525306,"(37.5, 52.0]",Q3
36015,2020-06-03,84254,38,0,137,219,7204,0.14285714285714285,224.42857142857142,0.1695553242067354,266.3714143287813,"(37.5, 52.0]",Q3
36015,2020-06-04,84254,38,0,137,114,7318,0.0,226.57142857142858,0.0,268.9147441918824,"(37.5, 52.0]",Q3
36015,2020-06-05,84254,38,0,137,853,8171,0.0,284.0,0.0,337.07598452299,"(37.5, 52.0]",Q3
36015,2020-06-06,84254,38,0,137,263,8434,0.0,273.42857142857144,0.0,324.52889053169156,"(37.5, 52.0]",Q3
36015,2020-06-07,84254,38,0,137,217,8651,0.0,294.0,0.0,348.9448572174615,"(37.5, 52.0]",Q3
36017,2020-03-02,47536,36,0,0,0,0,0.0,0.0,0.0,0.0,"(24.0, 37.5]",Q2
36017,2020-03-03,47536,36,0,0,0,0,0.0,0.0,0.0,0.0,"(24.0, 37.5]",Q2
36017,2020-03-04,47536,36,0,0,0,0,0.0,0.0,0.0,0.0,"(24.0, 37.5]",Q2
36017,2020-03-05,47536,36,0,0,0,0,0.0,0.0,0.0,0.0,"(24.0, 37.5]",Q2
36017,2020-03-06,47536,36,0,0,0,0,0.0,0.0,0.0,0.0,"(24.0, 37.5]",Q2
36017,2020-03-07,47536,36,0,0,0,0,0.0,0.0,0.0,0.0,"(24.0, 37.5]",Q2
36017,2020-03-08,47536,36,0,0,0,0,0.0,0.0,0.0,0.0,"(24.0, 37.5]",Q2
36017,2020-03-09,47536,36,0,0,0,0,0.0,0.0,0.0,0.0,"(24.0, 37.5]",Q2
36017,2020-03-10,47536,36,0,0,0,0,0.0,0.0,0.0,0.0,"(24.0, 37.5]",Q2
36017,2020-03-11,47536,36,0,0,0,0,0.0,0.0,0.0,0.0,"(24.0, 37.5]",Q2
36017,2020-03-12,47536,36,0,0,0,0,0.0,0.0,0.0,0.0,"(24.0, 37.5]",Q2
36017,2020-03-13,47536,36,0,0,0,0,0.0,0.0,0.0,0.0,"(24.0, 37.5]",Q2
36017,2020-03-14,47536,36,0,0,0,0,0.0,0.0,0.0,0.0,"(24.0, 37.5]",Q2
36017,2020-03-15,47536,36,0,0,1,1,0.0,0.14285714285714285,0.0,0.30052411405491175,"(24.0, 37.5]",Q2
36017,2020-03-16,47536,36,0,0,2,3,0.0,0.42857142857142855,0.0,0.9015723421647351,"(24.0, 37.5]",Q2
36017,2020-03-17,47536,36,1,1,1,4,0.14285714285714285,0.5714285714285714,0.30052411405491175,1.202096456219647,"(24.0, 37.5]",Q2
36017,2020-03-18,47536,36,1,2,1,5,0.2857142857142857,0.7142857142857143,0.6010482281098235,1.5026205702745588,"(24.0, 37.5]",Q2
36017,2020-03-19,47536,36,0,2,0,5,0.2857142857142857,0.7142857142857143,0.6010482281098235,1.5026205702745588,"(24.0, 37.5]",Q2
36017,2020-03-20,47536,36,0,2,4,9,0.2857142857142857,1.2857142857142858,0.6010482281098235,2.7047170264942064,"(24.0, 37.5]",Q2
36017,2020-03-21,47536,36,1,3,4,13,0.42857142857142855,1.8571428571428572,0.9015723421647351,3.906813482713853,"(24.0, 37.5]",Q2
36017,2020-03-22,47536,36,0,3,2,15,0.42857142857142855,2.0,0.9015723421647351,4.207337596768765,"(24.0, 37.5]",Q2
36017,2020-03-23,47536,36,0,3,3,18,0.42857142857142855,2.142857142857143,0.9015723421647351,4.5078617108236765,"(24.0, 37.5]",Q2
36017,2020-03-24,47536,36,0,3,6,24,0.2857142857142857,2.857142857142857,0.6010482281098235,6.010482281098235,"(24.0, 37.5]",Q2
36017,2020-03-25,47536,36,0,3,1,25,0.14285714285714285,2.857142857142857,0.30052411405491175,6.010482281098235,"(24.0, 37.5]",Q2
36017,2020-03-26,47536,36,1,4,6,31,0.2857142857142857,3.7142857142857144,0.6010482281098235,7.813626965427706,"(24.0, 37.5]",Q2
36017,2020-03-27,47536,36,4,8,13,44,0.8571428571428571,5.0,1.8031446843294703,10.518343991921911,"(24.0, 37.5]",Q2
36017,2020-03-28,47536,36,7,15,15,59,1.7142857142857142,6.571428571428571,3.6062893686589406,13.82410924652594,"(24.0, 37.5]",Q2
36017,2020-03-29,47536,36,2,17,7,66,2.0,7.285714285714286,4.207337596768765,15.3267298168005,"(24.0, 37.5]",Q2
36017,2020-03-30,47536,36,2,19,9,75,2.2857142857142856,8.142857142857142,4.808385824878588,17.129874501129972,"(24.0, 37.5]",Q2
36017,2020-03-31,47536,36,7,26,20,95,3.2857142857142856,10.142857142857142,6.91205462326297,21.337212097898735,"(24.0, 37.5]",Q2
36017,2020-04-01,47536,36,2,28,16,111,3.5714285714285716,12.285714285714286,7.513102851372794,25.84507380872241,"(24.0, 37.5]",Q2
36017,2020-04-02,47536,36,4,32,17,128,4.0,13.857142857142858,8.41467519353753,29.15083906332644,"(24.0, 37.5]",Q2
36017,2020-04-03,47536,36,7,39,40,168,4.428571428571429,17.714285714285715,9.316247535702265,37.26499014280906,"(24.0, 37.5]",Q2
36017,2020-04-04,47536,36,4,43,17,185,4.0,18.0,8.41467519353753,37.866038370918886,"(24.0, 37.5]",Q2
36017,2020-04-05,47536,36,3,46,27,212,4.142857142857143,20.857142857142858,8.715199307592442,43.87652065201711,"(24.0, 37.5]",Q2
36017,2020-04-06,47536,36,5,51,42,254,4.571428571428571,25.571428571428573,9.616771649757176,53.793816415829205,"(24.0, 37.5]",Q2
36017,2020-04-07,47536,36,2,53,11,265,3.857142857142857,24.285714285714285,8.114151079482617,51.089099389335,"(24.0, 37.5]",Q2
36017,2020-04-08,47536,36,2,55,21,286,3.857142857142857,25.0,8.114151079482617,52.59171995960956,"(24.0, 37.5]",Q2
36017,2020-04-09,47536,36,5,60,29,315,4.0,26.714285714285715,8.41467519353753,56.1980093282685,"(24.0, 37.5]",Q2
36017,2020-04-10,47536,36,1,61,17,332,3.142857142857143,23.428571428571427,6.611530509208059,49.28595470500552,"(24.0, 37.5]",Q2
36017,2020-04-11,47536,36,2,63,12,344,2.857142857142857,22.714285714285715,6.010482281098235,47.78333413473097,"(24.0, 37.5]",Q2
36017,2020-04-12,47536,36,2,65,17,361,2.7142857142857144,21.285714285714285,5.7099581670433235,44.778092994181854,"(24.0, 37.5]",Q2
36017,2020-04-13,47536,36,3,68,36,397,2.4285714285714284,20.428571428571427,5.1089099389334995,42.97494830985238,"(24.0, 37.5]",Q2
36017,2020-04-14,47536,36,3,71,17,414,2.5714285714285716,21.285714285714285,5.409434052988413,44.778092994181854,"(24.0, 37.5]",Q2
36017,2020-04-15,47536,36,2,73,21,435,2.5714285714285716,21.285714285714285,5.409434052988413,44.778092994181854,"(24.0, 37.5]",Q2
36017,2020-04-16,47536,36,3,76,16,451,2.2857142857142856,19.428571428571427,4.808385824878588,40.871279511467996,"(24.0, 37.5]",Q2
36017,2020-04-17,47536,36,1,77,11,462,2.2857142857142856,18.571428571428573,4.808385824878588,39.068134827138536,"(24.0, 37.5]",Q2
36017,2020-04-18,47536,36,1,78,13,475,2.142857142857143,18.714285714285715,4.5078617108236765,39.368658941193445,"(24.0, 37.5]",Q2
36017,2020-04-19,47536,36,0,78,11,486,1.8571428571428572,17.857142857142858,3.906813482713853,37.56551425686397,"(24.0, 37.5]",Q2
36017,2020-04-20,47536,36,1,79,7,493,1.5714285714285714,13.714285714285714,3.3057652546040295,28.850314949271525,"(24.0, 37.5]",Q2
36017,2020-04-21,47536,36,0,79,17,510,1.1428571428571428,13.714285714285714,2.404192912439294,28.850314949271525,"(24.0, 37.5]",Q2
36017,2020-04-22,47536,36,3,82,20,530,1.2857142857142858,13.571428571428571,2.7047170264942064,28.549790835216616,"(24.0, 37.5]",Q2
36017,2020-04-23,47536,36,2,84,20,550,1.1428571428571428,14.142857142857142,2.404192912439294,29.75188729143626,"(24.0, 37.5]",Q2
36017,2020-04-24,47536,36,7,91,144,694,2.0,33.142857142857146,4.207337596768765,69.72159446073954,"(24.0, 37.5]",Q2
36017,2020-04-25,47536,36,2,93,19,713,2.142857142857143,34.0,4.5078617108236765,71.524739145069,"(24.0, 37.5]",Q2
36017,2020-04-26,47536,36,2,95,23,736,2.4285714285714284,35.714285714285715,5.1089099389334995,75.13102851372794,"(24.0, 37.5]",Q2
36017,2020-04-27,47536,36,0,95,10,746,2.2857142857142856,36.142857142857146,4.808385824878588,76.03260085589268,"(24.0, 37.5]",Q2
36017,2020-04-28,47536,36,1,96,18,764,2.4285714285714284,36.285714285714285,5.1089099389334995,76.33312496994759,"(24.0, 37.5]",Q2
36017,2020-04-29,47536,36,2,98,25,789,2.2857142857142856,37.0,4.808385824878588,77.83574554022215,"(24.0, 37.5]",Q2
36017,2020-04-30,47536,36,1,99,21,810,2.142857142857143,37.142857142857146,4.5078617108236765,78.13626965427707,"(24.0, 37.5]",Q2
36017,2020-05-01,47536,36,0,99,35,845,1.1428571428571428,21.571428571428573,2.404192912439294,45.37914122229168,"(24.0, 37.5]",Q2
36017,2020-05-02,47536,36,0,99,36,881,0.8571428571428571,24.0,1.8031446843294703,50.48805116122518,"(24.0, 37.5]",Q2
36017,2020-05-03,47536,36,1,100,50,931,0.7142857142857143,27.857142857142858,1.5026205702745588,58.6022022407078,"(24.0, 37.5]",Q2
36017,2020-05-04,47536,36,0,100,42,973,0.7142857142857143,32.42857142857143,1.5026205702745588,68.21897389046498,"(24.0, 37.5]",Q2
36017,2020-05-05,47536,36,2,102,51,1024,0.8571428571428571,37.142857142857146,1.8031446843294703,78.13626965427707,"(24.0, 37.5]",Q2
36017,2020-05-06,47536,36,3,105,50,1074,1.0,40.714285714285715,2.1036687983843825,85.64937250564985,"(24.0, 37.5]",Q2
36017,2020-05-07,47536,36,0,105,26,1100,0.8571428571428571,41.42857142857143,1.8031446843294703,87.15199307592442,"(24.0, 37.5]",Q2
36017,2020-05-08,47536,36,4,109,181,1281,1.4285714285714286,62.285714285714285,3.0052411405491175,131.02851372794152,"(24.0, 37.5]",Q2
36017,2020-05-09,47536,36,0,109,45,1326,1.4285714285714286,63.57142857142857,3.0052411405491175,133.73323075443574,"(24.0, 37.5]",Q2
36017,2020-05-10,47536,36,2,111,107,1433,1.5714285714285714,71.71428571428571,3.3057652546040295,150.8631052555657,"(24.0, 37.5]",Q2
36017,2020-05-11,47536,36,1,112,197,1630,1.7142857142857142,93.85714285714286,3.6062893686589406,197.444342934077,"(24.0, 37.5]",Q2
36017,2020-05-12,47536,36,0,112,83,1713,1.4285714285714286,98.42857142857143,3.0052411405491175,207.0611145838342,"(24.0, 37.5]",Q2
36017,2020-05-13,47536,36,0,112,41,1754,1.0,97.14285714285714,2.1036687983843825,204.35639755734,"(24.0, 37.5]",Q2
36017,2020-05-14,47536,36,1,113,45,1799,1.1428571428571428,99.85714285714286,2.404192912439294,210.0663557243833,"(24.0, 37.5]",Q2
36017,2020-05-15,47536,36,2,115,54,1853,0.8571428571428571,81.71428571428571,1.8031446843294703,171.89979323940952,"(24.0, 37.5]",Q2
36017,2020-05-16,47536,36,2,117,50,1903,1.1428571428571428,82.42857142857143,2.404192912439294,173.40241380968408,"(24.0, 37.5]",Q2
36017,2020-05-17,47536,36,1,118,62,1965,1.0,76.0,2.1036687983843825,159.87882867721305,"(24.0, 37.5]",Q2
36017,2020-05-18,47536,36,0,118,67,2032,0.8571428571428571,57.42857142857143,1.8031446843294703,120.81069385007453,"(24.0, 37.5]",Q2
36017,2020-05-19,47536,36,0,118,54,2086,0.8571428571428571,53.285714285714285,1.8031446843294703,112.09549454248209,"(24.0, 37.5]",Q2
36017,2020-05-20,47536,36,0,118,150,2236,0.8571428571428571,68.85714285714286,1.8031446843294703,144.85262297446747,"(24.0, 37.5]",Q2
36017,2020-05-21,47536,36,0,118,219,2455,0.7142857142857143,93.71428571428571,1.5026205702745588,197.1438188200221,"(24.0, 37.5]",Q2
36017,2020-05-22,47536,36,0,118,143,2598,0.42857142857142855,106.42857142857143,0.9015723421647351,223.89046497090928,"(24.0, 37.5]",Q2
36017,2020-05-23,47536,36,0,118,226,2824,0.14285714285714285,131.57142857142858,0.30052411405491175,276.7827090445738,"(24.0, 37.5]",Q2
36017,2020-05-24,47536,36,1,119,217,3041,0.14285714285714285,153.71428571428572,0.30052411405491175,323.36394672308506,"(24.0, 37.5]",Q2
36017,2020-05-25,47536,36,4,123,221,3262,0.7142857142857143,175.71428571428572,1.5026205702745588,369.6446602875415,"(24.0, 37.5]",Q2
36017,2020-05-26,47536,36,2,125,122,3384,1.0,185.42857142857142,2.1036687983843825,390.08030004327543,"(24.0, 37.5]",Q2
36017,2020-05-27,47536,36,1,126,139,3523,1.1428571428571428,183.85714285714286,2.404192912439294,386.7745347886714,"(24.0, 37.5]",Q2
36017,2020-05-28,47536,36,4,130,168,3691,1.7142857142857142,176.57142857142858,3.6062893686589406,371.447804971871,"(24.0, 37.5]",Q2
36017,2020-05-29,47536,36,2,132,199,3890,2.0,184.57142857142858,4.207337596768765,388.27715535894606,"(24.0, 37.5]",Q2
36017,2020-05-30,47536,36,1,133,404,4294,2.142857142857143,210.0,4.5078617108236765,441.7704476607203,"(24.0, 37.5]",Q2
36017,2020-05-31,47536,36,0,133,173,4467,2.0,203.71428571428572,4.207337596768765,428.54738664230416,"(24.0, 37.5]",Q2
36017,2020-06-01,47536,36,0,133,190,4657,1.4285714285714286,199.28571428571428,3.0052411405491175,419.23113910660186,"(24.0, 37.5]",Q2
36017,2020-06-02,47536,36,0,133,245,4902,1.1428571428571428,216.85714285714286,2.404192912439294,456.1956051353561,"(24.0, 37.5]",Q2
36017,2020-06-03,47536,36,0,133,193,5095,1.0,224.57142857142858,2.1036687983843825,472.4239072943213,"(24.0, 37.5]",Q2
36017,2020-06-04,47536,36,0,133,329,5424,0.42857142857142855,247.57142857142858,0.9015723421647351,520.808289657162,"(24.0, 37.5]",Q2
36017,2020-06-05,47536,36,0,133,252,5676,0.14285714285714285,255.14285714285714,0.30052411405491175,536.7360677020724,"(24.0, 37.5]",Q2
36017,2020-06-06,47536,36,1,134,233,5909,0.14285714285714285,230.71428571428572,0.30052411405491175,485.3464441986825,"(24.0, 37.5]",Q2
36017,2020-06-07,47536,36,1,135,313,6222,0.2857142857142857,250.71428571428572,0.6010482281098235,527.4198201663701,"(24.0, 37.5]",Q2
36019,2020-03-02,80695,52,0,0,0,0,0.0,0.0,0.0,0.0,"(37.5, 52.0]",Q3
36019,2020-03-03,80695,52,0,0,0,0,0.0,0.0,0.0,0.0,"(37.5, 52.0]",Q3
36019,2020-03-04,80695,52,0,0,0,0,0.0,0.0,0.0,0.0,"(37.5, 52.0]",Q3
36019,2020-03-05,80695,52,0,0,0,0,0.0,0.0,0.0,0.0,"(37.5, 52.0]",Q3
36019,2020-03-06,80695,52,0,0,0,0,0.0,0.0,0.0,0.0,"(37.5, 52.0]",Q3
36019,2020-03-07,80695,52,0,0,0,0,0.0,0.0,0.0,0.0,"(37.5, 52.0]",Q3
36019,2020-03-08,80695,52,0,0,0,0,0.0,0.0,0.0,0.0,"(37.5, 52.0]",Q3
36019,2020-03-09,80695,52,0,0,0,0,0.0,0.0,0.0,0.0,"(37.5, 52.0]",Q3
36019,2020-03-10,80695,52,0,0,0,0,0.0,0.0,0.0,0.0,"(37.5, 52.0]",Q3
36019,2020-03-11,80695,52,0,0,4,4,0.0,0.5714285714285714,0.0,0.7081338018818656,"(37.5, 52.0]",Q3
36019,2020-03-12,80695,52,0,0,3,7,0.0,1.0,0.0,1.2392341532932647,"(37.5, 52.0]",Q3
36019,2020-03-13,80695,52,0,0,1,8,0.0,1.1428571428571428,0.0,1.4162676037637312,"(37.5, 52.0]",Q3
36019,2020-03-14,80695,52,0,0,1,9,0.0,1.2857142857142858,0.0,1.5933010542341979,"(37.5, 52.0]",Q3
36019,2020-03-15,80695,52,0,0,0,9,0.0,1.2857142857142858,0.0,1.5933010542341979,"(37.5, 52.0]",Q3
36019,2020-03-16,80695,52,1,1,1,10,0.14285714285714285,1.4285714285714286,0.1770334504704664,1.770334504704664,"(37.5, 52.0]",Q3
36019,2020-03-17,80695,52,0,1,3,13,0.14285714285714285,1.8571428571428572,0.1770334504704664,2.301434856116063,"(37.5, 52.0]",Q3
36019,2020-03-18,80695,52,1,2,21,34,0.2857142857142857,4.285714285714286,0.3540669009409328,5.311003514113992,"(37.5, 52.0]",Q3
36019,2020-03-19,80695,52,0,2,9,43,0.2857142857142857,5.142857142857143,0.3540669009409328,6.3732042169367915,"(37.5, 52.0]",Q3
36019,2020-03-20,80695,52,2,4,12,55,0.5714285714285714,6.714285714285714,0.7081338018818656,8.32057217211192,"(37.5, 52.0]",Q3
36019,2020-03-21,80695,52,0,4,2,57,0.5714285714285714,6.857142857142857,0.7081338018818656,8.497605622582386,"(37.5, 52.0]",Q3
36019,2020-03-22,80695,52,2,6,12,69,0.8571428571428571,8.571428571428571,1.0622007028227982,10.622007028227983,"(37.5, 52.0]",Q3
36019,2020-03-23,80695,52,2,8,17,86,1.0,10.857142857142858,1.2392341532932647,13.454542235755447,"(37.5, 52.0]",Q3
36019,2020-03-24,80695,52,2,10,14,100,1.2857142857142858,12.428571428571429,1.5933010542341979,15.401910190930575,"(37.5, 52.0]",Q3
36019,2020-03-25,80695,52,1,11,16,116,1.2857142857142858,11.714285714285714,1.5933010542341979,14.516742938578243,"(37.5, 52.0]",Q3
36019,2020-03-26,80695,52,0,11,6,122,1.2857142857142858,11.285714285714286,1.5933010542341979,13.985642587166847,"(37.5, 52.0]",Q3
36019,2020-03-27,80695,52,1,12,22,144,1.1428571428571428,12.714285714285714,1.4162676037637312,15.755977091871507,"(37.5, 52.0]",Q3
36019,2020-03-28,80695,52,1,13,18,162,1.2857142857142858,15.0,1.5933010542341979,18.58851229939897,"(37.5, 52.0]",Q3
36019,2020-03-29,80695,52,4,17,19,181,1.5714285714285714,16.0,1.9473679551751304,19.827746452692235,"(37.5, 52.0]",Q3
36019,2020-03-30,80695,52,4,21,9,190,1.8571428571428572,14.857142857142858,2.301434856116063,18.411478848928503,"(37.5, 52.0]",Q3
36019,2020-03-31,80695,52,4,25,21,211,2.142857142857143,15.857142857142858,2.655501757056996,19.65071300222177,"(37.5, 52.0]",Q3
36019,2020-04-01,80695,52,0,25,5,216,2.0,14.285714285714286,2.4784683065865294,17.70334504704664,"(37.5, 52.0]",Q3
36019,2020-04-02,80695,52,5,30,16,232,2.7142857142857144,15.714285714285714,3.363635558938862,19.473679551751303,"(37.5, 52.0]",Q3
36019,2020-04-03,80695,52,1,31,11,243,2.7142857142857144,14.142857142857142,3.363635558938862,17.52631159657617,"(37.5, 52.0]",Q3
36019,2020-04-04,80695,52,2,33,23,266,2.857142857142857,14.857142857142858,3.540669009409328,18.411478848928503,"(37.5, 52.0]",Q3
36019,2020-04-05,80695,52,3,36,14,280,2.7142857142857144,14.142857142857142,3.363635558938862,17.52631159657617,"(37.5, 52.0]",Q3
36019,2020-04-06,80695,52,1,37,16,296,2.2857142857142856,15.142857142857142,2.8325352075274624,18.765545749869435,"(37.5, 52.0]",Q3
36019,2020-04-07,80695,52,2,39,25,321,2.0,15.714285714285714,2.4784683065865294,19.473679551751303,"(37.5, 52.0]",Q3
36019,2020-04-08,80695,52,1,40,25,346,2.142857142857143,18.571428571428573,2.655501757056996,23.014348561160634,"(37.5, 52.0]",Q3
36019,2020-04-09,80695,52,3,43,17,363,1.8571428571428572,18.714285714285715,2.301434856116063,23.1913820116311,"(37.5, 52.0]",Q3
36019,2020-04-10,80695,52,0,43,23,386,1.7142857142857142,20.428571428571427,2.1244014056455964,25.315783417276695,"(37.5, 52.0]",Q3
36019,2020-04-11,80695,52,0,43,25,411,1.4285714285714286,20.714285714285715,1.770334504704664,25.66985031821763,"(37.5, 52.0]",Q3
36019,2020-04-12,80695,52,1,44,9,420,1.1428571428571428,20.0,1.4162676037637312,24.784683065865295,"(37.5, 52.0]",Q3
36019,2020-04-13,80695,52,1,45,23,443,1.1428571428571428,21.0,1.4162676037637312,26.02391721915856,"(37.5, 52.0]",Q3
36019,2020-04-14,80695,52,0,45,8,451,0.8571428571428571,18.571428571428573,1.0622007028227982,23.014348561160634,"(37.5, 52.0]",Q3
36019,2020-04-15,80695,52,1,46,17,468,0.8571428571428571,17.428571428571427,1.0622007028227982,21.5980809573969,"(37.5, 52.0]",Q3
36019,2020-04-16,80695,52,1,47,21,489,0.5714285714285714,18.0,0.7081338018818656,22.306214759278767,"(37.5, 52.0]",Q3
36019,2020-04-17,80695,52,1,48,16,505,0.7142857142857143,17.0,0.885167252352332,21.066980605985503,"(37.5, 52.0]",Q3
36019,2020-04-18,80695,52,1,49,12,517,0.8571428571428571,15.142857142857142,1.0622007028227982,18.765545749869435,"(37.5, 52.0]",Q3
36019,2020-04-19,80695,52,2,51,10,527,1.0,15.285714285714286,1.2392341532932647,18.942579200339903,"(37.5, 52.0]",Q3
36019,2020-04-20,80695,52,0,51,17,544,0.8571428571428571,14.428571428571429,1.0622007028227982,17.880378497517103,"(37.5, 52.0]",Q3
36019,2020-04-21,80695,52,0,51,4,548,0.8571428571428571,13.857142857142858,1.0622007028227982,17.17224469563524,"(37.5, 52.0]",Q3
36019,2020-04-22,80695,52,1,52,11,559,0.8571428571428571,13.0,1.0622007028227982,16.110043992812443,"(37.5, 52.0]",Q3
36019,2020-04-23,80695,52,1,53,14,573,0.8571428571428571,12.0,1.0622007028227982,14.870809839519175,"(37.5, 52.0]",Q3
36019,2020-04-24,80695,52,1,54,39,612,0.8571428571428571,15.285714285714286,1.0622007028227982,18.942579200339903,"(37.5, 52.0]",Q3
36019,2020-04-25,80695,52,3,57,28,640,1.1428571428571428,17.571428571428573,1.4162676037637312,21.775114407867367,"(37.5, 52.0]",Q3
36019,2020-04-26,80695,52,2,59,30,670,1.1428571428571428,20.428571428571427,1.4162676037637312,25.315783417276695,"(37.5, 52.0]",Q3
36019,2020-04-27,80695,52,0,59,15,685,1.1428571428571428,20.142857142857142,1.4162676037637312,24.96171651633576,"(37.5, 52.0]",Q3
36019,2020-04-28,80695,52,0,59,23,708,1.1428571428571428,22.857142857142858,1.4162676037637312,28.325352075274623,"(37.5, 52.0]",Q3
36019,2020-04-29,80695,52,0,59,40,748,1.0,27.0,1.2392341532932647,33.459322138918154,"(37.5, 52.0]",Q3
36019,2020-04-30,80695,52,2,61,48,796,1.1428571428571428,31.857142857142858,1.4162676037637312,39.47845945491401,"(37.5, 52.0]",Q3
36019,2020-05-01,80695,52,1,62,35,831,1.1428571428571428,31.285714285714285,1.4162676037637312,38.77032565303214,"(37.5, 52.0]",Q3
36019,2020-05-02,80695,52,4,66,33,864,1.2857142857142858,32.0,1.5933010542341979,39.65549290538447,"(37.5, 52.0]",Q3
36019,2020-05-03,80695,52,2,68,21,885,1.2857142857142858,30.714285714285715,1.5933010542341979,38.062191851150274,"(37.5, 52.0]",Q3
36019,2020-05-04,80695,52,1,69,27,912,1.4285714285714286,32.42857142857143,1.770334504704664,40.186593256795874,"(37.5, 52.0]",Q3
36019,2020-05-05,80695,52,0,69,25,937,1.4285714285714286,32.714285714285715,1.770334504704664,40.54066015773681,"(37.5, 52.0]",Q3
36019,2020-05-06,80695,52,0,69,22,959,1.4285714285714286,30.142857142857142,1.770334504704664,37.35405804926841,"(37.5, 52.0]",Q3
36019,2020-05-07,80695,52,5,74,72,1031,1.8571428571428572,33.57142857142857,2.301434856116063,41.6028608605596,"(37.5, 52.0]",Q3
36019,2020-05-08,80695,52,2,76,27,1058,2.0,32.42857142857143,2.4784683065865294,40.186593256795874,"(37.5, 52.0]",Q3
36019,2020-05-09,80695,52,0,76,33,1091,1.4285714285714286,32.42857142857143,1.770334504704664,40.186593256795874,"(37.5, 52.0]",Q3
36019,2020-05-10,80695,52,0,76,53,1144,1.1428571428571428,37.0,1.4162676037637312,45.851663671850794,"(37.5, 52.0]",Q3
36019,2020-05-11,80695,52,1,77,38,1182,1.1428571428571428,38.57142857142857,1.4162676037637312,47.799031627025926,"(37.5, 52.0]",Q3
36019,2020-05-12,80695,52,1,78,53,1235,1.2857142857142858,42.57142857142857,1.5933010542341979,52.75596824019899,"(37.5, 52.0]",Q3
36019,2020-05-13,80695,52,3,81,123,1358,1.7142857142857142,57.0,2.1244014056455964,70.6363467377161,"(37.5, 52.0]",Q3
36019,2020-05-14,80695,52,4,85,126,1484,1.5714285714285714,64.71428571428571,1.9473679551751304,80.19615306312127,"(37.5, 52.0]",Q3
36019,2020-05-15,80695,52,6,91,150,1634,2.142857142857143,82.28571428571429,2.655501757056996,101.97126747098866,"(37.5, 52.0]",Q3
36019,2020-05-16,80695,52,1,92,88,1722,2.2857142857142856,90.14285714285714,2.8325352075274624,111.70810724686429,"(37.5, 52.0]",Q3
36019,2020-05-17,80695,52,2,94,155,1877,2.5714285714285716,104.71428571428571,3.1866021084683958,129.76551919485186,"(37.5, 52.0]",Q3
36019,2020-05-18,80695,52,0,94,59,1936,2.4285714285714284,107.71428571428571,3.0095686579979284,133.48322165473166,"(37.5, 52.0]",Q3
36019,2020-05-19,80695,52,0,94,58,1994,2.2857142857142856,108.42857142857143,2.8325352075274624,134.368388907084,"(37.5, 52.0]",Q3
36019,2020-05-20,80695,52,0,94,204,2198,1.8571428571428572,120.0,2.301434856116063,148.70809839519177,"(37.5, 52.0]",Q3
36019,2020-05-21,80695,52,0,94,131,2329,1.2857142857142858,120.71428571428571,1.5933010542341979,149.59326564754411,"(37.5, 52.0]",Q3
36019,2020-05-22,80695,52,1,95,135,2464,0.5714285714285714,118.57142857142857,0.7081338018818656,146.9377638904871,"(37.5, 52.0]",Q3
36019,2020-05-23,80695,52,0,95,131,2595,0.42857142857142855,124.71428571428571,0.5311003514113991,154.55020226071716,"(37.5, 52.0]",Q3
36019,2020-05-24,80695,52,0,95,70,2665,0.14285714285714285,112.57142857142857,0.1770334504704664,139.50235897072753,"(37.5, 52.0]",Q3
36019,2020-05-25,80695,52,0,95,108,2773,0.14285714285714285,119.57142857142857,0.1770334504704664,148.17699804378037,"(37.5, 52.0]",Q3
36019,2020-05-26,80695,52,0,95,51,2824,0.14285714285714285,118.57142857142857,0.1770334504704664,146.9377638904871,"(37.5, 52.0]",Q3
36019,2020-05-27,80695,52,0,95,201,3025,0.14285714285714285,118.14285714285714,0.1770334504704664,146.4066635390757,"(37.5, 52.0]",Q3
36019,2020-05-28,80695,52,0,95,226,3251,0.14285714285714285,131.71428571428572,0.1770334504704664,163.22484133377003,"(37.5, 52.0]",Q3
36019,2020-05-29,80695,52,0,95,441,3692,0.0,175.42857142857142,0.0,217.39707717773274,"(37.5, 52.0]",Q3
36019,2020-05-30,80695,52,0,95,329,4021,0.0,203.71428571428572,0.0,252.4497003708851,"(37.5, 52.0]",Q3
36019,2020-05-31,80695,52,1,96,146,4167,0.14285714285714285,214.57142857142858,0.1770334504704664,265.90424260664054,"(37.5, 52.0]",Q3
36019,2020-06-01,80695,52,1,97,147,4314,0.2857142857142857,220.14285714285714,0.3540669009409328,272.80854717498875,"(37.5, 52.0]",Q3
36019,2020-06-02,80695,52,0,97,309,4623,0.2857142857142857,257.0,0.3540669009409328,318.48317739636906,"(37.5, 52.0]",Q3
36019,2020-06-03,80695,52,0,97,632,5255,0.2857142857142857,318.57142857142856,0.3540669009409328,394.7845945491401,"(37.5, 52.0]",Q3
36019,2020-06-04,80695,52,0,97,319,5574,0.2857142857142857,331.85714285714283,0.3540669009409328,411.2487054428934,"(37.5, 52.0]",Q3
36019,2020-06-05,80695,52,0,97,421,5995,0.2857142857142857,329.0,0.3540669009409328,407.7080364334841,"(37.5, 52.0]",Q3
36019,2020-06-06,80695,52,0,97,305,6300,0.2857142857142857,325.57142857142856,0.3540669009409328,403.45923362219287,"(37.5, 52.0]",Q3
36019,2020-06-07,80695,52,0,97,220,6520,0.14285714285714285,336.14285714285717,0.1770334504704664,416.55970895700744,"(37.5, 52.0]",Q3
36021,2020-03-02,59916,24,0,0,0,0,0.0,0.0,0.0,0.0,"(3.999, 24.0]",Q1
36021,2020-03-03,59916,24,0,0,0,0,0.0,0.0,0.0,0.0,"(3.999, 24.0]",Q1
36021,2020-03-04,59916,24,0,0,0,0,0.0,0.0,0.0,0.0,"(3.999, 24.0]",Q1
36021,2020-03-05,59916,24,0,0,0,0,0.0,0.0,0.0,0.0,"(3.999, 24.0]",Q1
36021,2020-03-06,59916,24,0,0,0,0,0.0,0.0,0.0,0.0,"(3.999, 24.0]",Q1
36021,2020-03-07,59916,24,0,0,0,0,0.0,0.0,0.0,0.0,"(3.999, 24.0]",Q1
36021,2020-03-08,59916,24,0,0,1,1,0.0,0.14285714285714285,0.0,0.23842903874948737,"(3.999, 24.0]",Q1
36021,2020-03-09,59916,24,0,0,0,1,0.0,0.14285714285714285,0.0,0.23842903874948737,"(3.999, 24.0]",Q1
36021,2020-03-10,59916,24,0,0,0,1,0.0,0.14285714285714285,0.0,0.23842903874948737,"(3.999, 24.0]",Q1
36021,2020-03-11,59916,24,0,0,2,3,0.0,0.42857142857142855,0.0,0.7152871162484621,"(3.999, 24.0]",Q1
36021,2020-03-12,59916,24,0,0,2,5,0.0,0.7142857142857143,0.0,1.1921451937474368,"(3.999, 24.0]",Q1
36021,2020-03-13,59916,24,0,0,1,6,0.0,0.8571428571428571,0.0,1.4305742324969242,"(3.999, 24.0]",Q1
36021,2020-03-14,59916,24,0,0,4,10,0.0,1.4285714285714286,0.0,2.3842903874948735,"(3.999, 24.0]",Q1
36021,2020-03-15,59916,24,0,0,2,12,0.0,1.5714285714285714,0.0,2.622719426244361,"(3.999, 24.0]",Q1
36021,2020-03-16,59916,24,0,0,13,25,0.0,3.4285714285714284,0.0,5.722296929987697,"(3.999, 24.0]",Q1
36021,2020-03-17,59916,24,0,0,14,39,0.0,5.428571428571429,0.0,9.060303472480522,"(3.999, 24.0]",Q1
36021,2020-03-18,59916,24,0,0,32,71,0.0,9.714285714285714,0.0,16.213174634965142,"(3.999, 24.0]",Q1
36021,2020-03-19,59916,24,1,1,24,95,0.14285714285714285,12.857142857142858,0.23842903874948737,21.458613487453867,"(3.999, 24.0]",Q1
36021,2020-03-20,59916,24,1,2,35,130,0.2857142857142857,17.714285714285715,0.47685807749897474,29.56520080493644,"(3.999, 24.0]",Q1
36021,2020-03-21,59916,24,3,5,52,182,0.7142857142857143,24.571428571428573,1.1921451937474368,41.00979466491183,"(3.999, 24.0]",Q1
36021,2020-03-22,59916,24,5,10,48,230,1.4285714285714286,31.142857142857142,2.3842903874948735,51.977530447388254,"(3.999, 24.0]",Q1
36021,2020-03-23,59916,24,1,11,10,240,1.5714285714285714,30.714285714285715,2.622719426244361,51.262243331139786,"(3.999, 24.0]",Q1
36021,2020-03-24,59916,24,1,12,15,255,1.7142857142857142,30.857142857142858,2.8611484649938483,51.50067236988927,"(3.999, 24.0]",Q1
36021,2020-03-25,59916,24,1,13,22,277,1.8571428571428572,29.428571428571427,3.099577503743336,49.116381982394394,"(3.999, 24.0]",Q1
36021,2020-03-26,59916,24,7,20,20,297,2.7142857142857144,28.857142857142858,4.530151736240261,48.16266582739645,"(3.999, 24.0]",Q1
36021,2020-03-27,59916,24,2,22,15,312,2.857142857142857,26.0,4.768580774989747,43.3940850524067,"(3.999, 24.0]",Q1
36021,2020-03-28,59916,24,1,23,11,323,2.5714285714285716,20.142857142857142,4.291722697490773,33.61849446367772,"(3.999, 24.0]",Q1
36021,2020-03-29,59916,24,3,26,26,349,2.2857142857142856,17.0,3.814864619991798,28.373055611189,"(3.999, 24.0]",Q1
36021,2020-03-30,59916,24,4,30,14,363,2.7142857142857144,17.571428571428573,4.530151736240261,29.326771766186948,"(3.999, 24.0]",Q1
36021,2020-03-31,59916,24,1,31,12,375,2.7142857142857144,17.142857142857142,4.530151736240261,28.611484649938483,"(3.999, 24.0]",Q1
36021,2020-04-01,59916,24,5,36,21,396,3.2857142857142856,17.0,5.4838678912382095,28.373055611189,"(3.999, 24.0]",Q1
36021,2020-04-02,59916,24,6,42,22,418,3.142857142857143,17.285714285714285,5.245438852488722,28.84991368868797,"(3.999, 24.0]",Q1
36021,2020-04-03,59916,24,7,49,20,438,3.857142857142857,18.0,6.437584046236159,30.04205888243541,"(3.999, 24.0]",Q1
36021,2020-04-04,59916,24,2,51,15,453,4.0,18.571428571428573,6.676013084985647,30.99577503743336,"(3.999, 24.0]",Q1
36021,2020-04-05,59916,24,8,59,23,476,4.714285714285714,18.142857142857142,7.868158278733083,30.280487921184893,"(3.999, 24.0]",Q1
36021,2020-04-06,59916,24,2,61,15,491,4.428571428571429,18.285714285714285,7.39130020123411,30.518916959934383,"(3.999, 24.0]",Q1
36021,2020-04-07,59916,24,2,63,8,499,4.571428571428571,17.714285714285715,7.629729239983596,29.56520080493644,"(3.999, 24.0]",Q1
36021,2020-04-08,59916,24,7,70,27,526,4.857142857142857,18.571428571428573,8.106587317482571,30.99577503743336,"(3.999, 24.0]",Q1
36021,2020-04-09,59916,24,4,74,55,581,4.571428571428571,23.285714285714285,7.629729239983596,38.86393331616644,"(3.999, 24.0]",Q1
36021,2020-04-10,59916,24,3,77,30,611,4.0,24.714285714285715,6.676013084985647,41.24822370366132,"(3.999, 24.0]",Q1
36021,2020-04-11,59916,24,2,79,35,646,4.0,27.571428571428573,6.676013084985647,46.01680447865107,"(3.999, 24.0]",Q1
36021,2020-04-12,59916,24,1,80,27,673,3.0,28.142857142857142,5.007009813739235,46.97052063364901,"(3.999, 24.0]",Q1
36021,2020-04-13,59916,24,4,84,30,703,3.2857142857142856,30.285714285714285,5.4838678912382095,50.54695621489132,"(3.999, 24.0]",Q1
36021,2020-04-14,59916,24,12,96,55,758,4.714285714285714,37.0,7.868158278733083,61.753121036117236,"(3.999, 24.0]",Q1
36021,2020-04-15,59916,24,3,99,28,786,4.142857142857143,37.142857142857146,6.914442123735134,61.99155007486672,"(3.999, 24.0]",Q1
36021,2020-04-16,59916,24,2,101,20,806,3.857142857142857,32.142857142857146,6.437584046236159,53.646533718634664,"(3.999, 24.0]",Q1
36021,2020-04-17,59916,24,4,105,32,838,4.0,32.42857142857143,6.676013084985647,54.12339179613364,"(3.999, 24.0]",Q1
36021,2020-04-18,59916,24,2,107,34,872,4.0,32.285714285714285,6.676013084985647,53.88496275738414,"(3.999, 24.0]",Q1
36021,2020-04-19,59916,24,4,111,17,889,4.428571428571429,30.857142857142858,7.39130020123411,51.50067236988927,"(3.999, 24.0]",Q1
36021,2020-04-20,59916,24,2,113,24,913,4.142857142857143,30.0,6.914442123735134,50.07009813739235,"(3.999, 24.0]",Q1
36021,2020-04-21,59916,24,4,117,34,947,3.0,27.0,5.007009813739235,45.06308832365311,"(3.999, 24.0]",Q1
36021,2020-04-22,59916,24,6,123,35,982,3.4285714285714284,28.0,5.722296929987697,46.73209159489953,"(3.999, 24.0]",Q1
36021,2020-04-23,59916,24,6,129,35,1017,4.0,30.142857142857142,6.676013084985647,50.30852717614184,"(3.999, 24.0]",Q1
36021,2020-04-24,59916,24,11,140,105,1122,5.0,40.57142857142857,8.345016356232058,67.71384700485441,"(3.999, 24.0]",Q1
36021,2020-04-25,59916,24,3,143,27,1149,5.142857142857143,39.57142857142857,8.583445394981545,66.044843733608,"(3.999, 24.0]",Q1
36021,2020-04-26,59916,24,3,146,22,1171,5.0,40.285714285714285,8.345016356232058,67.23698892735544,"(3.999, 24.0]",Q1
36021,2020-04-27,59916,24,8,154,33,1204,5.857142857142857,41.57142857142857,9.775590588728983,69.38285027610083,"(3.999, 24.0]",Q1
36021,2020-04-28,59916,24,11,165,37,1241,6.857142857142857,42.0,11.444593859975393,70.09813739234929,"(3.999, 24.0]",Q1
36021,2020-04-29,59916,24,5,170,61,1302,6.714285714285714,45.714285714285715,11.206164821225906,76.29729239983595,"(3.999, 24.0]",Q1
36021,2020-04-30,59916,24,32,202,76,1378,10.428571428571429,51.57142857142857,17.405319828712578,86.07288298856494,"(3.999, 24.0]",Q1
36021,2020-05-01,59916,24,3,205,37,1415,9.285714285714286,41.857142857142854,15.49788751871668,69.8597083535998,"(3.999, 24.0]",Q1
36021,2020-05-02,59916,24,4,209,57,1472,9.428571428571429,46.142857142857146,15.736316557466166,77.01257951608443,"(3.999, 24.0]",Q1
36021,2020-05-03,59916,24,4,213,38,1510,9.571428571428571,48.42857142857143,15.974745596215653,80.82744413607622,"(3.999, 24.0]",Q1
36021,2020-05-04,59916,24,16,229,79,1589,10.714285714285714,55.0,17.882177906211552,91.79517991855265,"(3.999, 24.0]",Q1
36021,2020-05-05,59916,24,62,291,188,1777,18.0,76.57142857142857,30.04205888243541,127.79796476972523,"(3.999, 24.0]",Q1
36021,2020-05-06,59916,24,11,302,58,1835,18.857142857142858,76.14285714285714,31.472633114932332,127.08267765347675,"(3.999, 24.0]",Q1
36021,2020-05-07,59916,24,2,304,70,1905,14.571428571428571,75.28571428571429,24.31976195244771,125.65210342097987,"(3.999, 24.0]",Q1
36021,2020-05-08,59916,24,0,304,42,1947,14.142857142857142,76.0,23.60447483619925,126.84424861472729,"(3.999, 24.0]",Q1
36021,2020-05-09,59916,24,8,312,264,2211,14.714285714285714,105.57142857142857,24.558190991197197,176.19905963587118,"(3.999, 24.0]",Q1
36021,2020-05-10,59916,24,2,314,41,2252,14.428571428571429,106.0,24.081332913698226,176.91434675211963,"(3.999, 24.0]",Q1
36021,2020-05-11,59916,24,0,314,55,2307,12.142857142857142,102.57142857142857,20.266468293706428,171.19204982213193,"(3.999, 24.0]",Q1
36021,2020-05-12,59916,24,4,318,85,2392,3.857142857142857,87.85714285714286,6.437584046236159,146.63385883093474,"(3.999, 24.0]",Q1
36021,2020-05-13,59916,24,9,327,100,2492,3.5714285714285716,93.85714285714286,5.960725968737185,156.6478784584132,"(3.999, 24.0]",Q1
36021,2020-05-14,59916,24,6,333,95,2587,4.142857142857143,97.42857142857143,6.914442123735134,162.6086044271504,"(3.999, 24.0]",Q1
36021,2020-05-15,59916,24,5,338,71,2658,4.857142857142857,101.57142857142857,8.106587317482571,169.52304655088554,"(3.999, 24.0]",Q1
36021,2020-05-16,59916,24,2,340,68,2726,4.0,73.57142857142857,6.676013084985647,122.790954955986,"(3.999, 24.0]",Q1
36021,2020-05-17,59916,24,6,346,86,2812,4.571428571428571,80.0,7.629729239983596,133.52026169971293,"(3.999, 24.0]",Q1
36021,2020-05-18,59916,24,4,350,39,2851,5.142857142857143,77.71428571428571,8.583445394981545,129.70539707972114,"(3.999, 24.0]",Q1
36021,2020-05-19,59916,24,0,350,107,2958,4.571428571428571,80.85714285714286,7.629729239983596,134.95083593220986,"(3.999, 24.0]",Q1
36021,2020-05-20,59916,24,5,355,128,3086,4.0,84.85714285714286,6.676013084985647,141.62684901719552,"(3.999, 24.0]",Q1
36021,2020-05-21,59916,24,1,356,78,3164,3.2857142857142856,82.42857142857143,5.4838678912382095,137.57355535845423,"(3.999, 24.0]",Q1
36021,2020-05-22,59916,24,3,359,96,3260,3.0,86.0,5.007009813739235,143.5342813271914,"(3.999, 24.0]",Q1
36021,2020-05-23,59916,24,6,365,94,3354,3.5714285714285716,89.71428571428571,5.960725968737185,149.73343633467806,"(3.999, 24.0]",Q1
36021,2020-05-24,59916,24,7,372,134,3488,3.7142857142857144,96.57142857142857,6.199155007486672,161.17803019465345,"(3.999, 24.0]",Q1
36021,2020-05-25,59916,24,1,373,145,3633,3.2857142857142856,111.71428571428571,5.4838678912382095,186.4515083020991,"(3.999, 24.0]",Q1
36021,2020-05-26,59916,24,7,380,62,3695,4.285714285714286,105.28571428571429,7.152871162484621,175.7222015583722,"(3.999, 24.0]",Q1
36021,2020-05-27,59916,24,0,380,145,3840,3.5714285714285716,107.71428571428571,5.960725968737185,179.77549521711347,"(3.999, 24.0]",Q1
36021,2020-05-28,59916,24,2,382,159,3999,3.7142857142857144,119.28571428571429,6.199155007486672,199.08824735582198,"(3.999, 24.0]",Q1
36021,2020-05-29,59916,24,1,383,125,4124,3.4285714285714284,123.42857142857143,5.722296929987697,206.0026894795571,"(3.999, 24.0]",Q1
36021,2020-05-30,59916,24,4,387,211,4335,3.142857142857143,140.14285714285714,5.245438852488722,233.8988870132471,"(3.999, 24.0]",Q1
36021,2020-05-31,59916,24,2,389,94,4429,2.4285714285714284,134.42857142857142,4.0532936587412856,224.3617254632676,"(3.999, 24.0]",Q1
36021,2020-06-01,59916,24,2,391,167,4596,2.5714285714285716,137.57142857142858,4.291722697490773,229.60716431575634,"(3.999, 24.0]",Q1
36021,2020-06-02,59916,24,8,399,393,4989,2.7142857142857144,184.85714285714286,4.530151736240261,308.52717614183666,"(3.999, 24.0]",Q1
36021,2020-06-03,59916,24,1,400,276,5265,2.857142857142857,203.57142857142858,4.768580774989747,339.76138021801955,"(3.999, 24.0]",Q1
36021,2020-06-04,59916,24,11,411,269,5534,4.142857142857143,219.28571428571428,6.914442123735134,365.9885744804631,"(3.999, 24.0]",Q1
36021,2020-06-05,59916,24,1,412,225,5759,4.142857142857143,233.57142857142858,6.914442123735134,389.8314783554119,"(3.999, 24.0]",Q1
36021,2020-06-06,59916,24,2,414,211,5970,3.857142857142857,233.57142857142858,6.437584046236159,389.8314783554119,"(3.999, 24.0]",Q1
36021,2020-06-07,59916,24,0,414,144,6114,3.5714285714285716,240.71428571428572,5.960725968737185,401.7529302928862,"(3.999, 24.0]",Q1
36023,2020-03-02,47823,38,0,0,0,0,0.0,0.0,0.0,0.0,"(37.5, 52.0]",Q3
36023,2020-03-03,47823,38,0,0,0,0,0.0,0.0,0.0,0.0,"(37.5, 52.0]",Q3
36023,2020-03-04,47823,38,0,0,0,0,0.0,0.0,0.0,0.0,"(37.5, 52.0]",Q3
36023,2020-03-05,47823,38,0,0,0,0,0.0,0.0,0.0,0.0,"(37.5, 52.0]",Q3
36023,2020-03-06,47823,38,0,0,0,0,0.0,0.0,0.0,0.0,"(37.5, 52.0]",Q3
36023,2020-03-07,47823,38,0,0,1,1,0.0,1.0,0.0,2.091044058298308,"(37.5, 52.0]",Q3
36023,2020-03-08,47823,38,0,0,0,1,0.0,0.14285714285714285,0.0,0.2987205797569012,"(37.5, 52.0]",Q3
36023,2020-03-09,47823,38,0,0,0,1,0.0,0.14285714285714285,0.0,0.2987205797569012,"(37.5, 52.0]",Q3
36023,2020-03-10,47823,38,0,0,0,1,0.0,0.14285714285714285,0.0,0.2987205797569012,"(37.5, 52.0]",Q3
36023,2020-03-11,47823,38,0,0,0,1,0.0,0.14285714285714285,0.0,0.2987205797569012,"(37.5, 52.0]",Q3
36023,2020-03-12,47823,38,0,0,0,1,0.0,0.14285714285714285,0.0,0.2987205797569012,"(37.5, 52.0]",Q3
36023,2020-03-13,47823,38,0,0,0,1,0.0,0.14285714285714285,0.0,0.2987205797569012,"(37.5, 52.0]",Q3
36023,2020-03-14,47823,38,0,0,1,2,0.0,0.14285714285714285,0.0,0.2987205797569012,"(37.5, 52.0]",Q3
36023,2020-03-15,47823,38,0,0,0,2,0.0,0.14285714285714285,0.0,0.2987205797569012,"(37.5, 52.0]",Q3
36023,2020-03-16,47823,38,0,0,2,4,0.0,0.42857142857142855,0.0,0.8961617392707035,"(37.5, 52.0]",Q3
36023,2020-03-17,47823,38,0,0,1,5,0.0,0.5714285714285714,0.0,1.1948823190276048,"(37.5, 52.0]",Q3
36023,2020-03-18,47823,38,0,0,1,6,0.0,0.7142857142857143,0.0,1.493602898784506,"(37.5, 52.0]",Q3
36023,2020-03-19,47823,38,0,0,7,13,0.0,1.7142857142857142,0.0,3.584646957082814,"(37.5, 52.0]",Q3
36023,2020-03-20,47823,38,0,0,15,28,0.0,3.857142857142857,0.0,8.06545565343633,"(37.5, 52.0]",Q3
36023,2020-03-21,47823,38,1,1,17,45,0.14285714285714285,6.142857142857143,0.2987205797569012,12.844984929546753,"(37.5, 52.0]",Q3
36023,2020-03-22,47823,38,1,2,55,100,0.2857142857142857,14.0,0.5974411595138024,29.27461681617632,"(37.5, 52.0]",Q3
36023,2020-03-23,47823,38,0,2,30,130,0.2857142857142857,18.0,0.5974411595138024,37.638793049369546,"(37.5, 52.0]",Q3
36023,2020-03-24,47823,38,0,2,3,133,0.2857142857142857,18.285714285714285,0.5974411595138024,38.23623420888335,"(37.5, 52.0]",Q3
36023,2020-03-25,47823,38,0,2,41,174,0.2857142857142857,24.0,0.5974411595138024,50.185057399159405,"(37.5, 52.0]",Q3
36023,2020-03-26,47823,38,2,4,34,208,0.5714285714285714,27.857142857142858,1.1948823190276048,58.25051305259573,"(37.5, 52.0]",Q3
36023,2020-03-27,47823,38,1,5,45,253,0.7142857142857143,32.142857142857146,1.493602898784506,67.21213044530278,"(37.5, 52.0]",Q3
36023,2020-03-28,47823,38,1,6,28,281,0.7142857142857143,33.714285714285715,1.493602898784506,70.49805682262868,"(37.5, 52.0]",Q3
36023,2020-03-29,47823,38,2,8,48,329,0.8571428571428571,32.714285714285715,1.792323478541407,68.40701276433037,"(37.5, 52.0]",Q3
36023,2020-03-30,47823,38,0,8,9,338,0.8571428571428571,29.714285714285715,1.792323478541407,62.133880589435456,"(37.5, 52.0]",Q3
36023,2020-03-31,47823,38,0,8,12,350,0.8571428571428571,31.0,1.792323478541407,64.82236580724756,"(37.5, 52.0]",Q3
36023,2020-04-01,47823,38,0,8,42,392,0.8571428571428571,31.142857142857142,1.792323478541407,65.12108638700445,"(37.5, 52.0]",Q3
36023,2020-04-02,47823,38,2,10,54,446,0.8571428571428571,34.0,1.792323478541407,71.09549798214248,"(37.5, 52.0]",Q3
36023,2020-04-03,47823,38,0,10,32,478,0.7142857142857143,32.142857142857146,1.493602898784506,67.21213044530278,"(37.5, 52.0]",Q3
36023,2020-04-04,47823,38,0,10,38,516,0.5714285714285714,33.57142857142857,1.1948823190276048,70.19933624287177,"(37.5, 52.0]",Q3
36023,2020-04-05,47823,38,3,13,42,558,0.7142857142857143,32.714285714285715,1.493602898784506,68.40701276433037,"(37.5, 52.0]",Q3
36023,2020-04-06,47823,38,3,16,25,583,1.1428571428571428,35.0,2.3897646380552096,73.1865420404408,"(37.5, 52.0]",Q3
36023,2020-04-07,47823,38,0,16,18,601,1.1428571428571428,35.857142857142854,2.3897646380552096,74.97886551898219,"(37.5, 52.0]",Q3
36023,2020-04-08,47823,38,0,16,41,642,1.1428571428571428,35.714285714285715,2.3897646380552096,74.6801449392253,"(37.5, 52.0]",Q3
36023,2020-04-09,47823,38,1,17,25,667,1.0,31.571428571428573,2.091044058298308,66.01724812627516,"(37.5, 52.0]",Q3
36023,2020-04-10,47823,38,0,17,20,687,1.0,29.857142857142858,2.091044058298308,62.43260116919235,"(37.5, 52.0]",Q3
36023,2020-04-11,47823,38,1,18,18,705,1.1428571428571428,27.0,2.3897646380552096,56.45818957405432,"(37.5, 52.0]",Q3
36023,2020-04-12,47823,38,2,20,18,723,1.0,23.571428571428573,2.091044058298308,49.2888956598887,"(37.5, 52.0]",Q3
36023,2020-04-13,47823,38,2,22,38,761,0.8571428571428571,25.428571428571427,1.792323478541407,53.1722631967284,"(37.5, 52.0]",Q3
36023,2020-04-14,47823,38,1,23,6,767,1.0,23.714285714285715,2.091044058298308,49.5876162396456,"(37.5, 52.0]",Q3
36023,2020-04-15,47823,38,1,24,17,784,1.1428571428571428,20.285714285714285,2.3897646380552096,42.41832232547997,"(37.5, 52.0]",Q3
36023,2020-04-16,47823,38,1,25,13,797,1.1428571428571428,18.571428571428573,2.3897646380552096,38.83367536839716,"(37.5, 52.0]",Q3
36023,2020-04-17,47823,38,0,25,19,816,1.1428571428571428,18.428571428571427,2.3897646380552096,38.534954788640256,"(37.5, 52.0]",Q3
36023,2020-04-18,47823,38,0,25,11,827,1.0,17.428571428571427,2.091044058298308,36.44391073034195,"(37.5, 52.0]",Q3
36023,2020-04-19,47823,38,0,25,12,839,0.7142857142857143,16.571428571428573,1.493602898784506,34.65158725180054,"(37.5, 52.0]",Q3
36023,2020-04-20,47823,38,0,25,2,841,0.42857142857142855,11.428571428571429,0.8961617392707035,23.897646380552096,"(37.5, 52.0]",Q3
36023,2020-04-21,47823,38,0,25,5,846,0.2857142857142857,11.285714285714286,0.5974411595138024,23.598925800795197,"(37.5, 52.0]",Q3
36023,2020-04-22,47823,38,0,25,30,876,0.14285714285714285,13.142857142857142,0.2987205797569012,27.482293337634907,"(37.5, 52.0]",Q3
36023,2020-04-23,47823,38,0,25,30,906,0.0,15.571428571428571,0.0,32.56054319350223,"(37.5, 52.0]",Q3
36023,2020-04-24,47823,38,3,28,109,1015,0.42857142857142855,28.428571428571427,0.8961617392707035,59.445395371623334,"(37.5, 52.0]",Q3
36023,2020-04-25,47823,38,0,28,26,1041,0.42857142857142855,30.571428571428573,0.8961617392707035,63.92620406797686,"(37.5, 52.0]",Q3
36023,2020-04-26,47823,38,0,28,16,1057,0.42857142857142855,31.142857142857142,0.8961617392707035,65.12108638700445,"(37.5, 52.0]",Q3
36023,2020-04-27,47823,38,0,28,7,1064,0.42857142857142855,31.857142857142858,0.8961617392707035,66.61468928578897,"(37.5, 52.0]",Q3
36023,2020-04-28,47823,38,0,28,22,1086,0.42857142857142855,34.285714285714285,0.8961617392707035,71.69293914165628,"(37.5, 52.0]",Q3
36023,2020-04-29,47823,38,0,28,26,1112,0.42857142857142855,33.714285714285715,0.8961617392707035,70.49805682262868,"(37.5, 52.0]",Q3
36023,2020-04-30,47823,38,0,28,31,1143,0.42857142857142855,33.857142857142854,0.8961617392707035,70.79677740238557,"(37.5, 52.0]",Q3
36023,2020-05-01,47823,38,0,28,30,1173,0.0,22.571428571428573,0.0,47.19785160159039,"(37.5, 52.0]",Q3
36023,2020-05-02,47823,38,0,28,16,1189,0.0,21.142857142857142,0.0,44.210645804021375,"(37.5, 52.0]",Q3
36023,2020-05-03,47823,38,0,28,42,1231,0.0,24.857142857142858,0.0,51.97738087770081,"(37.5, 52.0]",Q3
36023,2020-05-04,47823,38,0,28,12,1243,0.0,25.571428571428573,0.0,53.47098377648531,"(37.5, 52.0]",Q3
36023,2020-05-05,47823,38,0,28,33,1276,0.0,27.142857142857142,0.0,56.75691015381122,"(37.5, 52.0]",Q3
36023,2020-05-06,47823,38,1,29,27,1303,0.14285714285714285,27.285714285714285,0.2987205797569012,57.05563073356813,"(37.5, 52.0]",Q3
36023,2020-05-07,47823,38,0,29,38,1341,0.14285714285714285,28.285714285714285,0.2987205797569012,59.14667479186643,"(37.5, 52.0]",Q3
36023,2020-05-08,47823,38,0,29,96,1437,0.14285714285714285,37.714285714285715,0.2987205797569012,78.86223305582192,"(37.5, 52.0]",Q3
36023,2020-05-09,47823,38,0,29,29,1466,0.14285714285714285,39.57142857142857,0.2987205797569012,82.74560059266163,"(37.5, 52.0]",Q3
36023,2020-05-10,47823,38,0,29,27,1493,0.14285714285714285,37.42857142857143,0.2987205797569012,78.26479189630811,"(37.5, 52.0]",Q3
36023,2020-05-11,47823,38,1,30,33,1526,0.2857142857142857,40.42857142857143,0.5974411595138024,84.53792407120305,"(37.5, 52.0]",Q3
36023,2020-05-12,47823,38,1,31,40,1566,0.42857142857142855,41.42857142857143,0.8961617392707035,86.62896812950135,"(37.5, 52.0]",Q3
36023,2020-05-13,47823,38,2,33,50,1616,0.5714285714285714,44.714285714285715,1.1948823190276048,93.49954146391008,"(37.5, 52.0]",Q3
36023,2020-05-14,47823,38,0,33,95,1711,0.5714285714285714,52.857142857142854,1.1948823190276048,110.52661451005343,"(37.5, 52.0]",Q3
36023,2020-05-15,47823,38,1,34,221,1932,0.7142857142857143,70.71428571428571,1.493602898784506,147.86668697966607,"(37.5, 52.0]",Q3
36023,2020-05-16,47823,38,0,34,140,2072,0.7142857142857143,86.57142857142857,1.493602898784506,181.02467133268212,"(37.5, 52.0]",Q3
36023,2020-05-17,47823,38,1,35,99,2171,0.8571428571428571,96.85714285714286,1.792323478541407,202.53255307517904,"(37.5, 52.0]",Q3
36023,2020-05-18,47823,38,1,36,62,2233,0.8571428571428571,101.0,1.792323478541407,211.19544988812913,"(37.5, 52.0]",Q3
36023,2020-05-19,47823,38,0,36,77,2310,0.7142857142857143,106.28571428571429,1.493602898784506,222.2481113391345,"(37.5, 52.0]",Q3
36023,2020-05-20,47823,38,0,36,144,2454,0.42857142857142855,119.71428571428571,0.8961617392707035,250.3278458362832,"(37.5, 52.0]",Q3
36023,2020-05-21,47823,38,1,37,86,2540,0.5714285714285714,118.42857142857143,1.1948823190276048,247.63936061847107,"(37.5, 52.0]",Q3
36023,2020-05-22,47823,38,1,38,223,2763,0.5714285714285714,118.71428571428571,1.1948823190276048,248.23680177798488,"(37.5, 52.0]",Q3
36023,2020-05-23,47823,38,1,39,147,2910,0.7142857142857143,119.71428571428571,1.493602898784506,250.3278458362832,"(37.5, 52.0]",Q3
36023,2020-05-24,47823,38,0,39,221,3131,0.5714285714285714,137.14285714285714,1.1948823190276048,286.77175656662513,"(37.5, 52.0]",Q3
36023,2020-05-25,47823,38,0,39,64,3195,0.42857142857142855,137.42857142857142,0.8961617392707035,287.3691977261389,"(37.5, 52.0]",Q3
36023,2020-05-26,47823,38,0,39,82,3277,0.42857142857142855,138.14285714285714,0.8961617392707035,288.86280062492347,"(37.5, 52.0]",Q3
36023,2020-05-27,47823,38,0,39,34,3311,0.42857142857142855,122.42857142857143,0.8961617392707035,256.00353685166436,"(37.5, 52.0]",Q3
36023,2020-05-28,47823,38,0,39,207,3518,0.2857142857142857,139.71428571428572,0.5974411595138024,292.1487270022494,"(37.5, 52.0]",Q3
36023,2020-05-29,47823,38,2,41,188,3706,0.42857142857142855,134.71428571428572,0.8961617392707035,281.69350671075784,"(37.5, 52.0]",Q3
36023,2020-05-30,47823,38,0,41,261,3967,0.2857142857142857,151.0,0.5974411595138024,315.74765280304456,"(37.5, 52.0]",Q3
36023,2020-05-31,47823,38,0,41,84,4051,0.2857142857142857,131.42857142857142,0.5974411595138024,274.82293337634906,"(37.5, 52.0]",Q3
36023,2020-06-01,47823,38,0,41,128,4179,0.2857142857142857,140.57142857142858,0.5974411595138024,293.9410504807908,"(37.5, 52.0]",Q3
36023,2020-06-02,47823,38,0,41,92,4271,0.2857142857142857,142.0,0.5974411595138024,296.92825627835975,"(37.5, 52.0]",Q3
36023,2020-06-03,47823,38,0,41,130,4401,0.2857142857142857,155.71428571428572,0.5974411595138024,325.60543193502235,"(37.5, 52.0]",Q3
36023,2020-06-04,47823,38,0,41,343,4744,0.2857142857142857,175.14285714285714,0.5974411595138024,366.23143078196085,"(37.5, 52.0]",Q3
36023,2020-06-05,47823,38,0,41,294,5038,0.0,190.28571428571428,0.0,397.8958122361924,"(37.5, 52.0]",Q3
36023,2020-06-06,47823,38,0,41,201,5239,0.0,181.71428571428572,0.0,379.9725774507783,"(37.5, 52.0]",Q3
36023,2020-06-07,47823,38,1,42,179,5418,0.14285714285714285,195.28571428571428,0.2987205797569012,408.35103252768386,"(37.5, 52.0]",Q3
36025,2020-03-02,44527,51,0,0,0,0,0.0,0.0,0.0,0.0,"(37.5, 52.0]",Q3
36025,2020-03-03,44527,51,0,0,0,0,0.0,0.0,0.0,0.0,"(37.5, 52.0]",Q3
36025,2020-03-04,44527,51,0,0,0,0,0.0,0.0,0.0,0.0,"(37.5, 52.0]",Q3
36025,2020-03-05,44527,51,0,0,0,0,0.0,0.0,0.0,0.0,"(37.5, 52.0]",Q3
36025,2020-03-06,44527,51,0,0,0,0,0.0,0.0,0.0,0.0,"(37.5, 52.0]",Q3
36025,2020-03-07,44527,51,0,0,0,0,0.0,0.0,0.0,0.0,"(37.5, 52.0]",Q3
36025,2020-03-08,44527,51,0,0,0,0,0.0,0.0,0.0,0.0,"(37.5, 52.0]",Q3
36025,2020-03-09,44527,51,0,0,1,1,0.0,0.14285714285714285,0.0,0.3208326248279535,"(37.5, 52.0]",Q3
36025,2020-03-10,44527,51,0,0,1,2,0.0,0.2857142857142857,0.0,0.641665249655907,"(37.5, 52.0]",Q3
36025,2020-03-11,44527,51,0,0,2,4,0.0,0.5714285714285714,0.0,1.283330499311814,"(37.5, 52.0]",Q3
36025,2020-03-12,44527,51,1,1,1,5,0.14285714285714285,0.7142857142857143,0.3208326248279535,1.6041631241397676,"(37.5, 52.0]",Q3
36025,2020-03-13,44527,51,0,1,1,6,0.14285714285714285,0.8571428571428571,0.3208326248279535,1.924995748967721,"(37.5, 52.0]",Q3
36025,2020-03-14,44527,51,0,1,1,7,0.14285714285714285,1.0,0.3208326248279535,2.2458283737956743,"(37.5, 52.0]",Q3
36025,2020-03-15,44527,51,0,1,5,12,0.14285714285714285,1.7142857142857142,0.3208326248279535,3.849991497935442,"(37.5, 52.0]",Q3
36025,2020-03-16,44527,51,0,1,0,12,0.14285714285714285,1.5714285714285714,0.3208326248279535,3.5291588731074883,"(37.5, 52.0]",Q3
36025,2020-03-17,44527,51,0,1,0,12,0.14285714285714285,1.4285714285714286,0.3208326248279535,3.208326248279535,"(37.5, 52.0]",Q3
36025,2020-03-18,44527,51,0,1,1,13,0.14285714285714285,1.2857142857142858,0.3208326248279535,2.887493623451582,"(37.5, 52.0]",Q3
36025,2020-03-19,44527,51,0,1,4,17,0.0,1.7142857142857142,0.0,3.849991497935442,"(37.5, 52.0]",Q3
36025,2020-03-20,44527,51,0,1,8,25,0.0,2.7142857142857144,0.0,6.095819871731117,"(37.5, 52.0]",Q3
36025,2020-03-21,44527,51,2,3,10,35,0.2857142857142857,4.0,0.641665249655907,8.983313495182697,"(37.5, 52.0]",Q3
36025,2020-03-22,44527,51,0,3,10,45,0.2857142857142857,4.714285714285714,0.641665249655907,10.587476619322466,"(37.5, 52.0]",Q3
36025,2020-03-23,44527,51,0,3,5,50,0.2857142857142857,5.428571428571429,0.641665249655907,12.191639743462234,"(37.5, 52.0]",Q3
36025,2020-03-24,44527,51,2,5,5,55,0.5714285714285714,6.142857142857143,1.283330499311814,13.795802867602001,"(37.5, 52.0]",Q3
36025,2020-03-25,44527,51,2,7,12,67,0.8571428571428571,7.714285714285714,1.924995748967721,17.32496174070949,"(37.5, 52.0]",Q3
36025,2020-03-26,44527,51,1,8,7,74,1.0,8.142857142857142,2.2458283737956743,18.28745961519335,"(37.5, 52.0]",Q3
36025,2020-03-27,44527,51,0,8,13,87,1.0,8.857142857142858,2.2458283737956743,19.89162273933312,"(37.5, 52.0]",Q3
36025,2020-03-28,44527,51,0,8,4,91,0.7142857142857143,8.0,1.6041631241397676,17.966626990365395,"(37.5, 52.0]",Q3
36025,2020-03-29,44527,51,3,11,12,103,1.1428571428571428,8.285714285714286,2.566660998623628,18.608292240021306,"(37.5, 52.0]",Q3
36025,2020-03-30,44527,51,5,16,11,114,1.8571428571428572,9.142857142857142,4.1708241227633955,20.533287988989024,"(37.5, 52.0]",Q3
36025,2020-03-31,44527,51,4,20,13,127,2.142857142857143,10.285714285714286,4.812489372419302,23.099948987612656,"(37.5, 52.0]",Q3
36025,2020-04-01,44527,51,2,22,7,134,2.142857142857143,9.571428571428571,4.812489372419302,21.495785863472886,"(37.5, 52.0]",Q3
36025,2020-04-02,44527,51,2,24,9,143,2.2857142857142856,9.857142857142858,5.133321997247256,22.137451113128794,"(37.5, 52.0]",Q3
36025,2020-04-03,44527,51,2,26,18,161,2.5714285714285716,10.571428571428571,5.774987246903164,23.741614237268557,"(37.5, 52.0]",Q3
36025,2020-04-04,44527,51,1,27,12,173,2.7142857142857144,11.714285714285714,6.095819871731117,26.308275235892182,"(37.5, 52.0]",Q3
36025,2020-04-05,44527,51,2,29,28,201,2.5714285714285716,14.0,5.774987246903164,31.441597233139447,"(37.5, 52.0]",Q3
36025,2020-04-06,44527,51,7,36,30,231,2.857142857142857,16.714285714285715,6.41665249655907,37.53741710487056,"(37.5, 52.0]",Q3
36025,2020-04-07,44527,51,1,37,16,247,2.4285714285714284,17.142857142857142,5.454154622075209,38.499914979354415,"(37.5, 52.0]",Q3
36025,2020-04-08,44527,51,0,37,22,269,2.142857142857143,19.285714285714285,4.812489372419302,43.31240435177372,"(37.5, 52.0]",Q3
36025,2020-04-09,44527,51,2,39,20,289,2.142857142857143,20.857142857142858,4.812489372419302,46.84156322488121,"(37.5, 52.0]",Q3
36025,2020-04-10,44527,51,0,39,17,306,1.8571428571428572,20.714285714285715,4.1708241227633955,46.52073060005326,"(37.5, 52.0]",Q3
36025,2020-04-11,44527,51,0,39,10,316,1.7142857142857142,20.428571428571427,3.849991497935442,45.87906535039735,"(37.5, 52.0]",Q3
36025,2020-04-12,44527,51,3,42,14,330,1.8571428571428572,18.428571428571427,4.1708241227633955,41.387408602806,"(37.5, 52.0]",Q3
36025,2020-04-13,44527,51,3,45,48,378,1.2857142857142858,21.0,2.887493623451582,47.16239584970916,"(37.5, 52.0]",Q3
36025,2020-04-14,44527,51,1,46,7,385,1.2857142857142858,19.714285714285715,2.887493623451582,44.27490222625759,"(37.5, 52.0]",Q3
36025,2020-04-15,44527,51,1,47,9,394,1.4285714285714286,17.857142857142858,3.208326248279535,40.10407810349419,"(37.5, 52.0]",Q3
36025,2020-04-16,44527,51,1,48,10,404,1.2857142857142858,16.428571428571427,2.887493623451582,36.89575185521465,"(37.5, 52.0]",Q3
36025,2020-04-17,44527,51,1,49,8,412,1.4285714285714286,15.142857142857142,3.208326248279535,34.00825823176307,"(37.5, 52.0]",Q3
36025,2020-04-18,44527,51,0,49,10,422,1.4285714285714286,15.142857142857142,3.208326248279535,34.00825823176307,"(37.5, 52.0]",Q3
36025,2020-04-19,44527,51,0,49,5,427,1.0,13.857142857142858,2.2458283737956743,31.120764608311493,"(37.5, 52.0]",Q3
36025,2020-04-20,44527,51,0,49,3,430,0.5714285714285714,7.428571428571429,1.283330499311814,16.683296491053582,"(37.5, 52.0]",Q3
36025,2020-04-21,44527,51,1,50,18,448,0.5714285714285714,9.0,1.283330499311814,20.21245536416107,"(37.5, 52.0]",Q3
36025,2020-04-22,44527,51,0,50,21,469,0.42857142857142855,10.714285714285714,0.9624978744838605,24.06244686209651,"(37.5, 52.0]",Q3
36025,2020-04-23,44527,51,1,51,15,484,0.42857142857142855,11.428571428571429,0.9624978744838605,25.66660998623628,"(37.5, 52.0]",Q3
36025,2020-04-24,44527,51,7,58,135,619,1.2857142857142858,29.571428571428573,2.887493623451582,66.41235333938637,"(37.5, 52.0]",Q3
36025,2020-04-25,44527,51,0,58,35,654,1.2857142857142858,33.142857142857146,2.887493623451582,74.43316896008523,"(37.5, 52.0]",Q3
36025,2020-04-26,44527,51,0,58,21,675,1.2857142857142858,35.42857142857143,2.887493623451582,79.56649095733248,"(37.5, 52.0]",Q3
36025,2020-04-27,44527,51,1,59,16,691,1.4285714285714286,37.285714285714285,3.208326248279535,83.73731508009587,"(37.5, 52.0]",Q3
36025,2020-04-28,44527,51,1,60,14,705,1.4285714285714286,36.714285714285715,3.208326248279535,82.45398458078405,"(37.5, 52.0]",Q3
36025,2020-04-29,44527,51,1,61,24,729,1.5714285714285714,37.142857142857146,3.5291588731074883,83.41648245526791,"(37.5, 52.0]",Q3
36025,2020-04-30,44527,51,0,61,24,753,1.4285714285714286,38.42857142857143,3.208326248279535,86.3039760787195,"(37.5, 52.0]",Q3
36025,2020-05-01,44527,51,0,61,29,782,0.42857142857142855,23.285714285714285,0.9624978744838605,52.29571784695642,"(37.5, 52.0]",Q3
36025,2020-05-02,44527,51,0,61,28,810,0.42857142857142855,22.285714285714285,0.9624978744838605,50.04988947316074,"(37.5, 52.0]",Q3
36025,2020-05-03,44527,51,1,62,54,864,0.5714285714285714,27.0,1.283330499311814,60.63736609248321,"(37.5, 52.0]",Q3
36025,2020-05-04,44527,51,0,62,31,895,0.42857142857142855,29.142857142857142,0.9624978744838605,65.44985546490251,"(37.5, 52.0]",Q3
36025,2020-05-05,44527,51,0,62,30,925,0.2857142857142857,31.428571428571427,0.641665249655907,70.58317746214976,"(37.5, 52.0]",Q3
36025,2020-05-06,44527,51,1,63,30,955,0.2857142857142857,32.285714285714285,0.641665249655907,72.5081732111175,"(37.5, 52.0]",Q3
36025,2020-05-07,44527,51,0,63,24,979,0.2857142857142857,32.285714285714285,0.641665249655907,72.5081732111175,"(37.5, 52.0]",Q3
36025,2020-05-08,44527,51,0,63,30,1009,0.2857142857142857,32.42857142857143,0.641665249655907,72.82900583594545,"(37.5, 52.0]",Q3
36025,2020-05-09,44527,51,1,64,33,1042,0.42857142857142855,33.142857142857146,0.9624978744838605,74.43316896008523,"(37.5, 52.0]",Q3
36025,2020-05-10,44527,51,1,65,19,1061,0.42857142857142855,28.142857142857142,0.9624978744838605,63.20402709110684,"(37.5, 52.0]",Q3
36025,2020-05-11,44527,51,0,65,50,1111,0.42857142857142855,30.857142857142858,0.9624978744838605,69.29984696283796,"(37.5, 52.0]",Q3
36025,2020-05-12,44527,51,1,66,53,1164,0.5714285714285714,34.142857142857146,1.283330499311814,76.67899733388089,"(37.5, 52.0]",Q3
36025,2020-05-13,44527,51,1,67,136,1300,0.5714285714285714,49.285714285714285,1.283330499311814,110.68725556564395,"(37.5, 52.0]",Q3
36025,2020-05-14,44527,51,0,67,120,1420,0.5714285714285714,63.0,1.283330499311814,141.4871875491275,"(37.5, 52.0]",Q3
36025,2020-05-15,44527,51,1,68,70,1490,0.7142857142857143,68.71428571428571,1.6041631241397676,154.32049254224563,"(37.5, 52.0]",Q3
36025,2020-05-16,44527,51,1,69,51,1541,0.7142857142857143,71.28571428571429,1.6041631241397676,160.0954797891488,"(37.5, 52.0]",Q3
36025,2020-05-17,44527,51,0,69,56,1597,0.5714285714285714,76.57142857142857,1.283330499311814,171.9662869077831,"(37.5, 52.0]",Q3
36025,2020-05-18,44527,51,0,69,65,1662,0.5714285714285714,78.71428571428571,1.283330499311814,176.77877628020235,"(37.5, 52.0]",Q3
36025,2020-05-19,44527,51,0,69,45,1707,0.42857142857142855,77.57142857142857,0.9624978744838605,174.21211528157875,"(37.5, 52.0]",Q3
36025,2020-05-20,44527,51,2,71,65,1772,0.5714285714285714,67.42857142857143,1.283330499311814,151.43299891879406,"(37.5, 52.0]",Q3
36025,2020-05-21,44527,51,1,72,124,1896,0.7142857142857143,68.0,1.6041631241397676,152.71632941810586,"(37.5, 52.0]",Q3
36025,2020-05-22,44527,51,2,74,51,1947,0.8571428571428571,65.28571428571429,1.924995748967721,146.62050954637476,"(37.5, 52.0]",Q3
36025,2020-05-23,44527,51,3,77,80,2027,1.1428571428571428,69.42857142857143,2.566660998623628,155.9246556663854,"(37.5, 52.0]",Q3
36025,2020-05-24,44527,51,0,77,44,2071,1.1428571428571428,67.71428571428571,2.566660998623628,152.07466416844994,"(37.5, 52.0]",Q3
36025,2020-05-25,44527,51,0,77,22,2093,1.1428571428571428,61.57142857142857,2.566660998623628,138.27886130084795,"(37.5, 52.0]",Q3
36025,2020-05-26,44527,51,1,78,205,2298,1.2857142857142858,84.42857142857143,2.887493623451582,189.6120812733205,"(37.5, 52.0]",Q3
36025,2020-05-27,44527,51,0,78,213,2511,1.0,105.57142857142857,2.2458283737956743,237.09530974785764,"(37.5, 52.0]",Q3
36025,2020-05-28,44527,51,1,79,156,2667,1.0,110.14285714285714,2.2458283737956743,247.36195374235214,"(37.5, 52.0]",Q3
36025,2020-05-29,44527,51,0,79,123,2790,0.7142857142857143,120.42857142857143,1.6041631241397676,270.4619027299648,"(37.5, 52.0]",Q3
36025,2020-05-30,44527,51,0,79,209,2999,0.2857142857142857,138.85714285714286,0.641665249655907,311.8493113327708,"(37.5, 52.0]",Q3
36025,2020-05-31,44527,51,2,81,96,3095,0.5714285714285714,146.28571428571428,1.283330499311814,328.5326078238244,"(37.5, 52.0]",Q3
36025,2020-06-01,44527,51,1,82,138,3233,0.7142857142857143,162.85714285714286,1.6041631241397676,365.749192303867,"(37.5, 52.0]",Q3
36025,2020-06-02,44527,51,0,82,195,3428,0.5714285714285714,161.42857142857142,1.283330499311814,362.54086605558746,"(37.5, 52.0]",Q3
36025,2020-06-03,44527,51,0,82,171,3599,0.5714285714285714,155.42857142857142,1.283330499311814,349.0658958128134,"(37.5, 52.0]",Q3
36025,2020-06-04,44527,51,2,84,129,3728,0.7142857142857143,151.57142857142858,1.6041631241397676,340.4034149424587,"(37.5, 52.0]",Q3
36025,2020-06-05,44527,51,1,85,217,3945,0.8571428571428571,165.0,1.924995748967721,370.5616816762863,"(37.5, 52.0]",Q3
36025,2020-06-06,44527,51,0,85,124,4069,0.8571428571428571,152.85714285714286,1.924995748967721,343.2909085659103,"(37.5, 52.0]",Q3
36025,2020-06-07,44527,51,0,85,164,4233,0.5714285714285714,162.57142857142858,1.283330499311814,365.1075270542111,"(37.5, 52.0]",Q3
36027,2020-03-02,293718,26,0,0,0,0,0.0,0.0,0.0,0.0,"(24.0, 37.5]",Q2
36027,2020-03-03,293718,26,0,0,0,0,0.0,0.0,0.0,0.0,"(24.0, 37.5]",Q2
36027,2020-03-04,293718,26,0,0,0,0,0.0,0.0,0.0,0.0,"(24.0, 37.5]",Q2
36027,2020-03-05,293718,26,0,0,0,0,0.0,0.0,0.0,0.0,"(24.0, 37.5]",Q2
36027,2020-03-06,293718,26,0,0,0,0,0.0,0.0,0.0,0.0,"(24.0, 37.5]",Q2
36027,2020-03-07,293718,26,0,0,0,0,0.0,0.0,0.0,0.0,"(24.0, 37.5]",Q2
36027,2020-03-08,293718,26,0,0,0,0,0.0,0.0,0.0,0.0,"(24.0, 37.5]",Q2
36027,2020-03-09,293718,26,0,0,0,0,0.0,0.0,0.0,0.0,"(24.0, 37.5]",Q2
36027,2020-03-10,293718,26,0,0,2,2,0.0,0.2857142857142857,0.0,0.09727503445968096,"(24.0, 37.5]",Q2
36027,2020-03-11,293718,26,1,1,5,7,0.14285714285714285,1.0,0.04863751722984048,0.3404626206088833,"(24.0, 37.5]",Q2
36027,2020-03-12,293718,26,0,1,3,10,0.14285714285714285,1.4285714285714286,0.04863751722984048,0.4863751722984048,"(24.0, 37.5]",Q2
36027,2020-03-13,293718,26,2,3,10,20,0.42857142857142855,2.857142857142857,0.1459125516895214,0.9727503445968096,"(24.0, 37.5]",Q2
36027,2020-03-14,293718,26,4,7,17,37,1.0,5.285714285714286,0.3404626206088833,1.7995881375040979,"(24.0, 37.5]",Q2
36027,2020-03-15,293718,26,3,10,20,57,1.4285714285714286,8.142857142857142,0.4863751722984048,2.772338482100907,"(24.0, 37.5]",Q2
36027,2020-03-16,293718,26,6,16,32,89,2.2857142857142856,12.714285714285714,0.7782002756774477,4.328739033455802,"(24.0, 37.5]",Q2
36027,2020-03-17,293718,26,4,20,23,112,2.857142857142857,15.714285714285714,0.9727503445968096,5.350126895282452,"(24.0, 37.5]",Q2
36027,2020-03-18,293718,26,11,31,107,219,4.285714285714286,30.285714285714285,1.4591255168952144,10.311153652726182,"(24.0, 37.5]",Q2
36027,2020-03-19,293718,26,5,36,59,278,5.0,38.285714285714285,1.7023131030444167,13.034854617597247,"(24.0, 37.5]",Q2
36027,2020-03-20,293718,26,13,49,205,483,6.571428571428571,66.14285714285714,2.237325792572662,22.519170477416143,"(24.0, 37.5]",Q2
36027,2020-03-21,293718,26,33,82,205,688,10.714285714285714,93.0,3.647813792238036,31.66302371662615,"(24.0, 37.5]",Q2
36027,2020-03-22,293718,26,18,100,135,823,12.857142857142858,109.42857142857143,4.377376550685644,37.25633819805781,"(24.0, 37.5]",Q2
36027,2020-03-23,293718,26,24,124,111,934,15.428571428571429,120.71428571428571,5.252851860822772,41.098702059215206,"(24.0, 37.5]",Q2
36027,2020-03-24,293718,26,29,153,146,1080,19.0,138.28571428571428,6.468789791568783,47.08111667848558,"(24.0, 37.5]",Q2
36027,2020-03-25,293718,26,37,190,209,1289,22.714285714285715,152.85714285714286,7.733365239544637,52.04214343592932,"(24.0, 37.5]",Q2
36027,2020-03-26,293718,26,35,225,155,1444,27.0,166.57142857142858,9.19249075643985,56.711345089994005,"(24.0, 37.5]",Q2
36027,2020-03-27,293718,26,37,262,200,1644,30.428571428571427,165.85714285714286,10.35979116995602,56.4681575038448,"(24.0, 37.5]",Q2
36027,2020-03-28,293718,26,58,320,195,1839,34.0,164.42857142857142,11.575729100702034,55.981782331546384,"(24.0, 37.5]",Q2
36027,2020-03-29,293718,26,72,392,227,2066,41.714285714285715,177.57142857142858,14.20215503111342,60.45643391669172,"(24.0, 37.5]",Q2
36027,2020-03-30,293718,26,92,484,300,2366,51.42857142857143,204.57142857142858,17.509506202742575,69.64892467313157,"(24.0, 37.5]",Q2
36027,2020-03-31,293718,26,63,547,196,2562,56.285714285714285,211.71428571428572,19.16318178855715,72.08080053462359,"(24.0, 37.5]",Q2
36027,2020-04-01,293718,26,120,667,330,2892,68.14285714285714,229.0,23.200095718633907,77.9659401194343,"(24.0, 37.5]",Q2
36027,2020-04-02,293718,26,142,809,415,3307,83.42857142857143,266.14285714285717,28.40431006222684,90.61169459919283,"(24.0, 37.5]",Q2
36027,2020-04-03,293718,26,129,938,447,3754,96.57142857142857,301.42857142857144,32.878961647372165,102.62516135496342,"(24.0, 37.5]",Q2
36027,2020-04-04,293718,26,139,1077,352,4106,108.14285714285714,323.85714285714283,36.818600542989245,110.26125156004835,"(24.0, 37.5]",Q2
36027,2020-04-05,293718,26,112,1189,338,4444,113.85714285714286,339.7142857142857,38.76410123218287,115.66001597256067,"(24.0, 37.5]",Q2
36027,2020-04-06,293718,26,60,1249,335,4779,109.28571428571429,344.7142857142857,37.20770068082797,117.36232907560507,"(24.0, 37.5]",Q2
36027,2020-04-07,293718,26,146,1395,462,5241,121.14285714285714,382.7142857142857,41.244614610904726,130.29990865874265,"(24.0, 37.5]",Q2
36027,2020-04-08,293718,26,98,1493,512,5753,118.0,408.7142857142857,40.17458923184824,139.1519367945736,"(24.0, 37.5]",Q2
36027,2020-04-09,293718,26,105,1598,509,6262,112.71428571428571,422.14285714285717,38.375001094344135,143.72386341417862,"(24.0, 37.5]",Q2
36027,2020-04-10,293718,26,146,1744,584,6846,115.14285714285714,441.7142857142857,39.20183888725143,150.38720327466677,"(24.0, 37.5]",Q2
36027,2020-04-11,293718,26,94,1838,431,7277,108.71428571428571,453.0,37.01315061190861,154.22956713582414,"(24.0, 37.5]",Q2
36027,2020-04-12,293718,26,43,1881,499,7776,98.85714285714286,476.0,33.657161923049614,162.06020740982848,"(24.0, 37.5]",Q2
36027,2020-04-13,293718,26,53,1934,566,8342,97.85714285714286,509.0,33.31669930244073,173.29547388992162,"(24.0, 37.5]",Q2
36027,2020-04-14,293718,26,114,2048,487,8829,93.28571428571429,512.5714285714286,31.760298751085834,174.51141182066763,"(24.0, 37.5]",Q2
36027,2020-04-15,293718,26,37,2085,314,9143,84.57142857142857,484.2857142857143,28.793410200065566,164.88118340915923,"(24.0, 37.5]",Q2
36027,2020-04-16,293718,26,57,2142,300,9443,77.71428571428571,454.42857142857144,26.45880937303322,154.71594230812258,"(24.0, 37.5]",Q2
36027,2020-04-17,293718,26,59,2201,381,9824,65.28571428571429,425.42857142857144,22.2273453740371,144.84252631046496,"(24.0, 37.5]",Q2
36027,2020-04-18,293718,26,39,2240,196,10020,57.42857142857143,391.85714285714283,19.552281926395874,133.41270976145242,"(24.0, 37.5]",Q2
36027,2020-04-19,293718,26,44,2284,357,10377,57.57142857142857,371.57142857142856,19.600919443625713,126.50618231481508,"(24.0, 37.5]",Q2
36027,2020-04-20,293718,26,47,2331,209,10586,56.714285714285715,320.57142857142856,19.30909434024667,109.14258866376204,"(24.0, 37.5]",Q2
36027,2020-04-21,293718,26,60,2391,313,10899,49.0,295.7142857142857,16.682668409835287,100.67966066576979,"(24.0, 37.5]",Q2
36027,2020-04-22,293718,26,69,2460,366,11265,53.57142857142857,303.14285714285717,18.239068961190178,103.2088115617215,"(24.0, 37.5]",Q2
36027,2020-04-23,293718,26,57,2517,374,11639,53.57142857142857,313.7142857142857,18.239068961190178,106.80798783672968,"(24.0, 37.5]",Q2
36027,2020-04-24,293718,26,143,2660,913,12552,65.57142857142857,389.7142857142857,22.324620408496777,132.68314700300482,"(24.0, 37.5]",Q2
36027,2020-04-25,293718,26,69,2729,485,13037,69.85714285714286,431.0,23.783745925391997,146.73938948242872,"(24.0, 37.5]",Q2
36027,2020-04-26,293718,26,64,2793,389,13426,72.71428571428571,435.57142857142856,24.756496269988798,148.29579003378362,"(24.0, 37.5]",Q2
36027,2020-04-27,293718,26,24,2817,223,13649,69.42857142857143,437.57142857142856,23.637833373702474,148.97671527500137,"(24.0, 37.5]",Q2
36027,2020-04-28,293718,26,64,2881,566,14215,70.0,473.7142857142857,23.832383442621833,161.28200713415103,"(24.0, 37.5]",Q2
36027,2020-04-29,293718,26,73,2954,427,14642,70.57142857142857,482.42857142857144,24.0269335115412,164.2488956851713,"(24.0, 37.5]",Q2
36027,2020-04-30,293718,26,48,3002,443,15085,69.28571428571429,492.2857142857143,23.589195856472635,167.6048843740303,"(24.0, 37.5]",Q2
36027,2020-05-01,293718,26,47,3049,473,15558,55.57142857142857,429.42857142857144,18.919994202407945,146.2043767929005,"(24.0, 37.5]",Q2
36027,2020-05-02,293718,26,37,3086,434,15992,51.0,422.14285714285717,17.36359365105305,143.72386341417862,"(24.0, 37.5]",Q2
36027,2020-05-03,293718,26,45,3131,370,16362,48.285714285714285,419.42857142857144,16.439480823686083,142.79975058681165,"(24.0, 37.5]",Q2
36027,2020-05-04,293718,26,20,3151,307,16669,47.714285714285715,431.42857142857144,16.24493075476672,146.88530203411824,"(24.0, 37.5]",Q2
36027,2020-05-05,293718,26,41,3192,370,17039,44.42857142857143,403.42857142857144,15.12626785848039,137.3523486570695,"(24.0, 37.5]",Q2
36027,2020-05-06,293718,26,41,3233,438,17477,39.857142857142854,405.0,13.569867307125492,137.88736134659774,"(24.0, 37.5]",Q2
36027,2020-05-07,293718,26,44,3277,482,17959,39.285714285714285,410.57142857142856,13.375317238206131,139.78422451856153,"(24.0, 37.5]",Q2
36027,2020-05-08,293718,26,42,3319,534,18493,38.57142857142857,419.2857142857143,13.132129652056927,142.7511130695818,"(24.0, 37.5]",Q2
36027,2020-05-09,293718,26,40,3359,471,18964,39.0,424.57142857142856,13.27804220374645,144.5507012070859,"(24.0, 37.5]",Q2
36027,2020-05-10,293718,26,19,3378,348,19312,35.285714285714285,421.42857142857144,12.0134667557706,143.4806758280294,"(24.0, 37.5]",Q2
36027,2020-05-11,293718,26,21,3399,216,19528,35.42857142857143,408.42857142857144,12.06210427300044,139.05466176011393,"(24.0, 37.5]",Q2
36027,2020-05-12,293718,26,30,3429,387,19915,33.857142857142854,410.85714285714283,11.527091583472194,139.8814995530212,"(24.0, 37.5]",Q2
36027,2020-05-13,293718,26,45,3474,459,20374,34.42857142857143,413.85714285714283,11.721641652391556,140.90288741484784,"(24.0, 37.5]",Q2
36027,2020-05-14,293718,26,24,3498,394,20768,31.571428571428573,401.2857142857143,10.748891307794747,136.62278589862188,"(24.0, 37.5]",Q2
36027,2020-05-15,293718,26,29,3527,627,21395,29.714285714285715,414.57142857142856,10.116603583806821,141.14607500099706,"(24.0, 37.5]",Q2
36027,2020-05-16,293718,26,16,3543,491,21886,26.285714285714285,417.42857142857144,8.949303170290648,142.11882534559388,"(24.0, 37.5]",Q2
36027,2020-05-17,293718,26,9,3552,337,22223,24.857142857142858,415.85714285714283,8.462927997992242,141.58381265606562,"(24.0, 37.5]",Q2
36027,2020-05-18,293718,26,158,3710,972,23195,44.42857142857143,523.8571428571429,15.12626785848039,178.35377568182503,"(24.0, 37.5]",Q2
36027,2020-05-19,293718,26,14,3724,536,23731,42.142857142857146,545.1428571428571,14.348067582802942,185.60076574907126,"(24.0, 37.5]",Q2
36027,2020-05-20,293718,26,21,3745,573,24304,38.714285714285715,561.4285714285714,13.18076716928677,191.14544271327307,"(24.0, 37.5]",Q2
36027,2020-05-21,293718,26,22,3767,556,24860,38.42857142857143,584.5714285714286,13.08349213482709,199.02472050450723,"(24.0, 37.5]",Q2
36027,2020-05-22,293718,26,26,3793,549,25409,38.0,573.4285714285714,12.937579583137566,195.23099416057968,"(24.0, 37.5]",Q2
36027,2020-05-23,293718,26,14,3807,874,26283,37.714285714285715,628.1428571428571,12.840304548677887,213.85916325960858,"(24.0, 37.5]",Q2
36027,2020-05-24,293718,26,18,3825,650,26933,39.0,672.8571428571429,13.27804220374645,229.08270615254867,"(24.0, 37.5]",Q2
36027,2020-05-25,293718,26,9,3834,301,27234,17.714285714285715,577.0,6.03105213650022,196.4469320913257,"(24.0, 37.5]",Q2
36027,2020-05-26,293718,26,13,3847,423,27657,17.571428571428573,560.8571428571429,5.982414619270379,190.95089264435373,"(24.0, 37.5]",Q2
36027,2020-05-27,293718,26,20,3867,911,28568,17.428571428571427,609.1428571428571,5.933777102040538,207.3903734680398,"(24.0, 37.5]",Q2
36027,2020-05-28,293718,26,20,3887,1257,29825,17.142857142857142,709.2857142857143,5.836502067580858,241.485273046158,"(24.0, 37.5]",Q2
36027,2020-05-29,293718,26,12,3899,1265,31090,15.142857142857142,811.5714285714286,5.155576826363091,276.3097353827237,"(24.0, 37.5]",Q2
36027,2020-05-30,293718,26,10,3909,765,31855,14.571428571428571,796.0,4.961026757443729,271.00824600467115,"(24.0, 37.5]",Q2
36027,2020-05-31,293718,26,15,3924,1034,32889,14.142857142857142,850.8571428571429,4.815114205754208,289.6850526209299,"(24.0, 37.5]",Q2
36027,2020-06-01,293718,26,12,3936,936,33825,14.571428571428571,941.5714285714286,4.961026757443729,320.5698760618786,"(24.0, 37.5]",Q2
36027,2020-06-02,293718,26,15,3951,1003,34828,14.857142857142858,1024.4285714285713,5.058301791903411,348.7796360551861,"(24.0, 37.5]",Q2
36027,2020-06-03,293718,26,11,3962,771,35599,13.571428571428571,1004.4285714285714,4.620564136834846,341.9703836430084,"(24.0, 37.5]",Q2
36027,2020-06-04,293718,26,22,3984,1166,36765,13.857142857142858,991.4285714285714,4.717839171294527,337.5443695750929,"(24.0, 37.5]",Q2
36027,2020-06-05,293718,26,11,3995,1072,37837,13.714285714285714,963.8571428571429,4.669201654064685,328.1573287497337,"(24.0, 37.5]",Q2
36027,2020-06-06,293718,26,5,4000,793,38630,13.0,967.8571428571429,4.426014067915483,329.5191792321692,"(24.0, 37.5]",Q2
36027,2020-06-07,293718,26,6,4006,906,39536,11.714285714285714,949.5714285714286,3.988276412846919,323.2935770267497,"(24.0, 37.5]",Q2
36029,2020-03-02,919719,43,0,0,0,0,0.0,0.0,0.0,0.0,"(37.5, 52.0]",Q3
36029,2020-03-03,919719,43,0,0,0,0,0.0,0.0,0.0,0.0,"(37.5, 52.0]",Q3
36029,2020-03-04,919719,43,0,0,6,6,0.0,6.0,0.0,0.65237317050099,"(37.5, 52.0]",Q3
36029,2020-03-05,919719,43,0,0,6,12,0.0,6.0,0.0,0.65237317050099,"(37.5, 52.0]",Q3
36029,2020-03-06,919719,43,0,0,0,12,0.0,0.0,0.0,0.0,"(37.5, 52.0]",Q3
36029,2020-03-07,919719,43,0,0,2,14,0.0,2.0,0.0,0.21745772350033,"(37.5, 52.0]",Q3
36029,2020-03-08,919719,43,0,0,1,15,0.0,2.142857142857143,0.0,0.23299041803606782,"(37.5, 52.0]",Q3
36029,2020-03-09,919719,43,0,0,1,16,0.0,2.2857142857142856,0.0,0.2485231125718057,"(37.5, 52.0]",Q3
36029,2020-03-10,919719,43,0,0,2,18,0.0,2.5714285714285716,0.0,0.2795885016432814,"(37.5, 52.0]",Q3
36029,2020-03-11,919719,43,0,0,0,18,0.0,1.7142857142857142,0.0,0.18639233442885428,"(37.5, 52.0]",Q3
36029,2020-03-12,919719,43,0,0,13,31,0.0,2.7142857142857144,0.0,0.2951211961790193,"(37.5, 52.0]",Q3
36029,2020-03-13,919719,43,0,0,5,36,0.0,3.4285714285714284,0.0,0.37278466885770856,"(37.5, 52.0]",Q3
36029,2020-03-14,919719,43,3,3,22,58,0.42857142857142855,6.285714285714286,0.04659808360721357,0.6834385595724657,"(37.5, 52.0]",Q3
36029,2020-03-15,919719,43,3,6,10,68,0.8571428571428571,7.571428571428571,0.09319616721442714,0.8232328103941063,"(37.5, 52.0]",Q3
36029,2020-03-16,919719,43,1,7,2,70,1.0,7.714285714285714,0.108728861750165,0.8387655049298441,"(37.5, 52.0]",Q3
36029,2020-03-17,919719,43,0,7,2,72,1.0,7.714285714285714,0.108728861750165,0.8387655049298441,"(37.5, 52.0]",Q3
36029,2020-03-18,919719,43,21,28,130,202,4.0,26.285714285714285,0.43491544700066,2.8580157945757656,"(37.5, 52.0]",Q3
36029,2020-03-19,919719,43,3,31,43,245,4.428571428571429,30.571428571428573,0.48151353060787355,3.3239966306479016,"(37.5, 52.0]",Q3
36029,2020-03-20,919719,43,7,38,55,300,5.428571428571429,37.714285714285715,0.5902423923580385,4.100631357434795,"(37.5, 52.0]",Q3
36029,2020-03-21,919719,43,16,54,111,411,7.285714285714286,50.42857142857143,0.7921674213226307,5.483041171115464,"(37.5, 52.0]",Q3
36029,2020-03-22,919719,43,33,87,247,658,11.571428571428571,84.28571428571429,1.2581482573947664,9.164289776085337,"(37.5, 52.0]",Q3
36029,2020-03-23,919719,43,20,107,100,758,14.285714285714286,98.28571428571429,1.5532694535737859,10.686493840587646,"(37.5, 52.0]",Q3
36029,2020-03-24,919719,43,15,122,114,872,16.428571428571427,114.28571428571429,1.7862598716098532,12.426155628590287,"(37.5, 52.0]",Q3
36029,2020-03-25,919719,43,12,134,116,988,15.142857142857142,112.28571428571429,1.6464656207882127,12.208697905089956,"(37.5, 52.0]",Q3
36029,2020-03-26,919719,43,85,219,348,1336,26.857142857142858,155.85714285714286,2.920146572718717,16.946169738490003,"(37.5, 52.0]",Q3
36029,2020-03-27,919719,43,99,318,370,1706,40.0,200.85714285714286,4.349154470006599,21.838968517247427,"(37.5, 52.0]",Q3
36029,2020-03-28,919719,43,40,358,126,1832,43.42857142857143,203.0,4.721939138864308,22.071958935283494,"(37.5, 52.0]",Q3
36029,2020-03-29,919719,43,18,376,67,1899,41.285714285714285,177.28571428571428,4.48894872082824,19.276073918850678,"(37.5, 52.0]",Q3
36029,2020-03-30,919719,43,62,438,189,2088,47.285714285714285,190.0,5.1413218913292305,20.658483732531348,"(37.5, 52.0]",Q3
36029,2020-03-31,919719,43,26,464,119,2207,48.857142857142854,190.71428571428572,5.312181531222347,20.73614720521004,"(37.5, 52.0]",Q3
36029,2020-04-01,919719,43,153,617,571,2778,69.0,255.71428571428572,7.502291460761385,27.803523218970767,"(37.5, 52.0]",Q3
36029,2020-04-02,919719,43,103,720,429,3207,71.57142857142857,267.2857142857143,7.781879962404665,29.061671476365525,"(37.5, 52.0]",Q3
36029,2020-04-03,919719,43,88,808,317,3524,70.0,259.7142857142857,7.611020322511551,28.238438665971422,"(37.5, 52.0]",Q3
36029,2020-04-04,919719,43,110,918,402,3926,80.0,299.14285714285717,8.698308940013199,32.525462357835075,"(37.5, 52.0]",Q3
36029,2020-04-05,919719,43,105,1023,549,4475,92.42857142857143,368.0,10.049653364622394,40.012221124060716,"(37.5, 52.0]",Q3
36029,2020-04-06,919719,43,112,1135,396,4871,99.57142857142857,397.57142857142856,10.826288091409285,43.227488892958455,"(37.5, 52.0]",Q3
36029,2020-04-07,919719,43,70,1205,295,5166,105.85714285714286,422.7142857142857,11.509726650981753,45.961243131248324,"(37.5, 52.0]",Q3
36029,2020-04-08,919719,43,157,1362,458,5624,106.42857142857143,406.57142857142856,11.571857429124703,44.20604864870994,"(37.5, 52.0]",Q3
36029,2020-04-09,919719,43,47,1409,309,5933,98.42857142857143,389.42857142857144,10.702026535123384,42.3421253044214,"(37.5, 52.0]",Q3
36029,2020-04-10,919719,43,63,1472,297,6230,94.85714285714286,386.57142857142856,10.313709171729938,42.03147141370664,"(37.5, 52.0]",Q3
36029,2020-04-11,919719,43,99,1571,317,6547,93.28571428571429,374.42857142857144,10.142849531836822,40.711192378168924,"(37.5, 52.0]",Q3
36029,2020-04-12,919719,43,53,1624,182,6729,85.85714285714286,322.0,9.335149415978453,35.010693483553126,"(37.5, 52.0]",Q3
36029,2020-04-13,919719,43,44,1668,223,6952,76.14285714285714,297.2857142857143,8.278926187548278,32.32353732887048,"(37.5, 52.0]",Q3
36029,2020-04-14,919719,43,83,1751,326,7278,78.0,301.7142857142857,8.48085121651287,32.80505085947836,"(37.5, 52.0]",Q3
36029,2020-04-15,919719,43,99,1850,394,7672,69.71428571428571,292.57142857142856,7.5799549334400735,31.81095840919113,"(37.5, 52.0]",Q3
36029,2020-04-16,919719,43,79,1929,348,8020,74.28571428571429,298.14285714285717,8.077001158583686,32.41673349608491,"(37.5, 52.0]",Q3
36029,2020-04-17,919719,43,68,1997,262,8282,75.0,293.14285714285717,8.154664631262374,31.873089187334084,"(37.5, 52.0]",Q3
36029,2020-04-18,919719,43,73,2070,367,8649,71.28571428571429,300.2857142857143,7.750814573333192,32.649723914120976,"(37.5, 52.0]",Q3
36029,2020-04-19,919719,43,39,2109,199,8848,69.28571428571429,302.7142857142857,7.5333568498328605,32.91377972122852,"(37.5, 52.0]",Q3
36029,2020-04-20,919719,43,38,2147,258,9106,68.42857142857143,307.7142857142857,7.440160682618433,33.45742402997934,"(37.5, 52.0]",Q3
36029,2020-04-21,919719,43,86,2233,347,9453,68.85714285714286,310.7142857142857,7.486758766225647,33.78361061522984,"(37.5, 52.0]",Q3
36029,2020-04-22,919719,43,217,2450,1307,10760,85.71428571428571,441.14285714285717,9.319616721442713,47.964960726358505,"(37.5, 52.0]",Q3
36029,2020-04-23,919719,43,153,2603,982,11742,96.28571428571429,531.7142857142857,10.469036117087317,57.8126890620163,"(37.5, 52.0]",Q3
36029,2020-04-24,919719,43,170,2773,872,12614,110.85714285714286,618.8571428571429,12.053370959732577,67.2876327288164,"(37.5, 52.0]",Q3
36029,2020-04-25,919719,43,181,2954,795,13409,126.28571428571429,680.0,13.730901969592267,73.9356259901122,"(37.5, 52.0]",Q3
36029,2020-04-26,919719,43,67,3021,508,13917,130.28571428571428,724.1428571428571,14.165817416592926,78.73522860165518,"(37.5, 52.0]",Q3
36029,2020-04-27,919719,43,68,3089,586,14503,134.57142857142858,771.0,14.631798252665062,83.82995240937721,"(37.5, 52.0]",Q3
36029,2020-04-28,919719,43,107,3196,716,15219,137.57142857142858,823.7142857142857,14.957984837915559,89.56151669306448,"(37.5, 52.0]",Q3
36029,2020-04-29,919719,43,123,3319,885,16104,124.14285714285714,763.4285714285714,13.497911551556195,83.00671959898311,"(37.5, 52.0]",Q3
36029,2020-04-30,919719,43,162,3481,905,17009,125.42857142857143,752.4285714285714,13.637705802377837,81.81070211973129,"(37.5, 52.0]",Q3
36029,2020-05-01,919719,43,117,3598,1058,18067,117.85714285714286,779.0,12.814472991983731,84.69978330337854,"(37.5, 52.0]",Q3
36029,2020-05-02,919719,43,112,3710,799,18866,108.0,779.5714285714286,11.74271706901782,84.76191408152148,"(37.5, 52.0]",Q3
36029,2020-05-03,919719,43,92,3802,760,19626,111.57142857142857,815.5714285714286,12.131034432411266,88.67615310452742,"(37.5, 52.0]",Q3
36029,2020-05-04,919719,43,89,3891,779,20405,114.57142857142857,843.1428571428571,12.45722101766176,91.67396314992483,"(37.5, 52.0]",Q3
36029,2020-05-05,919719,43,117,4008,1498,21903,116.0,954.8571428571429,12.61254796301914,103.82053027687185,"(37.5, 52.0]",Q3
36029,2020-05-06,919719,43,128,4136,1164,23067,116.71428571428571,994.7142857142857,12.690211435697828,108.1541520523427,"(37.5, 52.0]",Q3
36029,2020-05-07,919719,43,119,4255,1008,24075,110.57142857142857,1009.4285714285714,12.022305570661102,109.75401958952371,"(37.5, 52.0]",Q3
36029,2020-05-08,919719,43,82,4337,1049,25124,105.57142857142857,1008.1428571428571,11.478661261910275,109.61422533870206,"(37.5, 52.0]",Q3
36029,2020-05-09,919719,43,116,4453,1231,26355,106.14285714285714,1069.857142857143,11.540792040053226,116.32434937814081,"(37.5, 52.0]",Q3
36029,2020-05-10,919719,43,30,4483,386,26741,97.28571428571429,1016.4285714285714,10.57776497883748,110.51512162177485,"(37.5, 52.0]",Q3
36029,2020-05-11,919719,43,47,4530,696,27437,91.28571428571429,1004.5714285714286,9.92539180833649,109.2259079753086,"(37.5, 52.0]",Q3
36029,2020-05-12,919719,43,76,4606,1591,29028,85.42857142857143,1017.8571428571429,9.288551332371238,110.67044856713224,"(37.5, 52.0]",Q3
36029,2020-05-13,919719,43,65,4671,1664,30692,76.42857142857143,1089.2857142857142,8.309991576619753,118.43679583500115,"(37.5, 52.0]",Q3
36029,2020-05-14,919719,43,111,4782,1690,32382,75.28571428571429,1186.7142857142858,8.18573002033385,129.0300935083744,"(37.5, 52.0]",Q3
36029,2020-05-15,919719,43,85,4867,1164,33546,75.71428571428571,1203.142857142857,8.232328103941063,130.8163533799842,"(37.5, 52.0]",Q3
36029,2020-05-16,919719,43,87,4954,1827,35373,71.57142857142857,1288.2857142857142,7.781879962404665,140.07383932328398,"(37.5, 52.0]",Q3
36029,2020-05-17,919719,43,39,4993,628,36001,72.85714285714286,1322.857142857143,7.921674213226307,143.83275140093255,"(37.5, 52.0]",Q3
36029,2020-05-18,919719,43,44,5037,934,36935,72.42857142857143,1356.857142857143,7.875076129619094,147.52953270043815,"(37.5, 52.0]",Q3
36029,2020-05-19,919719,43,94,5131,2198,39133,75.0,1443.5714285714287,8.154664631262374,156.95787828363106,"(37.5, 52.0]",Q3
36029,2020-05-20,919719,43,139,5270,2974,42107,85.57142857142857,1630.7142857142858,9.304084026906976,177.30570812544764,"(37.5, 52.0]",Q3
36029,2020-05-21,919719,43,127,5397,2175,44282,87.85714285714286,1700.0,9.552607139478782,184.83906497528048,"(37.5, 52.0]",Q3
36029,2020-05-22,919719,43,155,5552,2767,47049,97.85714285714286,1929.0,10.639895756980433,209.73797431606826,"(37.5, 52.0]",Q3
36029,2020-05-23,919719,43,74,5626,1742,48791,96.0,1916.857142857143,10.43797072801584,208.41769528053055,"(37.5, 52.0]",Q3
36029,2020-05-24,919719,43,74,5700,1718,50509,101.0,2072.5714285714284,10.981615036766664,225.3483323244848,"(37.5, 52.0]",Q3
36029,2020-05-25,919719,43,53,5753,1334,51843,102.28571428571429,2129.714285714286,11.121409287588307,231.56141013877996,"(37.5, 52.0]",Q3
36029,2020-05-26,919719,43,57,5810,1572,53415,97.0,2040.2857142857142,10.546699589766005,221.83794335940806,"(37.5, 52.0]",Q3
36029,2020-05-27,919719,43,76,5886,2367,55782,88.0,1953.5714285714287,9.56813983401452,212.4095977762152,"(37.5, 52.0]",Q3
36029,2020-05-28,919719,43,49,5935,1944,57726,76.85714285714286,1920.5714285714287,8.356589660226968,208.82154533845977,"(37.5, 52.0]",Q3
36029,2020-05-29,919719,43,79,6014,2434,60160,66.0,1873.0,7.17610487551089,203.64915805805902,"(37.5, 52.0]",Q3
36029,2020-05-30,919719,43,56,6070,2402,62562,63.42857142857143,1967.2857142857142,6.896516373867609,213.900736451646,"(37.5, 52.0]",Q3
36029,2020-05-31,919719,43,53,6123,1951,64513,60.42857142857143,2000.5714285714287,6.570329788617114,217.51985427847296,"(37.5, 52.0]",Q3
36029,2020-06-01,919719,43,50,6173,2225,66738,60.0,2127.8571428571427,6.5237317050099,231.35948510981538,"(37.5, 52.0]",Q3
36029,2020-06-02,919719,43,61,6234,3364,70102,60.57142857142857,2383.8571428571427,6.585862483152851,259.1940737178576,"(37.5, 52.0]",Q3
36029,2020-06-03,919719,43,74,6308,2639,72741,60.285714285714285,2422.714285714286,6.554797094081375,263.4189666315783,"(37.5, 52.0]",Q3
36029,2020-06-04,919719,43,51,6359,2896,75637,60.57142857142857,2558.714285714286,6.585862483152851,278.2060918296008,"(37.5, 52.0]",Q3
36029,2020-06-05,919719,43,70,6429,4101,79738,59.285714285714285,2796.8571428571427,6.44606823233121,304.0990936206757,"(37.5, 52.0]",Q3
36029,2020-06-06,919719,43,57,6486,2102,81840,59.42857142857143,2754.0,6.461600926866948,299.43928525995443,"(37.5, 52.0]",Q3
36029,2020-06-07,919719,43,45,6531,1670,83510,58.285714285714285,2713.8571428571427,6.337339370581046,295.07459809541206,"(37.5, 52.0]",Q3
36031,2020-03-02,37300,23,0,0,0,0,0.0,0.0,0.0,0.0,"(3.999, 24.0]",Q1
36031,2020-03-03,37300,23,0,0,0,0,0.0,0.0,0.0,0.0,"(3.999, 24.0]",Q1
36031,2020-03-04,37300,23,0,0,0,0,0.0,0.0,0.0,0.0,"(3.999, 24.0]",Q1
36031,2020-03-05,37300,23,0,0,0,0,0.0,0.0,0.0,0.0,"(3.999, 24.0]",Q1
36031,2020-03-06,37300,23,0,0,0,0,0.0,0.0,0.0,0.0,"(3.999, 24.0]",Q1
36031,2020-03-07,37300,23,0,0,0,0,0.0,0.0,0.0,0.0,"(3.999, 24.0]",Q1
36031,2020-03-08,37300,23,0,0,0,0,0.0,0.0,0.0,0.0,"(3.999, 24.0]",Q1
36031,2020-03-09,37300,23,0,0,0,0,0.0,0.0,0.0,0.0,"(3.999, 24.0]",Q1
36031,2020-03-10,37300,23,0,0,0,0,0.0,0.0,0.0,0.0,"(3.999, 24.0]",Q1
36031,2020-03-11,37300,23,0,0,0,0,0.0,0.0,0.0,0.0,"(3.999, 24.0]",Q1
36031,2020-03-12,37300,23,0,0,0,0,0.0,0.0,0.0,0.0,"(3.999, 24.0]",Q1
36031,2020-03-13,37300,23,0,0,2,2,0.0,0.2857142857142857,0.0,0.7659900421294522,"(3.999, 24.0]",Q1
36031,2020-03-14,37300,23,0,0,1,3,0.0,0.42857142857142855,0.0,1.1489850631941785,"(3.999, 24.0]",Q1
36031,2020-03-15,37300,23,0,0,2,5,0.0,0.7142857142857143,0.0,1.9149751053236308,"(3.999, 24.0]",Q1
36031,2020-03-16,37300,23,0,0,0,5,0.0,0.7142857142857143,0.0,1.9149751053236308,"(3.999, 24.0]",Q1
36031,2020-03-17,37300,23,1,1,2,7,0.14285714285714285,1.0,0.3829950210647261,2.680965147453083,"(3.999, 24.0]",Q1
36031,2020-03-18,37300,23,0,1,1,8,0.14285714285714285,1.1428571428571428,0.3829950210647261,3.063960168517809,"(3.999, 24.0]",Q1
36031,2020-03-19,37300,23,0,1,10,18,0.14285714285714285,2.5714285714285716,0.3829950210647261,6.893910379165072,"(3.999, 24.0]",Q1
36031,2020-03-20,37300,23,1,2,5,23,0.2857142857142857,3.0,0.7659900421294522,8.04289544235925,"(3.999, 24.0]",Q1
36031,2020-03-21,37300,23,1,3,8,31,0.42857142857142855,4.0,1.1489850631941785,10.723860589812332,"(3.999, 24.0]",Q1
36031,2020-03-22,37300,23,0,3,2,33,0.42857142857142855,4.0,1.1489850631941785,10.723860589812332,"(3.999, 24.0]",Q1
36031,2020-03-23,37300,23,0,3,11,44,0.42857142857142855,5.571428571428571,1.1489850631941785,14.936805821524318,"(3.999, 24.0]",Q1
36031,2020-03-24,37300,23,1,4,6,50,0.42857142857142855,6.142857142857143,1.1489850631941785,16.468785905783225,"(3.999, 24.0]",Q1
36031,2020-03-25,37300,23,0,4,7,57,0.42857142857142855,7.0,1.1489850631941785,18.766756032171582,"(3.999, 24.0]",Q1
36031,2020-03-26,37300,23,0,4,6,63,0.42857142857142855,6.428571428571429,1.1489850631941785,17.234775947912677,"(3.999, 24.0]",Q1
36031,2020-03-27,37300,23,0,4,5,68,0.2857142857142857,6.428571428571429,0.7659900421294522,17.234775947912677,"(3.999, 24.0]",Q1
36031,2020-03-28,37300,23,0,4,3,71,0.14285714285714285,5.714285714285714,0.3829950210647261,15.319800842589046,"(3.999, 24.0]",Q1
36031,2020-03-29,37300,23,0,4,3,74,0.14285714285714285,5.857142857142857,0.3829950210647261,15.70279586365377,"(3.999, 24.0]",Q1
36031,2020-03-30,37300,23,0,4,5,79,0.14285714285714285,5.0,0.3829950210647261,13.404825737265417,"(3.999, 24.0]",Q1
36031,2020-03-31,37300,23,2,6,8,87,0.2857142857142857,5.285714285714286,0.7659900421294522,14.170815779394866,"(3.999, 24.0]",Q1
36031,2020-04-01,37300,23,0,6,2,89,0.2857142857142857,4.571428571428571,0.7659900421294522,12.255840674071235,"(3.999, 24.0]",Q1
36031,2020-04-02,37300,23,0,6,2,91,0.2857142857142857,4.0,0.7659900421294522,10.723860589812332,"(3.999, 24.0]",Q1
36031,2020-04-03,37300,23,1,7,7,98,0.42857142857142855,4.285714285714286,1.1489850631941785,11.489850631941785,"(3.999, 24.0]",Q1
36031,2020-04-04,37300,23,0,7,4,102,0.42857142857142855,4.428571428571429,1.1489850631941785,11.872845653006511,"(3.999, 24.0]",Q1
36031,2020-04-05,37300,23,0,7,4,106,0.42857142857142855,4.571428571428571,1.1489850631941785,12.255840674071235,"(3.999, 24.0]",Q1
36031,2020-04-06,37300,23,0,7,5,111,0.42857142857142855,4.571428571428571,1.1489850631941785,12.255840674071235,"(3.999, 24.0]",Q1
36031,2020-04-07,37300,23,0,7,4,115,0.14285714285714285,4.0,0.3829950210647261,10.723860589812332,"(3.999, 24.0]",Q1
36031,2020-04-08,37300,23,1,8,6,121,0.2857142857142857,4.571428571428571,0.7659900421294522,12.255840674071235,"(3.999, 24.0]",Q1
36031,2020-04-09,37300,23,2,10,13,134,0.5714285714285714,6.142857142857143,1.5319800842589044,16.468785905783225,"(3.999, 24.0]",Q1
36031,2020-04-10,37300,23,2,12,4,138,0.7142857142857143,5.714285714285714,1.9149751053236308,15.319800842589046,"(3.999, 24.0]",Q1
36031,2020-04-11,37300,23,0,12,12,150,0.7142857142857143,6.857142857142857,1.9149751053236308,18.383761011106856,"(3.999, 24.0]",Q1
36031,2020-04-12,37300,23,0,12,5,155,0.7142857142857143,7.0,1.9149751053236308,18.766756032171582,"(3.999, 24.0]",Q1
36031,2020-04-13,37300,23,0,12,24,179,0.7142857142857143,9.714285714285714,1.9149751053236308,26.043661432401375,"(3.999, 24.0]",Q1
36031,2020-04-14,37300,23,0,12,3,182,0.7142857142857143,9.571428571428571,1.9149751053236308,25.66066641133665,"(3.999, 24.0]",Q1
36031,2020-04-15,37300,23,0,12,8,190,0.5714285714285714,9.857142857142858,1.5319800842589044,26.42665645346611,"(3.999, 24.0]",Q1
36031,2020-04-16,37300,23,3,15,6,196,0.7142857142857143,8.857142857142858,1.9149751053236308,23.745691306013022,"(3.999, 24.0]",Q1
36031,2020-04-17,37300,23,1,16,5,201,0.5714285714285714,9.0,1.5319800842589044,24.128686327077748,"(3.999, 24.0]",Q1
36031,2020-04-18,37300,23,2,18,10,211,0.8571428571428571,8.714285714285714,2.297970126388357,23.362696284948296,"(3.999, 24.0]",Q1
36031,2020-04-19,37300,23,2,20,4,215,1.1428571428571428,8.571428571428571,3.063960168517809,22.97970126388357,"(3.999, 24.0]",Q1
36031,2020-04-20,37300,23,1,21,5,220,1.2857142857142858,5.857142857142857,3.446955189582536,15.70279586365377,"(3.999, 24.0]",Q1
36031,2020-04-21,37300,23,1,22,2,222,1.4285714285714286,5.714285714285714,3.8299502106472616,15.319800842589046,"(3.999, 24.0]",Q1
36031,2020-04-22,37300,23,0,22,1,223,1.4285714285714286,4.714285714285714,3.8299502106472616,12.638835695135965,"(3.999, 24.0]",Q1
36031,2020-04-23,37300,23,0,22,6,229,1.0,4.714285714285714,2.680965147453083,12.638835695135965,"(3.999, 24.0]",Q1
36031,2020-04-24,37300,23,2,24,35,264,1.1428571428571428,9.0,3.063960168517809,24.128686327077748,"(3.999, 24.0]",Q1
36031,2020-04-25,37300,23,0,24,15,279,0.8571428571428571,9.714285714285714,2.297970126388357,26.043661432401375,"(3.999, 24.0]",Q1
36031,2020-04-26,37300,23,0,24,27,306,0.5714285714285714,13.0,1.5319800842589044,34.852546916890084,"(3.999, 24.0]",Q1
36031,2020-04-27,37300,23,2,26,16,322,0.7142857142857143,14.571428571428571,1.9149751053236308,39.06549214860207,"(3.999, 24.0]",Q1
36031,2020-04-28,37300,23,1,27,19,341,0.7142857142857143,17.0,1.9149751053236308,45.57640750670242,"(3.999, 24.0]",Q1
36031,2020-04-29,37300,23,1,28,22,363,0.8571428571428571,20.0,2.297970126388357,53.61930294906167,"(3.999, 24.0]",Q1
36031,2020-04-30,37300,23,0,28,27,390,0.8571428571428571,23.0,2.297970126388357,61.662198391420915,"(3.999, 24.0]",Q1
36031,2020-05-01,37300,23,0,28,31,421,0.5714285714285714,22.428571428571427,1.5319800842589044,60.130218307162,"(3.999, 24.0]",Q1
36031,2020-05-02,37300,23,1,29,23,444,0.7142857142857143,23.571428571428573,1.9149751053236308,63.19417847567982,"(3.999, 24.0]",Q1
36031,2020-05-03,37300,23,0,29,10,454,0.7142857142857143,21.142857142857142,1.9149751053236308,56.683263117579465,"(3.999, 24.0]",Q1
36031,2020-05-04,37300,23,1,30,26,480,0.5714285714285714,22.571428571428573,1.5319800842589044,60.51321332822673,"(3.999, 24.0]",Q1
36031,2020-05-05,37300,23,0,30,18,498,0.42857142857142855,22.428571428571427,1.1489850631941785,60.130218307162,"(3.999, 24.0]",Q1
36031,2020-05-06,37300,23,0,30,15,513,0.2857142857142857,21.428571428571427,0.7659900421294522,57.44925315970892,"(3.999, 24.0]",Q1
36031,2020-05-07,37300,23,1,31,69,582,0.42857142857142855,27.428571428571427,1.1489850631941785,73.53504404442742,"(3.999, 24.0]",Q1
36031,2020-05-08,37300,23,0,31,64,646,0.42857142857142855,32.142857142857146,1.1489850631941785,86.17387973956339,"(3.999, 24.0]",Q1
36031,2020-05-09,37300,23,1,32,111,757,0.42857142857142855,44.714285714285715,1.1489850631941785,119.87744159325929,"(3.999, 24.0]",Q1
36031,2020-05-10,37300,23,0,32,31,788,0.42857142857142855,47.714285714285715,1.1489850631941785,127.92033703561854,"(3.999, 24.0]",Q1
36031,2020-05-11,37300,23,0,32,12,800,0.2857142857142857,45.714285714285715,0.7659900421294522,122.55840674071237,"(3.999, 24.0]",Q1
36031,2020-05-12,37300,23,0,32,77,877,0.2857142857142857,54.142857142857146,0.7659900421294522,145.1551129835312,"(3.999, 24.0]",Q1
36031,2020-05-13,37300,23,0,32,60,937,0.2857142857142857,60.57142857142857,0.7659900421294522,162.3898889314439,"(3.999, 24.0]",Q1
36031,2020-05-14,37300,23,0,32,34,971,0.14285714285714285,55.57142857142857,0.3829950210647261,148.98506319417848,"(3.999, 24.0]",Q1
36031,2020-05-15,37300,23,0,32,173,1144,0.14285714285714285,71.14285714285714,0.3829950210647261,190.7315204902336,"(3.999, 24.0]",Q1
36031,2020-05-16,37300,23,1,33,146,1290,0.14285714285714285,76.14285714285714,0.3829950210647261,204.13634622749905,"(3.999, 24.0]",Q1
36031,2020-05-17,37300,23,0,33,161,1451,0.14285714285714285,94.71428571428571,0.3829950210647261,253.92569896591343,"(3.999, 24.0]",Q1
36031,2020-05-18,37300,23,1,34,16,1467,0.2857142857142857,95.28571428571429,0.7659900421294522,255.45767905017237,"(3.999, 24.0]",Q1
36031,2020-05-19,37300,23,0,34,43,1510,0.2857142857142857,90.42857142857143,0.7659900421294522,242.43584833397165,"(3.999, 24.0]",Q1
36031,2020-05-20,37300,23,2,36,162,1672,0.5714285714285714,105.0,1.5319800842589044,281.5013404825737,"(3.999, 24.0]",Q1
36031,2020-05-21,37300,23,0,36,115,1787,0.5714285714285714,116.57142857142857,1.5319800842589044,312.52393718881655,"(3.999, 24.0]",Q1
36031,2020-05-22,37300,23,0,36,89,1876,0.5714285714285714,104.57142857142857,1.5319800842589044,280.35235541937953,"(3.999, 24.0]",Q1
36031,2020-05-23,37300,23,0,36,182,2058,0.42857142857142855,109.71428571428571,1.1489850631941785,294.1401761777097,"(3.999, 24.0]",Q1
36031,2020-05-24,37300,23,0,36,88,2146,0.42857142857142855,99.28571428571429,1.1489850631941785,266.1815396399847,"(3.999, 24.0]",Q1
36031,2020-05-25,37300,23,0,36,68,2214,0.2857142857142857,106.71428571428571,0.7659900421294522,286.0972807353504,"(3.999, 24.0]",Q1
36031,2020-05-26,37300,23,0,36,71,2285,0.2857142857142857,110.71428571428571,0.7659900421294522,296.8211413251627,"(3.999, 24.0]",Q1
36031,2020-05-27,37300,23,0,36,85,2370,0.0,99.71428571428571,0.0,267.33052470317887,"(3.999, 24.0]",Q1
36031,2020-05-28,37300,23,0,36,151,2521,0.0,104.85714285714286,0.0,281.118345461509,"(3.999, 24.0]",Q1
36031,2020-05-29,37300,23,0,36,95,2616,0.0,105.71428571428571,0.0,283.4163155878974,"(3.999, 24.0]",Q1
36031,2020-05-30,37300,23,1,37,258,2874,0.14285714285714285,116.57142857142857,0.3829950210647261,312.52393718881655,"(3.999, 24.0]",Q1
36031,2020-05-31,37300,23,0,37,144,3018,0.14285714285714285,124.57142857142857,0.3829950210647261,333.9716583684412,"(3.999, 24.0]",Q1
36031,2020-06-01,37300,23,1,38,64,3082,0.2857142857142857,124.0,0.7659900421294522,332.43967828418226,"(3.999, 24.0]",Q1
36031,2020-06-02,37300,23,0,38,109,3191,0.2857142857142857,129.42857142857142,0.7659900421294522,346.9934890846419,"(3.999, 24.0]",Q1
36031,2020-06-03,37300,23,0,38,193,3384,0.2857142857142857,144.85714285714286,0.7659900421294522,388.3569513596323,"(3.999, 24.0]",Q1
36031,2020-06-04,37300,23,0,38,106,3490,0.2857142857142857,138.42857142857142,0.7659900421294522,371.1221754117196,"(3.999, 24.0]",Q1
36031,2020-06-05,37300,23,0,38,96,3586,0.2857142857142857,138.57142857142858,0.7659900421294522,371.5051704327844,"(3.999, 24.0]",Q1
36031,2020-06-06,37300,23,0,38,178,3764,0.14285714285714285,127.14285714285714,0.3829950210647261,340.8655687476063,"(3.999, 24.0]",Q1
36031,2020-06-07,37300,23,1,39,160,3924,0.2857142857142857,129.42857142857142,0.7659900421294522,346.9934890846419,"(3.999, 24.0]",Q1
36033,2020-03-02,50293,68,0,0,0,0,0.0,0.0,0.0,0.0,"(52.0, 100.0]",Q4
36033,2020-03-03,50293,68,0,0,0,0,0.0,0.0,0.0,0.0,"(52.0, 100.0]",Q4
36033,2020-03-04,50293,68,0,0,0,0,0.0,0.0,0.0,0.0,"(52.0, 100.0]",Q4
36033,2020-03-05,50293,68,0,0,0,0,0.0,0.0,0.0,0.0,"(52.0, 100.0]",Q4
36033,2020-03-06,50293,68,0,0,0,0,0.0,0.0,0.0,0.0,"(52.0, 100.0]",Q4
36033,2020-03-07,50293,68,0,0,0,0,0.0,0.0,0.0,0.0,"(52.0, 100.0]",Q4
36033,2020-03-08,50293,68,0,0,0,0,0.0,0.0,0.0,0.0,"(52.0, 100.0]",Q4
36033,2020-03-09,50293,68,0,0,0,0,0.0,0.0,0.0,0.0,"(52.0, 100.0]",Q4
36033,2020-03-10,50293,68,0,0,0,0,0.0,0.0,0.0,0.0,"(52.0, 100.0]",Q4
36033,2020-03-11,50293,68,0,0,0,0,0.0,0.0,0.0,0.0,"(52.0, 100.0]",Q4
36033,2020-03-12,50293,68,0,0,1,1,0.0,0.14285714285714285,0.0,0.2840497541549378,"(52.0, 100.0]",Q4
36033,2020-03-13,50293,68,0,0,0,1,0.0,0.14285714285714285,0.0,0.2840497541549378,"(52.0, 100.0]",Q4
36033,2020-03-14,50293,68,0,0,1,2,0.0,0.2857142857142857,0.0,0.5680995083098755,"(52.0, 100.0]",Q4
36033,2020-03-15,50293,68,0,0,0,2,0.0,0.2857142857142857,0.0,0.5680995083098755,"(52.0, 100.0]",Q4
36033,2020-03-16,50293,68,0,0,3,5,0.0,0.7142857142857143,0.0,1.420248770774689,"(52.0, 100.0]",Q4
36033,2020-03-17,50293,68,0,0,1,6,0.0,0.8571428571428571,0.0,1.7042985249296265,"(52.0, 100.0]",Q4
36033,2020-03-18,50293,68,0,0,5,11,0.0,1.5714285714285714,0.0,3.1245472957043154,"(52.0, 100.0]",Q4
36033,2020-03-19,50293,68,0,0,6,17,0.0,2.2857142857142856,0.0,4.544796066479004,"(52.0, 100.0]",Q4
36033,2020-03-20,50293,68,0,0,5,22,0.0,3.0,0.0,5.965044837253694,"(52.0, 100.0]",Q4
36033,2020-03-21,50293,68,0,0,10,32,0.0,4.285714285714286,0.0,8.521492624648133,"(52.0, 100.0]",Q4
36033,2020-03-22,50293,68,0,0,8,40,0.0,5.428571428571429,0.0,10.793890657887637,"(52.0, 100.0]",Q4
36033,2020-03-23,50293,68,0,0,3,43,0.0,5.428571428571429,0.0,10.793890657887637,"(52.0, 100.0]",Q4
36033,2020-03-24,50293,68,1,1,4,47,0.14285714285714285,5.857142857142857,0.2840497541549378,11.646039920352449,"(52.0, 100.0]",Q4
36033,2020-03-25,50293,68,0,1,5,52,0.14285714285714285,5.857142857142857,0.2840497541549378,11.646039920352449,"(52.0, 100.0]",Q4
36033,2020-03-26,50293,68,1,2,11,63,0.2857142857142857,6.571428571428571,0.5680995083098755,13.066288691127138,"(52.0, 100.0]",Q4
36033,2020-03-27,50293,68,2,4,10,73,0.5714285714285714,7.285714285714286,1.136199016619751,14.486537461901827,"(52.0, 100.0]",Q4
36033,2020-03-28,50293,68,2,6,9,82,0.8571428571428571,7.142857142857143,1.7042985249296265,14.20248770774689,"(52.0, 100.0]",Q4
36033,2020-03-29,50293,68,0,6,14,96,0.8571428571428571,8.0,1.7042985249296265,15.906786232676515,"(52.0, 100.0]",Q4
36033,2020-03-30,50293,68,3,9,10,106,1.2857142857142858,9.0,2.5564477873944402,17.89513451176108,"(52.0, 100.0]",Q4
36033,2020-03-31,50293,68,0,9,9,115,1.1428571428571428,9.714285714285714,2.272398033239502,19.315383282535766,"(52.0, 100.0]",Q4
36033,2020-04-01,50293,68,0,9,8,123,1.1428571428571428,10.142857142857142,2.272398033239502,20.167532545000583,"(52.0, 100.0]",Q4
36033,2020-04-02,50293,68,1,10,19,142,1.1428571428571428,11.285714285714286,2.272398033239502,22.439930578240087,"(52.0, 100.0]",Q4
36033,2020-04-03,50293,68,0,10,4,146,0.8571428571428571,10.428571428571429,1.7042985249296265,20.735632053310457,"(52.0, 100.0]",Q4
36033,2020-04-04,50293,68,0,10,6,152,0.5714285714285714,10.0,1.136199016619751,19.883482790845644,"(52.0, 100.0]",Q4
36033,2020-04-05,50293,68,0,10,5,157,0.5714285714285714,8.714285714285714,1.136199016619751,17.327035003451204,"(52.0, 100.0]",Q4
36033,2020-04-06,50293,68,0,10,5,162,0.14285714285714285,8.0,0.2840497541549378,15.906786232676515,"(52.0, 100.0]",Q4
36033,2020-04-07,50293,68,0,10,7,169,0.14285714285714285,7.714285714285714,0.2840497541549378,15.33868672436664,"(52.0, 100.0]",Q4
36033,2020-04-08,50293,68,1,11,5,174,0.2857142857142857,7.285714285714286,0.5680995083098755,14.486537461901827,"(52.0, 100.0]",Q4
36033,2020-04-09,50293,68,0,11,6,180,0.14285714285714285,5.428571428571429,0.2840497541549378,10.793890657887637,"(52.0, 100.0]",Q4
36033,2020-04-10,50293,68,0,11,5,185,0.14285714285714285,5.571428571428571,0.2840497541549378,11.077940412042572,"(52.0, 100.0]",Q4
36033,2020-04-11,50293,68,1,12,8,193,0.2857142857142857,5.857142857142857,0.5680995083098755,11.646039920352449,"(52.0, 100.0]",Q4
36033,2020-04-12,50293,68,0,12,6,199,0.2857142857142857,6.0,0.5680995083098755,11.930089674507387,"(52.0, 100.0]",Q4
36033,2020-04-13,50293,68,1,13,13,212,0.42857142857142855,7.142857142857143,0.8521492624648133,14.20248770774689,"(52.0, 100.0]",Q4
36033,2020-04-14,50293,68,0,13,4,216,0.42857142857142855,6.714285714285714,0.8521492624648133,13.350338445282075,"(52.0, 100.0]",Q4
36033,2020-04-15,50293,68,0,13,11,227,0.2857142857142857,7.571428571428571,0.5680995083098755,15.054636970211703,"(52.0, 100.0]",Q4
36033,2020-04-16,50293,68,0,13,3,230,0.2857142857142857,7.142857142857143,0.5680995083098755,14.20248770774689,"(52.0, 100.0]",Q4
36033,2020-04-17,50293,68,0,13,9,239,0.2857142857142857,7.714285714285714,0.5680995083098755,15.33868672436664,"(52.0, 100.0]",Q4
36033,2020-04-18,50293,68,0,13,9,248,0.14285714285714285,7.857142857142857,0.2840497541549378,15.622736478521578,"(52.0, 100.0]",Q4
36033,2020-04-19,50293,68,0,13,5,253,0.14285714285714285,7.714285714285714,0.2840497541549378,15.33868672436664,"(52.0, 100.0]",Q4
36033,2020-04-20,50293,68,0,13,3,256,0.0,6.285714285714286,0.0,12.498189182817262,"(52.0, 100.0]",Q4
36033,2020-04-21,50293,68,0,13,2,258,0.0,6.0,0.0,11.930089674507387,"(52.0, 100.0]",Q4
36033,2020-04-22,50293,68,0,13,8,266,0.0,5.571428571428571,0.0,11.077940412042572,"(52.0, 100.0]",Q4
36033,2020-04-23,50293,68,0,13,9,275,0.0,6.428571428571429,0.0,12.782238936972199,"(52.0, 100.0]",Q4
36033,2020-04-24,50293,68,1,14,35,310,0.14285714285714285,10.142857142857142,0.2840497541549378,20.167532545000583,"(52.0, 100.0]",Q4
36033,2020-04-25,50293,68,0,14,3,313,0.14285714285714285,9.285714285714286,0.2840497541549378,18.463234020070956,"(52.0, 100.0]",Q4
36033,2020-04-26,50293,68,0,14,17,330,0.14285714285714285,11.0,0.2840497541549378,21.87183106993021,"(52.0, 100.0]",Q4
36033,2020-04-27,50293,68,0,14,13,343,0.14285714285714285,12.428571428571429,0.2840497541549378,24.712328611479588,"(52.0, 100.0]",Q4
36033,2020-04-28,50293,68,1,15,17,360,0.2857142857142857,14.571428571428571,0.5680995083098755,28.973074923803654,"(52.0, 100.0]",Q4
36033,2020-04-29,50293,68,0,15,14,374,0.2857142857142857,15.428571428571429,0.5680995083098755,30.67737344873328,"(52.0, 100.0]",Q4
36033,2020-04-30,50293,68,0,15,16,390,0.2857142857142857,16.428571428571427,0.5680995083098755,32.66572172781784,"(52.0, 100.0]",Q4
36033,2020-05-01,50293,68,0,15,9,399,0.14285714285714285,12.714285714285714,0.2840497541549378,25.28042811978946,"(52.0, 100.0]",Q4
36033,2020-05-02,50293,68,0,15,9,408,0.14285714285714285,13.571428571428571,0.2840497541549378,26.98472664471909,"(52.0, 100.0]",Q4
36033,2020-05-03,50293,68,1,16,15,423,0.2857142857142857,13.285714285714286,0.5680995083098755,26.416627136409215,"(52.0, 100.0]",Q4
36033,2020-05-04,50293,68,0,16,11,434,0.2857142857142857,13.0,0.5680995083098755,25.84852762809934,"(52.0, 100.0]",Q4
36033,2020-05-05,50293,68,0,16,15,449,0.14285714285714285,12.714285714285714,0.2840497541549378,25.28042811978946,"(52.0, 100.0]",Q4
36033,2020-05-06,50293,68,0,16,18,467,0.14285714285714285,13.285714285714286,0.2840497541549378,26.416627136409215,"(52.0, 100.0]",Q4
36033,2020-05-07,50293,68,1,17,82,549,0.2857142857142857,22.714285714285715,0.5680995083098755,45.16391091063511,"(52.0, 100.0]",Q4
36033,2020-05-08,50293,68,0,17,24,573,0.2857142857142857,24.857142857142858,0.5680995083098755,49.424657222959176,"(52.0, 100.0]",Q4
36033,2020-05-09,50293,68,0,17,50,623,0.2857142857142857,30.714285714285715,0.5680995083098755,61.07069714331163,"(52.0, 100.0]",Q4
36033,2020-05-10,50293,68,0,17,53,676,0.14285714285714285,36.142857142857146,0.2840497541549378,71.86458780119926,"(52.0, 100.0]",Q4
36033,2020-05-11,50293,68,0,17,91,767,0.14285714285714285,47.57142857142857,0.2840497541549378,94.58856813359428,"(52.0, 100.0]",Q4
36033,2020-05-12,50293,68,0,17,52,819,0.14285714285714285,52.857142857142854,0.2840497541549378,105.09840903732696,"(52.0, 100.0]",Q4
36033,2020-05-13,50293,68,0,17,56,875,0.14285714285714285,58.285714285714285,0.2840497541549378,115.89229969521462,"(52.0, 100.0]",Q4
36033,2020-05-14,50293,68,0,17,48,923,0.0,53.42857142857143,0.0,106.23460805394673,"(52.0, 100.0]",Q4
36033,2020-05-15,50293,68,1,18,196,1119,0.14285714285714285,78.0,0.2840497541549378,155.09116576859603,"(52.0, 100.0]",Q4
36033,2020-05-16,50293,68,0,18,126,1245,0.14285714285714285,88.85714285714286,0.2840497541549378,176.67894708437132,"(52.0, 100.0]",Q4
36033,2020-05-17,50293,68,0,18,285,1530,0.14285714285714285,122.0,0.2840497541549378,242.57849004831687,"(52.0, 100.0]",Q4
36033,2020-05-18,50293,68,0,18,9,1539,0.14285714285714285,110.28571428571429,0.2840497541549378,219.28641020761197,"(52.0, 100.0]",Q4
36033,2020-05-19,50293,68,0,18,55,1594,0.14285714285714285,110.71428571428571,0.2840497541549378,220.13855947007676,"(52.0, 100.0]",Q4
36033,2020-05-20,50293,68,1,19,245,1839,0.2857142857142857,137.71428571428572,0.5680995083098755,273.82396300536004,"(52.0, 100.0]",Q4
36033,2020-05-21,50293,68,0,19,194,2033,0.2857142857142857,158.57142857142858,0.5680995083098755,315.2952271119809,"(52.0, 100.0]",Q4
36033,2020-05-22,50293,68,1,20,83,2116,0.2857142857142857,142.42857142857142,0.5680995083098755,283.1976048924729,"(52.0, 100.0]",Q4
36033,2020-05-23,50293,68,0,20,178,2294,0.2857142857142857,149.85714285714286,0.5680995083098755,297.96819210852976,"(52.0, 100.0]",Q4
36033,2020-05-24,50293,68,0,20,138,2432,0.2857142857142857,128.85714285714286,0.5680995083098755,256.2128782477539,"(52.0, 100.0]",Q4
36033,2020-05-25,50293,68,0,20,219,2651,0.2857142857142857,158.85714285714286,0.5680995083098755,315.8633266202908,"(52.0, 100.0]",Q4
36033,2020-05-26,50293,68,0,20,84,2735,0.2857142857142857,163.0,0.5680995083098755,324.10076949078405,"(52.0, 100.0]",Q4
36033,2020-05-27,50293,68,0,20,157,2892,0.14285714285714285,150.42857142857142,0.2840497541549378,299.10439112514945,"(52.0, 100.0]",Q4
36033,2020-05-28,50293,68,1,21,118,3010,0.2857142857142857,139.57142857142858,0.5680995083098755,277.51660980937424,"(52.0, 100.0]",Q4
36033,2020-05-29,50293,68,1,22,129,3139,0.2857142857142857,146.14285714285714,0.5680995083098755,290.58289850050136,"(52.0, 100.0]",Q4
36033,2020-05-30,50293,68,0,22,151,3290,0.2857142857142857,142.28571428571428,0.5680995083098755,282.913555138318,"(52.0, 100.0]",Q4
36033,2020-05-31,50293,68,1,23,167,3457,0.42857142857142855,146.42857142857142,0.8521492624648133,291.1509980088112,"(52.0, 100.0]",Q4
36033,2020-06-01,50293,68,0,23,42,3499,0.42857142857142855,121.14285714285714,0.8521492624648133,240.87419152338725,"(52.0, 100.0]",Q4
36033,2020-06-02,50293,68,0,23,222,3721,0.42857142857142855,140.85714285714286,0.8521492624648133,280.07305759676865,"(52.0, 100.0]",Q4
36033,2020-06-03,50293,68,0,23,262,3983,0.42857142857142855,155.85714285714286,0.8521492624648133,309.89828178303713,"(52.0, 100.0]",Q4
36033,2020-06-04,50293,68,0,23,120,4103,0.2857142857142857,156.14285714285714,0.5680995083098755,310.466381291347,"(52.0, 100.0]",Q4
36033,2020-06-05,50293,68,0,23,207,4310,0.14285714285714285,167.28571428571428,0.2840497541549378,332.62226211543214,"(52.0, 100.0]",Q4
36033,2020-06-06,50293,68,0,23,198,4508,0.14285714285714285,174.0,0.2840497541549378,345.9726005607142,"(52.0, 100.0]",Q4
36033,2020-06-07,50293,68,0,23,272,4780,0.0,189.0,0.0,375.79782474698266,"(52.0, 100.0]",Q4
36035,2020-03-02,53591,54,0,0,0,0,0.0,0.0,0.0,0.0,"(52.0, 100.0]",Q4
36035,2020-03-03,53591,54,0,0,0,0,0.0,0.0,0.0,0.0,"(52.0, 100.0]",Q4
36035,2020-03-04,53591,54,0,0,0,0,0.0,0.0,0.0,0.0,"(52.0, 100.0]",Q4
36035,2020-03-05,53591,54,0,0,0,0,0.0,0.0,0.0,0.0,"(52.0, 100.0]",Q4
36035,2020-03-06,53591,54,0,0,0,0,0.0,0.0,0.0,0.0,"(52.0, 100.0]",Q4
36035,2020-03-07,53591,54,0,0,0,0,0.0,0.0,0.0,0.0,"(52.0, 100.0]",Q4
36035,2020-03-08,53591,54,0,0,0,0,0.0,0.0,0.0,0.0,"(52.0, 100.0]",Q4
36035,2020-03-09,53591,54,0,0,1,1,0.0,0.14285714285714285,0.0,0.2665692800230316,"(52.0, 100.0]",Q4
36035,2020-03-10,53591,54,0,0,1,2,0.0,0.2857142857142857,0.0,0.5331385600460632,"(52.0, 100.0]",Q4
36035,2020-03-11,53591,54,0,0,2,4,0.0,0.5714285714285714,0.0,1.0662771200921264,"(52.0, 100.0]",Q4
36035,2020-03-12,53591,54,0,0,1,5,0.0,0.7142857142857143,0.0,1.3328464001151579,"(52.0, 100.0]",Q4
36035,2020-03-13,53591,54,0,0,1,6,0.0,0.8571428571428571,0.0,1.5994156801381894,"(52.0, 100.0]",Q4
36035,2020-03-14,53591,54,0,0,4,10,0.0,1.4285714285714286,0.0,2.6656928002303157,"(52.0, 100.0]",Q4
36035,2020-03-15,53591,54,0,0,1,11,0.0,1.5714285714285714,0.0,2.9322620802533472,"(52.0, 100.0]",Q4
36035,2020-03-16,53591,54,0,0,1,12,0.0,1.5714285714285714,0.0,2.9322620802533472,"(52.0, 100.0]",Q4
36035,2020-03-17,53591,54,0,0,0,12,0.0,1.4285714285714286,0.0,2.6656928002303157,"(52.0, 100.0]",Q4
36035,2020-03-18,53591,54,1,1,12,24,0.14285714285714285,2.857142857142857,0.2665692800230316,5.3313856004606315,"(52.0, 100.0]",Q4
36035,2020-03-19,53591,54,0,1,6,30,0.14285714285714285,3.5714285714285716,0.2665692800230316,6.66423200057579,"(52.0, 100.0]",Q4
36035,2020-03-20,53591,54,0,1,13,43,0.14285714285714285,5.285714285714286,0.2665692800230316,9.863063360852168,"(52.0, 100.0]",Q4
36035,2020-03-21,53591,54,0,1,11,54,0.14285714285714285,6.285714285714286,0.2665692800230316,11.729048321013389,"(52.0, 100.0]",Q4
36035,2020-03-22,53591,54,0,1,11,65,0.14285714285714285,7.714285714285714,0.2665692800230316,14.394741121243705,"(52.0, 100.0]",Q4
36035,2020-03-23,53591,54,0,1,11,76,0.14285714285714285,9.142857142857142,0.2665692800230316,17.060433921474022,"(52.0, 100.0]",Q4
36035,2020-03-24,53591,54,0,1,4,80,0.14285714285714285,9.714285714285714,0.2665692800230316,18.126711041566146,"(52.0, 100.0]",Q4
36035,2020-03-25,53591,54,0,1,2,82,0.0,8.285714285714286,0.0,15.461018241335832,"(52.0, 100.0]",Q4
36035,2020-03-26,53591,54,0,1,5,87,0.0,8.142857142857142,0.0,15.1944489613128,"(52.0, 100.0]",Q4
36035,2020-03-27,53591,54,0,1,10,97,0.0,7.714285714285714,0.0,14.394741121243705,"(52.0, 100.0]",Q4
36035,2020-03-28,53591,54,0,1,10,107,0.0,7.571428571428571,0.0,14.128171841220672,"(52.0, 100.0]",Q4
36035,2020-03-29,53591,54,0,1,12,119,0.0,7.714285714285714,0.0,14.394741121243705,"(52.0, 100.0]",Q4
36035,2020-03-30,53591,54,0,1,5,124,0.0,6.857142857142857,0.0,12.795325441105515,"(52.0, 100.0]",Q4
36035,2020-03-31,53591,54,1,2,5,129,0.14285714285714285,7.0,0.2665692800230316,13.061894721128548,"(52.0, 100.0]",Q4
36035,2020-04-01,53591,54,4,6,10,139,0.7142857142857143,8.142857142857142,1.3328464001151579,15.1944489613128,"(52.0, 100.0]",Q4
36035,2020-04-02,53591,54,0,6,10,149,0.7142857142857143,8.857142857142858,1.3328464001151579,16.527295361427957,"(52.0, 100.0]",Q4
36035,2020-04-03,53591,54,3,9,24,173,1.1428571428571428,10.857142857142858,2.1325542401842528,20.2592652817504,"(52.0, 100.0]",Q4
36035,2020-04-04,53591,54,0,9,12,185,1.1428571428571428,11.142857142857142,2.1325542401842528,20.792403841796464,"(52.0, 100.0]",Q4
36035,2020-04-05,53591,54,2,11,20,205,1.4285714285714286,12.285714285714286,2.6656928002303157,22.92495808198072,"(52.0, 100.0]",Q4
36035,2020-04-06,53591,54,2,13,18,223,1.7142857142857142,14.142857142857142,3.1988313602763787,26.390358722280126,"(52.0, 100.0]",Q4
36035,2020-04-07,53591,54,1,14,6,229,1.7142857142857142,14.285714285714286,3.1988313602763787,26.65692800230316,"(52.0, 100.0]",Q4
36035,2020-04-08,53591,54,1,15,21,250,1.2857142857142858,15.857142857142858,2.3991235202072847,29.58919008255651,"(52.0, 100.0]",Q4
36035,2020-04-09,53591,54,3,18,24,274,1.7142857142857142,17.857142857142858,3.1988313602763787,33.32116000287895,"(52.0, 100.0]",Q4
36035,2020-04-10,53591,54,3,21,17,291,1.7142857142857142,16.857142857142858,3.1988313602763787,31.455175042717727,"(52.0, 100.0]",Q4
36035,2020-04-11,53591,54,0,21,11,302,1.7142857142857142,16.714285714285715,3.1988313602763787,31.1886057626947,"(52.0, 100.0]",Q4
36035,2020-04-12,53591,54,0,21,7,309,1.4285714285714286,14.857142857142858,2.6656928002303157,27.723205122395285,"(52.0, 100.0]",Q4
36035,2020-04-13,53591,54,1,22,75,384,1.2857142857142858,23.0,2.3991235202072847,42.917654083708086,"(52.0, 100.0]",Q4
36035,2020-04-14,53591,54,2,24,9,393,1.4285714285714286,23.428571428571427,2.6656928002303157,43.717361923777176,"(52.0, 100.0]",Q4
36035,2020-04-15,53591,54,1,25,13,406,1.4285714285714286,22.285714285714285,2.6656928002303157,41.58480768359293,"(52.0, 100.0]",Q4
36035,2020-04-16,53591,54,2,27,16,422,1.2857142857142858,21.142857142857142,2.3991235202072847,39.45225344340867,"(52.0, 100.0]",Q4
36035,2020-04-17,53591,54,0,27,7,429,0.8571428571428571,19.714285714285715,1.5994156801381894,36.78656064317836,"(52.0, 100.0]",Q4
36035,2020-04-18,53591,54,0,27,17,446,0.8571428571428571,20.571428571428573,1.5994156801381894,38.385976323316555,"(52.0, 100.0]",Q4
36035,2020-04-19,53591,54,0,27,3,449,0.8571428571428571,20.0,1.5994156801381894,37.319699203224424,"(52.0, 100.0]",Q4
36035,2020-04-20,53591,54,0,27,4,453,0.7142857142857143,9.857142857142858,1.3328464001151579,18.39328032158918,"(52.0, 100.0]",Q4
36035,2020-04-21,53591,54,1,28,7,460,0.5714285714285714,9.571428571428571,1.0662771200921264,17.860141761543115,"(52.0, 100.0]",Q4
36035,2020-04-22,53591,54,0,28,5,465,0.42857142857142855,8.428571428571429,0.7997078400690947,15.727587521358863,"(52.0, 100.0]",Q4
36035,2020-04-23,53591,54,1,29,16,481,0.2857142857142857,8.428571428571429,0.5331385600460632,15.727587521358863,"(52.0, 100.0]",Q4
36035,2020-04-24,53591,54,32,61,202,683,4.857142857142857,36.285714285714285,9.063355520783073,67.70859712585002,"(52.0, 100.0]",Q4
36035,2020-04-25,53591,54,1,62,29,712,5.0,38.0,9.329924800806106,70.9074284861264,"(52.0, 100.0]",Q4
36035,2020-04-26,53591,54,0,62,9,721,5.0,38.857142857142854,9.329924800806106,72.50684416626459,"(52.0, 100.0]",Q4
36035,2020-04-27,53591,54,4,66,16,737,5.571428571428571,40.57142857142857,10.396201920898232,75.70567552654097,"(52.0, 100.0]",Q4
36035,2020-04-28,53591,54,1,67,27,764,5.571428571428571,43.42857142857143,10.396201920898232,81.0370611270016,"(52.0, 100.0]",Q4
36035,2020-04-29,53591,54,4,71,27,791,6.142857142857143,46.57142857142857,11.46247904099036,86.9015852875083,"(52.0, 100.0]",Q4
36035,2020-04-30,53591,54,4,75,37,828,6.571428571428571,49.57142857142857,12.262186881059451,92.49954016799195,"(52.0, 100.0]",Q4
36035,2020-05-01,53591,54,4,79,34,862,2.5714285714285716,25.571428571428573,4.798247040414569,47.71590112412265,"(52.0, 100.0]",Q4
36035,2020-05-02,53591,54,3,82,36,898,2.857142857142857,26.571428571428573,5.3313856004606315,49.58188608428388,"(52.0, 100.0]",Q4
36035,2020-05-03,53591,54,2,84,25,923,3.142857142857143,28.857142857142858,5.8645241605066945,53.846994564652384,"(52.0, 100.0]",Q4
36035,2020-05-04,53591,54,13,97,63,986,4.428571428571429,35.57142857142857,8.263647680713978,66.37575072573486,"(52.0, 100.0]",Q4
36035,2020-05-05,53591,54,3,100,50,1036,4.714285714285714,38.857142857142854,8.796786240760044,72.50684416626459,"(52.0, 100.0]",Q4
36035,2020-05-06,53591,54,1,101,30,1066,4.285714285714286,39.285714285714285,7.997078400690948,73.30655200633369,"(52.0, 100.0]",Q4
36035,2020-05-07,53591,54,2,103,27,1093,4.0,37.857142857142854,7.463939840644883,70.64085920610336,"(52.0, 100.0]",Q4
36035,2020-05-08,53591,54,1,104,30,1123,3.5714285714285716,37.285714285714285,6.66423200057579,69.57458208601125,"(52.0, 100.0]",Q4
36035,2020-05-09,53591,54,3,107,31,1154,3.5714285714285716,36.57142857142857,6.66423200057579,68.24173568589609,"(52.0, 100.0]",Q4
36035,2020-05-10,53591,54,2,109,59,1213,3.5714285714285716,41.42857142857143,6.66423200057579,77.30509120667917,"(52.0, 100.0]",Q4
36035,2020-05-11,53591,54,26,135,100,1313,5.428571428571429,46.714285714285715,10.1296326408752,87.16815456753133,"(52.0, 100.0]",Q4
36035,2020-05-12,53591,54,5,140,61,1374,5.714285714285714,48.285714285714285,10.662771200921263,90.10041664778467,"(52.0, 100.0]",Q4
36035,2020-05-13,53591,54,4,144,81,1455,6.142857142857143,55.57142857142857,11.46247904099036,103.69544992895928,"(52.0, 100.0]",Q4
36035,2020-05-14,53591,54,1,145,67,1522,6.0,61.285714285714285,11.195909760967327,114.35822112988055,"(52.0, 100.0]",Q4
36035,2020-05-15,53591,54,3,148,100,1622,6.285714285714286,71.28571428571429,11.729048321013389,133.01807073149277,"(52.0, 100.0]",Q4
36035,2020-05-16,53591,54,23,171,110,1732,9.142857142857142,82.57142857142857,17.060433921474022,154.07704385331226,"(52.0, 100.0]",Q4
36035,2020-05-17,53591,54,11,182,132,1864,10.428571428571429,93.0,19.459557441681305,173.53660129499355,"(52.0, 100.0]",Q4
36035,2020-05-18,53591,54,0,182,30,1894,6.714285714285714,83.0,12.528756161082484,154.87675169338135,"(52.0, 100.0]",Q4
36035,2020-05-19,53591,54,2,184,89,1983,6.285714285714286,87.0,11.729048321013389,162.34069153402623,"(52.0, 100.0]",Q4
36035,2020-05-20,53591,54,2,186,100,2083,6.0,89.71428571428571,11.195909760967327,167.40550785446382,"(52.0, 100.0]",Q4
36035,2020-05-21,53591,54,3,189,88,2171,6.285714285714286,92.71428571428571,11.729048321013389,173.0034627349475,"(52.0, 100.0]",Q4
36035,2020-05-22,53591,54,4,193,142,2313,6.428571428571429,98.71428571428571,11.995617601036422,184.19937249591482,"(52.0, 100.0]",Q4
36035,2020-05-23,53591,54,1,194,84,2397,3.2857142857142856,95.0,6.1310934405297255,177.268571215316,"(52.0, 100.0]",Q4
36035,2020-05-24,53591,54,2,196,86,2483,2.0,88.42857142857143,3.7319699203224417,165.00638433425655,"(52.0, 100.0]",Q4
36035,2020-05-25,53591,54,0,196,44,2527,2.0,90.42857142857143,3.7319699203224417,168.738354254579,"(52.0, 100.0]",Q4
36035,2020-05-26,53591,54,2,198,112,2639,2.0,93.71428571428571,3.7319699203224417,174.8694476951087,"(52.0, 100.0]",Q4
36035,2020-05-27,53591,54,2,200,223,2862,2.0,111.28571428571429,3.7319699203224417,207.65746913794163,"(52.0, 100.0]",Q4
36035,2020-05-28,53591,54,6,206,202,3064,2.4285714285714284,127.57142857142857,4.531677760391537,238.04636706056718,"(52.0, 100.0]",Q4
36035,2020-05-29,53591,54,1,207,146,3210,2.0,128.14285714285714,3.7319699203224417,239.11264418065934,"(52.0, 100.0]",Q4
36035,2020-05-30,53591,54,1,208,159,3369,2.0,138.85714285714286,3.7319699203224417,259.1053401823867,"(52.0, 100.0]",Q4
36035,2020-05-31,53591,54,2,210,169,3538,2.0,150.71428571428572,3.7319699203224417,281.2305904242983,"(52.0, 100.0]",Q4
36035,2020-06-01,53591,54,2,212,83,3621,2.2857142857142856,156.28571428571428,4.2651084803685055,291.6267923451965,"(52.0, 100.0]",Q4
36035,2020-06-02,53591,54,1,213,197,3818,2.142857142857143,168.42857142857142,3.998539200345474,314.2851811471542,"(52.0, 100.0]",Q4
36035,2020-06-03,53591,54,2,215,187,4005,2.142857142857143,163.28571428571428,3.998539200345474,304.6886870663251,"(52.0, 100.0]",Q4
36035,2020-06-04,53591,54,4,219,248,4253,1.8571428571428572,169.85714285714286,3.4654006402994106,316.95087394738454,"(52.0, 100.0]",Q4
36035,2020-06-05,53591,54,3,222,233,4486,2.142857142857143,182.28571428571428,3.998539200345474,340.1424013093883,"(52.0, 100.0]",Q4
36035,2020-06-06,53591,54,2,224,205,4691,2.2857142857142856,188.85714285714286,4.2651084803685055,352.4045881904478,"(52.0, 100.0]",Q4
36035,2020-06-07,53591,54,3,227,254,4945,2.4285714285714284,201.0,4.531677760391537,375.0629769924054,"(52.0, 100.0]",Q4
36037,2020-03-02,57511,22,0,0,0,0,0.0,0.0,0.0,0.0,"(3.999, 24.0]",Q1
36037,2020-03-03,57511,22,0,0,0,0,0.0,0.0,0.0,0.0,"(3.999, 24.0]",Q1
36037,2020-03-04,57511,22,0,0,0,0,0.0,0.0,0.0,0.0,"(3.999, 24.0]",Q1
36037,2020-03-05,57511,22,0,0,0,0,0.0,0.0,0.0,0.0,"(3.999, 24.0]",Q1
36037,2020-03-06,57511,22,0,0,0,0,0.0,0.0,0.0,0.0,"(3.999, 24.0]",Q1
36037,2020-03-07,57511,22,0,0,0,0,0.0,0.0,0.0,0.0,"(3.999, 24.0]",Q1
36037,2020-03-08,57511,22,0,0,0,0,0.0,0.0,0.0,0.0,"(3.999, 24.0]",Q1
36037,2020-03-09,57511,22,0,0,0,0,0.0,0.0,0.0,0.0,"(3.999, 24.0]",Q1
36037,2020-03-10,57511,22,0,0,1,1,0.0,0.14285714285714285,0.0,0.24839968502919935,"(3.999, 24.0]",Q1
36037,2020-03-11,57511,22,0,0,0,1,0.0,0.14285714285714285,0.0,0.24839968502919935,"(3.999, 24.0]",Q1
36037,2020-03-12,57511,22,0,0,0,1,0.0,0.14285714285714285,0.0,0.24839968502919935,"(3.999, 24.0]",Q1
36037,2020-03-13,57511,22,0,0,0,1,0.0,0.14285714285714285,0.0,0.24839968502919935,"(3.999, 24.0]",Q1
36037,2020-03-14,57511,22,0,0,0,1,0.0,0.14285714285714285,0.0,0.24839968502919935,"(3.999, 24.0]",Q1
36037,2020-03-15,57511,22,0,0,0,1,0.0,0.14285714285714285,0.0,0.24839968502919935,"(3.999, 24.0]",Q1
36037,2020-03-16,57511,22,0,0,3,4,0.0,0.5714285714285714,0.0,0.9935987401167974,"(3.999, 24.0]",Q1
36037,2020-03-17,57511,22,0,0,5,9,0.0,1.1428571428571428,0.0,1.9871974802335948,"(3.999, 24.0]",Q1
36037,2020-03-18,57511,22,1,1,9,18,0.14285714285714285,2.4285714285714284,0.24839968502919935,4.222794645496389,"(3.999, 24.0]",Q1
36037,2020-03-19,57511,22,0,1,6,24,0.14285714285714285,3.2857142857142856,0.24839968502919935,5.713192755671585,"(3.999, 24.0]",Q1
36037,2020-03-20,57511,22,0,1,6,30,0.14285714285714285,4.142857142857143,0.24839968502919935,7.203590865846783,"(3.999, 24.0]",Q1
36037,2020-03-21,57511,22,0,1,6,36,0.14285714285714285,5.0,0.24839968502919935,8.693988976021979,"(3.999, 24.0]",Q1
36037,2020-03-22,57511,22,0,1,2,38,0.14285714285714285,5.285714285714286,0.24839968502919935,9.190788346080376,"(3.999, 24.0]",Q1
36037,2020-03-23,57511,22,0,1,8,46,0.14285714285714285,6.0,0.24839968502919935,10.432786771226374,"(3.999, 24.0]",Q1
36037,2020-03-24,57511,22,1,2,7,53,0.2857142857142857,6.285714285714286,0.4967993700583987,10.929586141284773,"(3.999, 24.0]",Q1
36037,2020-03-25,57511,22,2,4,19,72,0.42857142857142855,7.714285714285714,0.7451990550875981,13.413582991576765,"(3.999, 24.0]",Q1
36037,2020-03-26,57511,22,2,6,21,93,0.7142857142857143,9.857142857142858,1.241998425145997,17.13957826701476,"(3.999, 24.0]",Q1
36037,2020-03-27,57511,22,1,7,19,112,0.8571428571428571,11.714285714285714,1.4903981101751962,20.368774172394346,"(3.999, 24.0]",Q1
36037,2020-03-28,57511,22,2,9,6,118,1.1428571428571428,11.714285714285714,1.9871974802335948,20.368774172394346,"(3.999, 24.0]",Q1
36037,2020-03-29,57511,22,0,9,12,130,1.1428571428571428,13.142857142857142,1.9871974802335948,22.85277102268634,"(3.999, 24.0]",Q1
36037,2020-03-30,57511,22,1,10,24,154,1.2857142857142858,15.428571428571429,2.235597165262795,26.82716598315353,"(3.999, 24.0]",Q1
36037,2020-03-31,57511,22,3,13,28,182,1.5714285714285714,18.428571428571427,2.732396535321193,32.043559368766715,"(3.999, 24.0]",Q1
36037,2020-04-01,57511,22,1,14,39,221,1.4285714285714286,21.285714285714285,2.483996850291994,37.011553069350704,"(3.999, 24.0]",Q1
36037,2020-04-02,57511,22,2,16,23,244,1.4285714285714286,21.571428571428573,2.483996850291994,37.50835243940911,"(3.999, 24.0]",Q1
36037,2020-04-03,57511,22,4,20,30,274,1.8571428571428572,23.142857142857142,3.229195905379592,40.2407489747303,"(3.999, 24.0]",Q1
36037,2020-04-04,57511,22,2,22,12,286,1.8571428571428572,24.0,3.229195905379592,41.731147084905494,"(3.999, 24.0]",Q1
36037,2020-04-05,57511,22,1,23,11,297,2.0,23.857142857142858,3.477595590408791,41.482747399876295,"(3.999, 24.0]",Q1
36037,2020-04-06,57511,22,10,33,37,334,3.2857142857142856,25.714285714285715,5.713192755671585,44.71194330525589,"(3.999, 24.0]",Q1
36037,2020-04-07,57511,22,14,47,31,365,4.857142857142857,26.142857142857142,8.445589290992778,45.45714236034348,"(3.999, 24.0]",Q1
36037,2020-04-08,57511,22,9,56,43,408,6.0,26.714285714285715,10.432786771226374,46.450741100460284,"(3.999, 24.0]",Q1
36037,2020-04-09,57511,22,9,65,32,440,7.0,28.0,12.17158456643077,48.68633826572308,"(3.999, 24.0]",Q1
36037,2020-04-10,57511,22,2,67,18,458,6.714285714285714,26.285714285714285,11.67478519637237,45.70554204537268,"(3.999, 24.0]",Q1
36037,2020-04-11,57511,22,2,69,19,477,6.714285714285714,27.285714285714285,11.67478519637237,47.44433984057708,"(3.999, 24.0]",Q1
36037,2020-04-12,57511,22,2,71,7,484,6.857142857142857,26.714285714285715,11.92318488140157,46.450741100460284,"(3.999, 24.0]",Q1
36037,2020-04-13,57511,22,5,76,34,518,6.142857142857143,26.285714285714285,10.681186456255574,45.70554204537268,"(3.999, 24.0]",Q1
36037,2020-04-14,57511,22,0,76,15,533,4.142857142857143,24.0,7.203590865846783,41.731147084905494,"(3.999, 24.0]",Q1
36037,2020-04-15,57511,22,2,78,12,545,3.142857142857143,19.571428571428573,5.464793070642386,34.03075684900032,"(3.999, 24.0]",Q1
36037,2020-04-16,57511,22,5,83,21,566,2.5714285714285716,18.0,4.47119433052559,31.298360313679122,"(3.999, 24.0]",Q1
36037,2020-04-17,57511,22,4,87,13,579,2.857142857142857,17.285714285714285,4.967993700583988,30.05636188853312,"(3.999, 24.0]",Q1
36037,2020-04-18,57511,22,30,117,56,635,6.857142857142857,22.571428571428573,11.92318488140157,39.24715023461351,"(3.999, 24.0]",Q1
36037,2020-04-19,57511,22,2,119,14,649,6.857142857142857,23.571428571428573,11.92318488140157,40.9859480298179,"(3.999, 24.0]",Q1
36037,2020-04-20,57511,22,2,121,8,657,6.428571428571429,19.857142857142858,11.177985826313973,34.52755621905872,"(3.999, 24.0]",Q1
36037,2020-04-21,57511,22,1,122,17,674,6.571428571428571,20.142857142857142,11.42638551134317,35.024355589117114,"(3.999, 24.0]",Q1
36037,2020-04-22,57511,22,4,126,25,699,6.857142857142857,22.0,11.92318488140157,38.253551494496705,"(3.999, 24.0]",Q1
36037,2020-04-23,57511,22,1,127,19,718,6.285714285714286,21.714285714285715,10.929586141284773,37.75675212443831,"(3.999, 24.0]",Q1
36037,2020-04-24,57511,22,14,141,145,863,7.714285714285714,40.57142857142857,13.413582991576765,70.54551054829263,"(3.999, 24.0]",Q1
36037,2020-04-25,57511,22,3,144,37,900,3.857142857142857,37.857142857142854,6.706791495788383,65.82591653273784,"(3.999, 24.0]",Q1
36037,2020-04-26,57511,22,4,148,20,920,4.142857142857143,38.714285714285715,7.203590865846783,67.31631464291304,"(3.999, 24.0]",Q1
36037,2020-04-27,57511,22,1,149,28,948,4.0,41.57142857142857,6.955191180817582,72.28430834349702,"(3.999, 24.0]",Q1
36037,2020-04-28,57511,22,3,152,26,974,4.285714285714286,42.857142857142854,7.451990550875981,74.5199055087598,"(3.999, 24.0]",Q1
36037,2020-04-29,57511,22,1,153,32,1006,3.857142857142857,43.857142857142854,6.706791495788383,76.25870330396421,"(3.999, 24.0]",Q1
36037,2020-04-30,57511,22,1,154,29,1035,3.857142857142857,45.285714285714285,6.706791495788383,78.7427001542562,"(3.999, 24.0]",Q1
36037,2020-05-01,57511,22,1,155,55,1090,2.0,32.42857142857143,3.477595590408791,56.38672850162826,"(3.999, 24.0]",Q1
36037,2020-05-02,57511,22,0,155,25,1115,1.5714285714285714,30.714285714285715,2.732396535321193,53.40593228127787,"(3.999, 24.0]",Q1
36037,2020-05-03,57511,22,4,159,48,1163,1.5714285714285714,34.714285714285715,2.732396535321193,60.36112346209545,"(3.999, 24.0]",Q1
36037,2020-05-04,57511,22,0,159,47,1210,1.4285714285714286,37.42857142857143,2.483996850291994,65.08071747765024,"(3.999, 24.0]",Q1
36037,2020-05-05,57511,22,3,162,59,1269,1.4285714285714286,42.142857142857146,2.483996850291994,73.27790708361383,"(3.999, 24.0]",Q1
36037,2020-05-06,57511,22,6,168,98,1367,2.142857142857143,51.57142857142857,3.7259952754379904,89.67228629554097,"(3.999, 24.0]",Q1
36037,2020-05-07,57511,22,1,169,62,1429,2.142857142857143,56.285714285714285,3.7259952754379904,97.86947590150454,"(3.999, 24.0]",Q1
36037,2020-05-08,57511,22,1,170,47,1476,2.142857142857143,55.142857142857146,3.7259952754379904,95.88227842127097,"(3.999, 24.0]",Q1
36037,2020-05-09,57511,22,2,172,149,1625,2.4285714285714284,72.85714285714286,4.222794645496389,126.6838393648917,"(3.999, 24.0]",Q1
36037,2020-05-10,57511,22,1,173,182,1807,2.0,92.0,3.477595590408791,159.9693971588044,"(3.999, 24.0]",Q1
36037,2020-05-11,57511,22,1,174,77,1884,2.142857142857143,96.28571428571429,3.7259952754379904,167.4213877096804,"(3.999, 24.0]",Q1
36037,2020-05-12,57511,22,0,174,96,1980,1.7142857142857142,101.57142857142857,2.9807962203503924,176.61217605576076,"(3.999, 24.0]",Q1
36037,2020-05-13,57511,22,1,175,77,2057,1.0,98.57142857142857,1.7387977952043956,171.39578267014755,"(3.999, 24.0]",Q1
36037,2020-05-14,57511,22,0,175,66,2123,0.8571428571428571,99.14285714285714,1.4903981101751962,172.38938141026435,"(3.999, 24.0]",Q1
36037,2020-05-15,57511,22,3,178,47,2170,1.1428571428571428,99.14285714285714,1.9871974802335948,172.38938141026435,"(3.999, 24.0]",Q1
36037,2020-05-16,57511,22,2,180,69,2239,1.1428571428571428,87.71428571428571,1.9871974802335948,152.51740660792842,"(3.999, 24.0]",Q1
36037,2020-05-17,57511,22,0,180,30,2269,1.0,66.0,1.7387977952043956,114.76065448349011,"(3.999, 24.0]",Q1
36037,2020-05-18,57511,22,2,182,77,2346,1.1428571428571428,66.0,1.9871974802335948,114.76065448349011,"(3.999, 24.0]",Q1
36037,2020-05-19,57511,22,2,184,95,2441,1.4285714285714286,65.85714285714286,2.483996850291994,114.51225479846093,"(3.999, 24.0]",Q1
36037,2020-05-20,57511,22,4,188,145,2586,1.8571428571428572,75.57142857142857,3.229195905379592,131.40343338044647,"(3.999, 24.0]",Q1
36037,2020-05-21,57511,22,1,189,42,2628,2.0,72.14285714285714,3.477595590408791,125.44184093974569,"(3.999, 24.0]",Q1
36037,2020-05-22,57511,22,2,191,271,2899,1.8571428571428572,104.14285714285714,3.229195905379592,181.08337038628633,"(3.999, 24.0]",Q1
36037,2020-05-23,57511,22,0,191,181,3080,1.5714285714285714,120.14285714285714,2.732396535321193,208.9041351095567,"(3.999, 24.0]",Q1
36037,2020-05-24,57511,22,1,192,95,3175,1.7142857142857142,129.42857142857142,2.9807962203503924,225.05011463645462,"(3.999, 24.0]",Q1
36037,2020-05-25,57511,22,1,193,58,3233,1.5714285714285714,126.71428571428571,2.732396535321193,220.33052062089982,"(3.999, 24.0]",Q1
36037,2020-05-26,57511,22,2,195,84,3317,1.5714285714285714,125.14285714285714,2.732396535321193,217.59812408557866,"(3.999, 24.0]",Q1
36037,2020-05-27,57511,22,2,197,177,3494,1.2857142857142858,129.71428571428572,2.235597165262795,225.54691400651305,"(3.999, 24.0]",Q1
36037,2020-05-28,57511,22,2,199,119,3613,1.4285714285714286,140.71428571428572,2.483996850291994,244.67368975376144,"(3.999, 24.0]",Q1
36037,2020-05-29,57511,22,1,200,135,3748,1.2857142857142858,121.28571428571429,2.235597165262795,210.8913325897903,"(3.999, 24.0]",Q1
36037,2020-05-30,57511,22,2,202,115,3863,1.5714285714285714,111.85714285714286,2.732396535321193,194.49695337786312,"(3.999, 24.0]",Q1
36037,2020-05-31,57511,22,0,202,82,3945,1.4285714285714286,110.0,2.483996850291994,191.2677574724835,"(3.999, 24.0]",Q1
36037,2020-06-01,57511,22,0,202,145,4090,1.2857142857142858,122.42857142857143,2.235597165262795,212.87853007002388,"(3.999, 24.0]",Q1
36037,2020-06-02,57511,22,0,202,264,4354,1.0,148.14285714285714,1.7387977952043956,257.59047337527977,"(3.999, 24.0]",Q1
36037,2020-06-03,57511,22,3,205,326,4680,1.1428571428571428,169.42857142857142,1.9871974802335948,294.60202644463044,"(3.999, 24.0]",Q1
36037,2020-06-04,57511,22,0,205,137,4817,0.8571428571428571,172.0,1.4903981101751962,299.0732207751561,"(3.999, 24.0]",Q1
36037,2020-06-05,57511,22,1,206,322,5139,0.8571428571428571,198.71428571428572,1.4903981101751962,345.52396187561635,"(3.999, 24.0]",Q1
36037,2020-06-06,57511,22,2,208,153,5292,0.8571428571428571,204.14285714285714,1.4903981101751962,354.9631499067259,"(3.999, 24.0]",Q1
36037,2020-06-07,57511,22,0,208,104,5396,0.8571428571428571,207.28571428571428,1.4903981101751962,360.4279429773683,"(3.999, 24.0]",Q1
36039,2020-03-02,47491,28,0,0,0,0,0.0,0.0,0.0,0.0,"(24.0, 37.5]",Q2
36039,2020-03-03,47491,28,0,0,0,0,0.0,0.0,0.0,0.0,"(24.0, 37.5]",Q2
36039,2020-03-04,47491,28,0,0,0,0,0.0,0.0,0.0,0.0,"(24.0, 37.5]",Q2
36039,2020-03-05,47491,28,0,0,0,0,0.0,0.0,0.0,0.0,"(24.0, 37.5]",Q2
36039,2020-03-06,47491,28,0,0,0,0,0.0,0.0,0.0,0.0,"(24.0, 37.5]",Q2
36039,2020-03-07,47491,28,0,0,0,0,0.0,0.0,0.0,0.0,"(24.0, 37.5]",Q2
36039,2020-03-08,47491,28,0,0,0,0,0.0,0.0,0.0,0.0,"(24.0, 37.5]",Q2
36039,2020-03-09,47491,28,0,0,0,0,0.0,0.0,0.0,0.0,"(24.0, 37.5]",Q2
36039,2020-03-10,47491,28,0,0,0,0,0.0,0.0,0.0,0.0,"(24.0, 37.5]",Q2
36039,2020-03-11,47491,28,0,0,3,3,0.0,0.42857142857142855,0.0,0.9024266251951496,"(24.0, 37.5]",Q2
36039,2020-03-12,47491,28,0,0,0,3,0.0,0.42857142857142855,0.0,0.9024266251951496,"(24.0, 37.5]",Q2
36039,2020-03-13,47491,28,0,0,1,4,0.0,0.5714285714285714,0.0,1.2032355002601995,"(24.0, 37.5]",Q2
36039,2020-03-14,47491,28,2,2,8,12,0.2857142857142857,1.7142857142857142,0.6016177501300998,3.6097065007805984,"(24.0, 37.5]",Q2
36039,2020-03-15,47491,28,0,2,3,15,0.2857142857142857,2.142857142857143,0.6016177501300998,4.512133125975749,"(24.0, 37.5]",Q2
36039,2020-03-16,47491,28,0,2,9,24,0.2857142857142857,3.4285714285714284,0.6016177501300998,7.219413001561197,"(24.0, 37.5]",Q2
36039,2020-03-17,47491,28,0,2,8,32,0.2857142857142857,4.571428571428571,0.6016177501300998,9.625884002081596,"(24.0, 37.5]",Q2
36039,2020-03-18,47491,28,0,2,16,48,0.2857142857142857,6.428571428571429,0.6016177501300998,13.536399377927246,"(24.0, 37.5]",Q2
36039,2020-03-19,47491,28,0,2,21,69,0.2857142857142857,9.428571428571429,0.6016177501300998,19.853385754293296,"(24.0, 37.5]",Q2
36039,2020-03-20,47491,28,0,2,24,93,0.2857142857142857,12.714285714285714,0.6016177501300998,26.77198988078944,"(24.0, 37.5]",Q2
36039,2020-03-21,47491,28,0,2,23,116,0.0,14.857142857142858,0.0,31.284123006765196,"(24.0, 37.5]",Q2
36039,2020-03-22,47491,28,2,4,32,148,0.2857142857142857,19.0,0.6016177501300998,40.00758038365164,"(24.0, 37.5]",Q2
36039,2020-03-23,47491,28,0,4,8,156,0.2857142857142857,18.857142857142858,0.6016177501300998,39.70677150858659,"(24.0, 37.5]",Q2
36039,2020-03-24,47491,28,0,4,3,159,0.2857142857142857,18.142857142857142,0.6016177501300998,38.20272713326134,"(24.0, 37.5]",Q2
36039,2020-03-25,47491,28,1,5,11,170,0.42857142857142855,17.428571428571427,0.9024266251951496,36.69868275793608,"(24.0, 37.5]",Q2
36039,2020-03-26,47491,28,1,6,11,181,0.5714285714285714,16.0,1.2032355002601995,33.69059400728559,"(24.0, 37.5]",Q2
36039,2020-03-27,47491,28,1,7,6,187,0.7142857142857143,13.428571428571429,1.5040443753252497,28.276034256114695,"(24.0, 37.5]",Q2
36039,2020-03-28,47491,28,0,7,6,193,0.7142857142857143,11.0,1.5040443753252497,23.162283380008844,"(24.0, 37.5]",Q2
36039,2020-03-29,47491,28,3,10,13,206,0.8571428571428571,8.285714285714286,1.8048532503902992,17.446914753772898,"(24.0, 37.5]",Q2
36039,2020-03-30,47491,28,6,16,15,221,1.7142857142857142,9.285714285714286,3.6097065007805984,19.552576879228248,"(24.0, 37.5]",Q2
36039,2020-03-31,47491,28,2,18,9,230,2.0,10.142857142857142,4.211324250910699,21.357430129618542,"(24.0, 37.5]",Q2
36039,2020-04-01,47491,28,3,21,11,241,2.2857142857142856,10.142857142857142,4.812942001040798,21.357430129618542,"(24.0, 37.5]",Q2
36039,2020-04-02,47491,28,2,23,16,257,2.4285714285714284,10.857142857142858,5.113750876105849,22.861474504943796,"(24.0, 37.5]",Q2
36039,2020-04-03,47491,28,1,24,10,267,2.4285714285714284,11.428571428571429,5.113750876105849,24.064710005203995,"(24.0, 37.5]",Q2
36039,2020-04-04,47491,28,0,24,7,274,2.4285714285714284,11.571428571428571,5.113750876105849,24.365518880269043,"(24.0, 37.5]",Q2
36039,2020-04-05,47491,28,0,24,12,286,2.0,11.428571428571429,4.211324250910699,24.064710005203995,"(24.0, 37.5]",Q2
36039,2020-04-06,47491,28,0,24,13,299,1.1428571428571428,11.142857142857142,2.406471000520399,23.463092255073892,"(24.0, 37.5]",Q2
36039,2020-04-07,47491,28,1,25,6,305,1.0,10.714285714285714,2.1056621254553494,22.56066562987874,"(24.0, 37.5]",Q2
36039,2020-04-08,47491,28,3,28,29,334,1.0,13.285714285714286,2.1056621254553494,27.975225381049647,"(24.0, 37.5]",Q2
36039,2020-04-09,47491,28,6,34,36,370,1.5714285714285714,16.142857142857142,3.308897625715549,33.99140288235064,"(24.0, 37.5]",Q2
36039,2020-04-10,47491,28,3,37,27,397,1.8571428571428572,18.571428571428573,3.9105153758456495,39.105153758456495,"(24.0, 37.5]",Q2
36039,2020-04-11,47491,28,7,44,40,437,2.857142857142857,23.285714285714285,6.016177501300999,49.03184663560314,"(24.0, 37.5]",Q2
36039,2020-04-12,47491,28,1,45,14,451,3.0,23.571428571428573,6.3169863763660485,49.63346438573324,"(24.0, 37.5]",Q2
36039,2020-04-13,47491,28,21,66,93,544,6.0,35.0,12.633972752732097,73.69817439093723,"(24.0, 37.5]",Q2
36039,2020-04-14,47491,28,7,73,25,569,6.857142857142857,37.714285714285715,14.438826003122394,79.41354301717318,"(24.0, 37.5]",Q2
36039,2020-04-15,47491,28,1,74,16,585,6.571428571428571,35.857142857142854,13.837208252992298,75.50302764132752,"(24.0, 37.5]",Q2
36039,2020-04-16,47491,28,3,77,16,601,6.142857142857143,33.0,12.934781627797147,69.48685014002653,"(24.0, 37.5]",Q2
36039,2020-04-17,47491,28,5,82,28,629,6.428571428571429,33.142857142857146,13.536399377927246,69.78765901509159,"(24.0, 37.5]",Q2
36039,2020-04-18,47491,28,3,85,24,653,5.857142857142857,30.857142857142858,12.333163877667046,64.97471701405078,"(24.0, 37.5]",Q2
36039,2020-04-19,47491,28,1,86,8,661,5.857142857142857,30.0,12.333163877667046,63.16986376366049,"(24.0, 37.5]",Q2
36039,2020-04-20,47491,28,1,87,16,677,3.0,19.0,6.3169863763660485,40.00758038365164,"(24.0, 37.5]",Q2
36039,2020-04-21,47491,28,0,87,15,692,2.0,17.571428571428573,4.211324250910699,36.99949163300114,"(24.0, 37.5]",Q2
36039,2020-04-22,47491,28,2,89,25,717,2.142857142857143,18.857142857142858,4.512133125975749,39.70677150858659,"(24.0, 37.5]",Q2
36039,2020-04-23,47491,28,1,90,31,748,1.8571428571428572,21.0,3.9105153758456495,44.218904634562335,"(24.0, 37.5]",Q2
36039,2020-04-24,47491,28,17,107,212,960,3.5714285714285716,47.285714285714285,7.520221876626248,99.56773764653153,"(24.0, 37.5]",Q2
36039,2020-04-25,47491,28,3,110,36,996,3.5714285714285716,49.0,7.520221876626248,103.17744414731212,"(24.0, 37.5]",Q2
36039,2020-04-26,47491,28,1,111,25,1021,3.5714285714285716,51.42857142857143,7.520221876626248,108.29119502341797,"(24.0, 37.5]",Q2
36039,2020-04-27,47491,28,1,112,20,1041,3.5714285714285716,52.0,7.520221876626248,109.49443052367816,"(24.0, 37.5]",Q2
36039,2020-04-28,47491,28,2,114,24,1065,3.857142857142857,53.285714285714285,8.121839626756348,112.20171039926362,"(24.0, 37.5]",Q2
36039,2020-04-29,47491,28,17,131,59,1124,6.0,58.142857142857146,12.633972752732097,122.42921215147533,"(24.0, 37.5]",Q2
36039,2020-04-30,47491,28,8,139,47,1171,7.0,60.42857142857143,14.739634878187447,127.24215415251612,"(24.0, 37.5]",Q2
36039,2020-05-01,47491,28,3,142,36,1207,5.0,35.285714285714285,10.528310627276747,74.29979214106733,"(24.0, 37.5]",Q2
36039,2020-05-02,47491,28,9,151,32,1239,5.857142857142857,34.714285714285715,12.333163877667046,73.09655664080714,"(24.0, 37.5]",Q2
36039,2020-05-03,47491,28,3,154,34,1273,6.142857142857143,36.0,12.934781627797147,75.80383651639258,"(24.0, 37.5]",Q2
36039,2020-05-04,47491,28,12,166,36,1309,7.714285714285714,38.285714285714285,16.243679253512695,80.61677851743337,"(24.0, 37.5]",Q2
36039,2020-05-05,47491,28,22,188,84,1393,10.571428571428571,46.857142857142854,22.259856754813693,98.66531102133636,"(24.0, 37.5]",Q2
36039,2020-05-06,47491,28,10,198,55,1448,9.571428571428571,46.285714285714285,20.154194629358344,97.46207552107617,"(24.0, 37.5]",Q2
36039,2020-05-07,47491,28,1,199,34,1482,8.571428571428571,44.42857142857143,18.048532503902997,93.55156014523054,"(24.0, 37.5]",Q2
36039,2020-05-08,47491,28,5,204,45,1527,8.857142857142858,45.714285714285715,18.650150254033097,96.25884002081598,"(24.0, 37.5]",Q2
36039,2020-05-09,47491,28,2,206,44,1571,7.857142857142857,47.42857142857143,16.544488128577743,99.86854652159658,"(24.0, 37.5]",Q2
36039,2020-05-10,47491,28,0,206,14,1585,7.428571428571429,44.57142857142857,15.642061503382598,93.85236902029557,"(24.0, 37.5]",Q2
36039,2020-05-11,47491,28,0,206,28,1613,5.714285714285714,43.42857142857143,12.032355002601998,91.44589801977519,"(24.0, 37.5]",Q2
36039,2020-05-12,47491,28,0,206,41,1654,2.5714285714285716,37.285714285714285,5.414559751170899,78.51111639197802,"(24.0, 37.5]",Q2
36039,2020-05-13,47491,28,1,207,46,1700,1.2857142857142858,36.0,2.7072798755854497,75.80383651639258,"(24.0, 37.5]",Q2
36039,2020-05-14,47491,28,2,209,64,1764,1.4285714285714286,40.285714285714285,3.0080887506504994,84.82810276834407,"(24.0, 37.5]",Q2
36039,2020-05-15,47491,28,2,211,49,1813,1.0,40.857142857142854,2.1056621254553494,86.03133826860427,"(24.0, 37.5]",Q2
36039,2020-05-16,47491,28,1,212,43,1856,0.8571428571428571,40.714285714285715,1.8048532503902992,85.73052939353923,"(24.0, 37.5]",Q2
36039,2020-05-17,47491,28,1,213,33,1889,1.0,43.42857142857143,2.1056621254553494,91.44589801977519,"(24.0, 37.5]",Q2
36039,2020-05-18,47491,28,1,214,26,1915,1.1428571428571428,43.142857142857146,2.406471000520399,90.84428026964508,"(24.0, 37.5]",Q2
36039,2020-05-19,47491,28,1,215,189,2104,1.2857142857142858,64.28571428571429,2.7072798755854497,135.36399377927248,"(24.0, 37.5]",Q2
36039,2020-05-20,47491,28,0,215,44,2148,1.1428571428571428,64.0,2.406471000520399,134.76237602914236,"(24.0, 37.5]",Q2
36039,2020-05-21,47491,28,0,215,48,2196,0.8571428571428571,61.714285714285715,1.8048532503902992,129.94943402810156,"(24.0, 37.5]",Q2
36039,2020-05-22,47491,28,2,217,69,2265,0.8571428571428571,64.57142857142857,1.8048532503902992,135.96561152940257,"(24.0, 37.5]",Q2
36039,2020-05-23,47491,28,3,220,55,2320,1.1428571428571428,66.28571428571429,2.406471000520399,139.57531803018318,"(24.0, 37.5]",Q2
36039,2020-05-24,47491,28,5,225,35,2355,1.7142857142857142,66.57142857142857,3.6097065007805984,140.17693578031327,"(24.0, 37.5]",Q2
36039,2020-05-25,47491,28,0,225,24,2379,1.5714285714285714,66.28571428571429,3.308897625715549,139.57531803018318,"(24.0, 37.5]",Q2
36039,2020-05-26,47491,28,6,231,108,2487,2.2857142857142856,54.714285714285715,4.812942001040798,115.20979914991412,"(24.0, 37.5]",Q2
36039,2020-05-27,47491,28,5,236,107,2594,3.0,63.714285714285715,6.3169863763660485,134.16075827901227,"(24.0, 37.5]",Q2
36039,2020-05-28,47491,28,1,237,92,2686,3.142857142857143,70.0,6.617795251431098,147.39634878187445,"(24.0, 37.5]",Q2
36039,2020-05-29,47491,28,1,238,110,2796,3.0,75.85714285714286,6.3169863763660485,159.7295126595415,"(24.0, 37.5]",Q2
36039,2020-05-30,47491,28,0,238,100,2896,2.5714285714285716,82.28571428571429,5.414559751170899,173.26591203746878,"(24.0, 37.5]",Q2
36039,2020-05-31,47491,28,1,239,79,2975,2.0,88.57142857142857,4.211324250910699,186.50150254033096,"(24.0, 37.5]",Q2
36039,2020-06-01,47491,28,2,241,119,3094,2.2857142857142856,102.14285714285714,4.812942001040798,215.0783456715107,"(24.0, 37.5]",Q2
36039,2020-06-02,47491,28,0,241,153,3247,1.4285714285714286,108.57142857142857,3.0080887506504994,228.61474504943794,"(24.0, 37.5]",Q2
36039,2020-06-03,47491,28,0,241,130,3377,0.7142857142857143,111.85714285714286,1.5040443753252497,235.5333491759341,"(24.0, 37.5]",Q2
36039,2020-06-04,47491,28,1,242,134,3511,0.7142857142857143,117.85714285714286,1.5040443753252497,248.16732192866618,"(24.0, 37.5]",Q2
36039,2020-06-05,47491,28,4,246,181,3692,1.1428571428571428,128.0,2.406471000520399,269.5247520582847,"(24.0, 37.5]",Q2
36039,2020-06-06,47491,28,0,246,117,3809,1.1428571428571428,130.42857142857142,2.406471000520399,274.63850293439054,"(24.0, 37.5]",Q2
36039,2020-06-07,47491,28,1,247,42,3851,1.1428571428571428,125.14285714285714,2.406471000520399,263.5085745569837,"(24.0, 37.5]",Q2
36041,2020-03-02,4434,12,0,0,0,0,0.0,0.0,0.0,0.0,"(3.999, 24.0]",Q1
36041,2020-03-03,4434,12,0,0,0,0,0.0,0.0,0.0,0.0,"(3.999, 24.0]",Q1
36041,2020-03-04,4434,12,0,0,0,0,0.0,0.0,0.0,0.0,"(3.999, 24.0]",Q1
36041,2020-03-05,4434,12,0,0,0,0,0.0,0.0,0.0,0.0,"(3.999, 24.0]",Q1
36041,2020-03-06,4434,12,0,0,0,0,0.0,0.0,0.0,0.0,"(3.999, 24.0]",Q1
36041,2020-03-07,4434,12,0,0,0,0,0.0,0.0,0.0,0.0,"(3.999, 24.0]",Q1
36041,2020-03-08,4434,12,0,0,0,0,0.0,0.0,0.0,0.0,"(3.999, 24.0]",Q1
36041,2020-03-09,4434,12,0,0,0,0,0.0,0.0,0.0,0.0,"(3.999, 24.0]",Q1
36041,2020-03-10,4434,12,0,0,0,0,0.0,0.0,0.0,0.0,"(3.999, 24.0]",Q1
36041,2020-03-11,4434,12,0,0,0,0,0.0,0.0,0.0,0.0,"(3.999, 24.0]",Q1
36041,2020-03-12,4434,12,0,0,0,0,0.0,0.0,0.0,0.0,"(3.999, 24.0]",Q1
36041,2020-03-13,4434,12,0,0,0,0,0.0,0.0,0.0,0.0,"(3.999, 24.0]",Q1
36041,2020-03-14,4434,12,0,0,0,0,0.0,0.0,0.0,0.0,"(3.999, 24.0]",Q1
36041,2020-03-15,4434,12,0,0,0,0,0.0,0.0,0.0,0.0,"(3.999, 24.0]",Q1
36041,2020-03-16,4434,12,0,0,0,0,0.0,0.0,0.0,0.0,"(3.999, 24.0]",Q1
36041,2020-03-17,4434,12,1,1,2,2,0.14285714285714285,0.2857142857142857,3.221857078420001,6.443714156840002,"(3.999, 24.0]",Q1
36041,2020-03-18,4434,12,1,2,8,10,0.2857142857142857,1.4285714285714286,6.443714156840002,32.21857078420001,"(3.999, 24.0]",Q1
36041,2020-03-19,4434,12,0,2,0,10,0.2857142857142857,1.4285714285714286,6.443714156840002,32.21857078420001,"(3.999, 24.0]",Q1
36041,2020-03-20,4434,12,0,2,1,11,0.2857142857142857,1.5714285714285714,6.443714156840002,35.44042786262001,"(3.999, 24.0]",Q1
36041,2020-03-21,4434,12,0,2,0,11,0.2857142857142857,1.5714285714285714,6.443714156840002,35.44042786262001,"(3.999, 24.0]",Q1
36041,2020-03-22,4434,12,0,2,0,11,0.2857142857142857,1.5714285714285714,6.443714156840002,35.44042786262001,"(3.999, 24.0]",Q1
36041,2020-03-23,4434,12,0,2,2,13,0.2857142857142857,1.8571428571428572,6.443714156840002,41.884142019460015,"(3.999, 24.0]",Q1
36041,2020-03-24,4434,12,0,2,1,14,0.14285714285714285,1.7142857142857142,3.221857078420001,38.662284941040014,"(3.999, 24.0]",Q1
36041,2020-03-25,4434,12,0,2,0,14,0.0,0.5714285714285714,0.0,12.887428313680005,"(3.999, 24.0]",Q1
36041,2020-03-26,4434,12,0,2,0,14,0.0,0.5714285714285714,0.0,12.887428313680005,"(3.999, 24.0]",Q1
36041,2020-03-27,4434,12,0,2,0,14,0.0,0.42857142857142855,0.0,9.665571235260003,"(3.999, 24.0]",Q1
36041,2020-03-28,4434,12,0,2,0,14,0.0,0.42857142857142855,0.0,9.665571235260003,"(3.999, 24.0]",Q1
36041,2020-03-29,4434,12,0,2,0,14,0.0,0.42857142857142855,0.0,9.665571235260003,"(3.999, 24.0]",Q1
36041,2020-03-30,4434,12,0,2,0,14,0.0,0.14285714285714285,0.0,3.221857078420001,"(3.999, 24.0]",Q1
36041,2020-03-31,4434,12,0,2,0,14,0.0,0.0,0.0,0.0,"(3.999, 24.0]",Q1
36041,2020-04-01,4434,12,0,2,3,17,0.0,0.42857142857142855,0.0,9.665571235260003,"(3.999, 24.0]",Q1
36041,2020-04-02,4434,12,0,2,0,17,0.0,0.42857142857142855,0.0,9.665571235260003,"(3.999, 24.0]",Q1
36041,2020-04-03,4434,12,0,2,0,17,0.0,0.42857142857142855,0.0,9.665571235260003,"(3.999, 24.0]",Q1
36041,2020-04-04,4434,12,0,2,0,17,0.0,0.42857142857142855,0.0,9.665571235260003,"(3.999, 24.0]",Q1
36041,2020-04-05,4434,12,0,2,0,17,0.0,0.42857142857142855,0.0,9.665571235260003,"(3.999, 24.0]",Q1
36041,2020-04-06,4434,12,0,2,0,17,0.0,0.42857142857142855,0.0,9.665571235260003,"(3.999, 24.0]",Q1
36041,2020-04-07,4434,12,0,2,0,17,0.0,0.42857142857142855,0.0,9.665571235260003,"(3.999, 24.0]",Q1
36041,2020-04-08,4434,12,1,3,1,18,0.14285714285714285,0.14285714285714285,3.221857078420001,3.221857078420001,"(3.999, 24.0]",Q1
36041,2020-04-09,4434,12,0,3,0,18,0.14285714285714285,0.14285714285714285,3.221857078420001,3.221857078420001,"(3.999, 24.0]",Q1
36041,2020-04-10,4434,12,0,3,1,19,0.14285714285714285,0.2857142857142857,3.221857078420001,6.443714156840002,"(3.999, 24.0]",Q1
36041,2020-04-11,4434,12,0,3,0,19,0.14285714285714285,0.2857142857142857,3.221857078420001,6.443714156840002,"(3.999, 24.0]",Q1
36041,2020-04-12,4434,12,0,3,1,20,0.14285714285714285,0.42857142857142855,3.221857078420001,9.665571235260003,"(3.999, 24.0]",Q1
36041,2020-04-13,4434,12,0,3,0,20,0.14285714285714285,0.42857142857142855,3.221857078420001,9.665571235260003,"(3.999, 24.0]",Q1
36041,2020-04-14,4434,12,0,3,0,20,0.14285714285714285,0.42857142857142855,3.221857078420001,9.665571235260003,"(3.999, 24.0]",Q1
36041,2020-04-15,4434,12,0,3,0,20,0.0,0.2857142857142857,0.0,6.443714156840002,"(3.999, 24.0]",Q1
36041,2020-04-16,4434,12,0,3,6,26,0.0,1.1428571428571428,0.0,25.77485662736001,"(3.999, 24.0]",Q1
36041,2020-04-17,4434,12,0,3,1,27,0.0,1.1428571428571428,0.0,25.77485662736001,"(3.999, 24.0]",Q1
36041,2020-04-18,4434,12,0,3,1,28,0.0,1.2857142857142858,0.0,28.996713705780014,"(3.999, 24.0]",Q1
36041,2020-04-19,4434,12,0,3,0,28,0.0,1.1428571428571428,0.0,25.77485662736001,"(3.999, 24.0]",Q1
36041,2020-04-20,4434,12,0,3,0,28,0.0,1.1428571428571428,0.0,25.77485662736001,"(3.999, 24.0]",Q1
36041,2020-04-21,4434,12,0,3,1,29,0.0,1.2857142857142858,0.0,28.996713705780014,"(3.999, 24.0]",Q1
36041,2020-04-22,4434,12,0,3,0,29,0.0,1.2857142857142858,0.0,28.996713705780014,"(3.999, 24.0]",Q1
36041,2020-04-23,4434,12,0,3,0,29,0.0,0.42857142857142855,0.0,9.665571235260003,"(3.999, 24.0]",Q1
36041,2020-04-24,4434,12,0,3,3,32,0.0,0.7142857142857143,0.0,16.109285392100006,"(3.999, 24.0]",Q1
36041,2020-04-25,4434,12,0,3,1,33,0.0,0.7142857142857143,0.0,16.109285392100006,"(3.999, 24.0]",Q1
36041,2020-04-26,4434,12,0,3,2,35,0.0,1.0,0.0,22.552999548940008,"(3.999, 24.0]",Q1
36041,2020-04-27,4434,12,0,3,1,36,0.0,1.1428571428571428,0.0,25.77485662736001,"(3.999, 24.0]",Q1
36041,2020-04-28,4434,12,0,3,2,38,0.0,1.2857142857142858,0.0,28.996713705780014,"(3.999, 24.0]",Q1
36041,2020-04-29,4434,12,0,3,0,38,0.0,1.2857142857142858,0.0,28.996713705780014,"(3.999, 24.0]",Q1
36041,2020-04-30,4434,12,0,3,2,40,0.0,1.5714285714285714,0.0,35.44042786262001,"(3.999, 24.0]",Q1
36041,2020-05-01,4434,12,0,3,3,43,0.0,1.5714285714285714,0.0,35.44042786262001,"(3.999, 24.0]",Q1
36041,2020-05-02,4434,12,0,3,1,44,0.0,1.5714285714285714,0.0,35.44042786262001,"(3.999, 24.0]",Q1
36041,2020-05-03,4434,12,0,3,2,46,0.0,1.5714285714285714,0.0,35.44042786262001,"(3.999, 24.0]",Q1
36041,2020-05-04,4434,12,0,3,1,47,0.0,1.5714285714285714,0.0,35.44042786262001,"(3.999, 24.0]",Q1
36041,2020-05-05,4434,12,2,5,6,53,0.2857142857142857,2.142857142857143,6.443714156840002,48.32785617630002,"(3.999, 24.0]",Q1
36041,2020-05-06,4434,12,0,5,0,53,0.2857142857142857,2.142857142857143,6.443714156840002,48.32785617630002,"(3.999, 24.0]",Q1
36041,2020-05-07,4434,12,0,5,4,57,0.2857142857142857,2.4285714285714284,6.443714156840002,54.77157033314002,"(3.999, 24.0]",Q1
36041,2020-05-08,4434,12,0,5,3,60,0.2857142857142857,2.4285714285714284,6.443714156840002,54.77157033314002,"(3.999, 24.0]",Q1
36041,2020-05-09,4434,12,0,5,1,61,0.2857142857142857,2.4285714285714284,6.443714156840002,54.77157033314002,"(3.999, 24.0]",Q1
36041,2020-05-10,4434,12,0,5,0,61,0.2857142857142857,2.142857142857143,6.443714156840002,48.32785617630002,"(3.999, 24.0]",Q1
36041,2020-05-11,4434,12,0,5,0,61,0.2857142857142857,2.0,6.443714156840002,45.105999097880016,"(3.999, 24.0]",Q1
36041,2020-05-12,4434,12,0,5,6,67,0.0,2.0,0.0,45.105999097880016,"(3.999, 24.0]",Q1
36041,2020-05-13,4434,12,0,5,45,112,0.0,8.428571428571429,0.0,190.08956762678008,"(3.999, 24.0]",Q1
36041,2020-05-14,4434,12,0,5,10,122,0.0,9.285714285714286,0.0,209.42071009730012,"(3.999, 24.0]",Q1
36041,2020-05-15,4434,12,0,5,34,156,0.0,13.714285714285714,0.0,309.2982795283201,"(3.999, 24.0]",Q1
36041,2020-05-16,4434,12,0,5,139,295,0.0,33.42857142857143,0.0,753.9145563502803,"(3.999, 24.0]",Q1
36041,2020-05-17,4434,12,0,5,35,330,0.0,38.42857142857143,0.0,866.6795540949804,"(3.999, 24.0]",Q1
36041,2020-05-18,4434,12,0,5,2,332,0.0,38.714285714285715,0.0,873.1232682518204,"(3.999, 24.0]",Q1
36041,2020-05-19,4434,12,0,5,10,342,0.0,39.285714285714285,0.0,886.0106965655003,"(3.999, 24.0]",Q1
36041,2020-05-20,4434,12,0,5,12,354,0.0,34.57142857142857,0.0,779.6894129776402,"(3.999, 24.0]",Q1
36041,2020-05-21,4434,12,0,5,8,362,0.0,34.285714285714285,0.0,773.2456988208003,"(3.999, 24.0]",Q1
36041,2020-05-22,4434,12,0,5,38,400,0.0,34.857142857142854,0.0,786.1331271344802,"(3.999, 24.0]",Q1
36041,2020-05-23,4434,12,0,5,3,403,0.0,15.428571428571429,0.0,347.9605644693602,"(3.999, 24.0]",Q1
36041,2020-05-24,4434,12,0,5,3,406,0.0,10.857142857142858,0.0,244.86113795992014,"(3.999, 24.0]",Q1
36041,2020-05-25,4434,12,0,5,5,411,0.0,11.285714285714286,0.0,254.5267091951801,"(3.999, 24.0]",Q1
36041,2020-05-26,4434,12,0,5,1,412,0.0,10.0,0.0,225.52999548940008,"(3.999, 24.0]",Q1
36041,2020-05-27,4434,12,0,5,3,415,0.0,8.714285714285714,0.0,196.53328178362005,"(3.999, 24.0]",Q1
36041,2020-05-28,4434,12,0,5,4,419,0.0,8.142857142857142,0.0,183.64585346994008,"(3.999, 24.0]",Q1
36041,2020-05-29,4434,12,0,5,3,422,0.0,3.142857142857143,0.0,70.88085572524002,"(3.999, 24.0]",Q1
36041,2020-05-30,4434,12,0,5,22,444,0.0,5.857142857142857,0.0,132.09614021522006,"(3.999, 24.0]",Q1
36041,2020-05-31,4434,12,0,5,5,449,0.0,6.142857142857143,0.0,138.53985437206006,"(3.999, 24.0]",Q1
36041,2020-06-01,4434,12,0,5,1,450,0.0,5.571428571428571,0.0,125.65242605838004,"(3.999, 24.0]",Q1
36041,2020-06-02,4434,12,0,5,2,452,0.0,5.714285714285714,0.0,128.87428313680005,"(3.999, 24.0]",Q1
36041,2020-06-03,4434,12,0,5,74,526,0.0,15.857142857142858,0.0,357.62613570462014,"(3.999, 24.0]",Q1
36041,2020-06-04,4434,12,0,5,8,534,0.0,16.428571428571427,0.0,370.51356401830014,"(3.999, 24.0]",Q1
36041,2020-06-05,4434,12,0,5,7,541,0.0,17.0,0.0,383.40099233198015,"(3.999, 24.0]",Q1
36041,2020-06-06,4434,12,0,5,38,579,0.0,19.285714285714285,0.0,434.95070558670017,"(3.999, 24.0]",Q1
36041,2020-06-07,4434,12,0,5,8,587,0.0,19.714285714285715,0.0,444.6162768219602,"(3.999, 24.0]",Q1
36043,2020-03-02,61833,38,0,0,0,0,0.0,0.0,0.0,0.0,"(37.5, 52.0]",Q3
36043,2020-03-03,61833,38,0,0,0,0,0.0,0.0,0.0,0.0,"(37.5, 52.0]",Q3
36043,2020-03-04,61833,38,0,0,0,0,0.0,0.0,0.0,0.0,"(37.5, 52.0]",Q3
36043,2020-03-05,61833,38,0,0,0,0,0.0,0.0,0.0,0.0,"(37.5, 52.0]",Q3
36043,2020-03-06,61833,38,0,0,0,0,0.0,0.0,0.0,0.0,"(37.5, 52.0]",Q3
36043,2020-03-07,61833,38,0,0,0,0,0.0,0.0,0.0,0.0,"(37.5, 52.0]",Q3
36043,2020-03-08,61833,38,0,0,0,0,0.0,0.0,0.0,0.0,"(37.5, 52.0]",Q3
36043,2020-03-09,61833,38,0,0,0,0,0.0,0.0,0.0,0.0,"(37.5, 52.0]",Q3
36043,2020-03-10,61833,38,0,0,0,0,0.0,0.0,0.0,0.0,"(37.5, 52.0]",Q3
36043,2020-03-11,61833,38,0,0,0,0,0.0,0.0,0.0,0.0,"(37.5, 52.0]",Q3
36043,2020-03-12,61833,38,1,1,1,1,0.14285714285714285,0.14285714285714285,0.23103705603341718,0.23103705603341718,"(37.5, 52.0]",Q3
36043,2020-03-13,61833,38,0,1,0,1,0.14285714285714285,0.14285714285714285,0.23103705603341718,0.23103705603341718,"(37.5, 52.0]",Q3
36043,2020-03-14,61833,38,0,1,1,2,0.14285714285714285,0.2857142857142857,0.23103705603341718,0.46207411206683435,"(37.5, 52.0]",Q3
36043,2020-03-15,61833,38,0,1,0,2,0.14285714285714285,0.2857142857142857,0.23103705603341718,0.46207411206683435,"(37.5, 52.0]",Q3
36043,2020-03-16,61833,38,0,1,0,2,0.14285714285714285,0.2857142857142857,0.23103705603341718,0.46207411206683435,"(37.5, 52.0]",Q3
36043,2020-03-17,61833,38,0,1,0,2,0.14285714285714285,0.2857142857142857,0.23103705603341718,0.46207411206683435,"(37.5, 52.0]",Q3
36043,2020-03-18,61833,38,0,1,1,3,0.14285714285714285,0.42857142857142855,0.23103705603341718,0.6931111681002515,"(37.5, 52.0]",Q3
36043,2020-03-19,61833,38,1,2,1,4,0.14285714285714285,0.42857142857142855,0.23103705603341718,0.6931111681002515,"(37.5, 52.0]",Q3
36043,2020-03-20,61833,38,1,3,5,9,0.2857142857142857,1.1428571428571428,0.46207411206683435,1.8482964482673374,"(37.5, 52.0]",Q3
36043,2020-03-21,61833,38,1,4,10,19,0.42857142857142855,2.4285714285714284,0.6931111681002515,3.927629952568092,"(37.5, 52.0]",Q3
36043,2020-03-22,61833,38,0,4,6,25,0.42857142857142855,3.2857142857142856,0.6931111681002515,5.3138522887685955,"(37.5, 52.0]",Q3
36043,2020-03-23,61833,38,0,4,3,28,0.42857142857142855,3.7142857142857144,0.6931111681002515,6.0069634568688475,"(37.5, 52.0]",Q3
36043,2020-03-24,61833,38,1,5,5,33,0.5714285714285714,4.428571428571429,0.9241482241336687,7.162148737035933,"(37.5, 52.0]",Q3
36043,2020-03-25,61833,38,2,7,6,39,0.8571428571428571,5.142857142857143,1.386222336200503,8.31733401720302,"(37.5, 52.0]",Q3
36043,2020-03-26,61833,38,2,9,9,48,1.0,6.285714285714286,1.6172593922339202,10.165630465470358,"(37.5, 52.0]",Q3
36043,2020-03-27,61833,38,0,9,8,56,0.8571428571428571,6.714285714285714,1.386222336200503,10.858741633570608,"(37.5, 52.0]",Q3
36043,2020-03-28,61833,38,1,10,14,70,0.8571428571428571,7.285714285714286,1.386222336200503,11.782889857704276,"(37.5, 52.0]",Q3
36043,2020-03-29,61833,38,2,12,8,78,1.1428571428571428,7.571428571428571,1.8482964482673374,12.244963969771112,"(37.5, 52.0]",Q3
36043,2020-03-30,61833,38,0,12,1,79,1.1428571428571428,7.285714285714286,1.8482964482673374,11.782889857704276,"(37.5, 52.0]",Q3
36043,2020-03-31,61833,38,0,12,4,83,1.0,7.142857142857143,1.6172593922339202,11.55185280167086,"(37.5, 52.0]",Q3
36043,2020-04-01,61833,38,2,14,9,92,1.0,7.571428571428571,1.6172593922339202,12.244963969771112,"(37.5, 52.0]",Q3
36043,2020-04-02,61833,38,0,14,19,111,0.7142857142857143,9.0,1.155185280167086,14.555334530105284,"(37.5, 52.0]",Q3
36043,2020-04-03,61833,38,4,18,27,138,1.2857142857142858,11.714285714285714,2.079333504300755,18.94503859474021,"(37.5, 52.0]",Q3
36043,2020-04-04,61833,38,4,22,46,184,1.7142857142857142,16.285714285714285,2.772444672401006,26.33822438780956,"(37.5, 52.0]",Q3
36043,2020-04-05,61833,38,3,25,23,207,1.8571428571428572,18.428571428571427,3.0034817284344237,29.803780228310817,"(37.5, 52.0]",Q3
36043,2020-04-06,61833,38,2,27,19,226,2.142857142857143,21.0,3.4655558405012576,33.962447236912325,"(37.5, 52.0]",Q3
36043,2020-04-07,61833,38,2,29,19,245,2.4285714285714284,23.142857142857142,3.927629952568092,37.428003077413585,"(37.5, 52.0]",Q3
36043,2020-04-08,61833,38,3,32,44,289,2.5714285714285716,28.142857142857142,4.15866700860151,45.51430003858319,"(37.5, 52.0]",Q3
36043,2020-04-09,61833,38,4,36,23,312,3.142857142857143,28.714285714285715,5.082815232735179,46.438448262716854,"(37.5, 52.0]",Q3
36043,2020-04-10,61833,38,1,37,12,324,2.7142857142857144,26.571428571428573,4.389704064634928,42.9728924222156,"(37.5, 52.0]",Q3
36043,2020-04-11,61833,38,0,37,11,335,2.142857142857143,21.571428571428573,3.4655558405012576,34.886595461046,"(37.5, 52.0]",Q3
36043,2020-04-12,61833,38,1,38,29,364,1.8571428571428572,22.428571428571427,3.0034817284344237,36.272817797246496,"(37.5, 52.0]",Q3
36043,2020-04-13,61833,38,1,39,26,390,1.7142857142857142,23.428571428571427,2.772444672401006,37.89007718948042,"(37.5, 52.0]",Q3
36043,2020-04-14,61833,38,1,40,9,399,1.5714285714285714,22.0,2.5414076163675894,35.57970662914625,"(37.5, 52.0]",Q3
36043,2020-04-15,61833,38,3,43,23,422,1.5714285714285714,19.0,2.5414076163675894,30.72792845244449,"(37.5, 52.0]",Q3
36043,2020-04-16,61833,38,3,46,30,452,1.4285714285714286,20.0,2.310370560334172,32.34518784467841,"(37.5, 52.0]",Q3
36043,2020-04-17,61833,38,1,47,18,470,1.4285714285714286,20.857142857142858,2.310370560334172,33.73141018087891,"(37.5, 52.0]",Q3
36043,2020-04-18,61833,38,2,49,20,490,1.7142857142857142,22.142857142857142,2.772444672401006,35.810743685179666,"(37.5, 52.0]",Q3
36043,2020-04-19,61833,38,0,49,23,513,1.5714285714285714,21.285714285714285,2.5414076163675894,34.42452134897916,"(37.5, 52.0]",Q3
36043,2020-04-20,61833,38,1,50,7,520,1.5714285714285714,18.571428571428573,2.5414076163675894,30.03481728434424,"(37.5, 52.0]",Q3
36043,2020-04-21,61833,38,3,53,34,554,1.8571428571428572,22.142857142857142,3.0034817284344237,35.810743685179666,"(37.5, 52.0]",Q3
36043,2020-04-22,61833,38,1,54,25,579,1.5714285714285714,22.428571428571427,2.5414076163675894,36.272817797246496,"(37.5, 52.0]",Q3
36043,2020-04-23,61833,38,2,56,27,606,1.4285714285714286,22.0,2.310370560334172,35.57970662914625,"(37.5, 52.0]",Q3
36043,2020-04-24,61833,38,0,56,59,665,1.2857142857142858,27.857142857142858,2.079333504300755,45.05222592651636,"(37.5, 52.0]",Q3
36043,2020-04-25,61833,38,1,57,31,696,1.1428571428571428,29.428571428571427,1.8482964482673374,47.59363354288394,"(37.5, 52.0]",Q3
36043,2020-04-26,61833,38,1,58,26,722,1.2857142857142858,29.857142857142858,2.079333504300755,48.286744710984195,"(37.5, 52.0]",Q3
36043,2020-04-27,61833,38,0,58,14,736,1.1428571428571428,30.857142857142858,1.8482964482673374,49.90400410321812,"(37.5, 52.0]",Q3
36043,2020-04-28,61833,38,0,58,28,764,0.7142857142857143,30.0,1.155185280167086,48.51778176701762,"(37.5, 52.0]",Q3
36043,2020-04-29,61833,38,0,58,28,792,0.5714285714285714,30.428571428571427,0.9241482241336687,49.21089293511786,"(37.5, 52.0]",Q3
36043,2020-04-30,61833,38,2,60,28,820,0.5714285714285714,30.571428571428573,0.9241482241336687,49.44192999115128,"(37.5, 52.0]",Q3
36043,2020-05-01,61833,38,1,61,15,835,0.7142857142857143,24.285714285714285,1.155185280167086,39.27629952568092,"(37.5, 52.0]",Q3
36043,2020-05-02,61833,38,1,62,29,864,0.7142857142857143,24.0,1.155185280167086,38.81422541361409,"(37.5, 52.0]",Q3
36043,2020-05-03,61833,38,1,63,41,905,0.7142857142857143,26.142857142857142,1.155185280167086,42.27978125411535,"(37.5, 52.0]",Q3
36043,2020-05-04,61833,38,4,67,29,934,1.2857142857142858,28.285714285714285,2.079333504300755,45.74533709461661,"(37.5, 52.0]",Q3
36043,2020-05-05,61833,38,1,68,66,1000,1.4285714285714286,33.714285714285715,2.310370560334172,54.52474522388646,"(37.5, 52.0]",Q3
36043,2020-05-06,61833,38,6,74,65,1065,2.2857142857142856,39.0,3.696592896534675,63.0731162971229,"(37.5, 52.0]",Q3
36043,2020-05-07,61833,38,2,76,55,1120,2.2857142857142856,42.857142857142854,3.696592896534675,69.31111681002515,"(37.5, 52.0]",Q3
36043,2020-05-08,61833,38,1,77,43,1163,2.2857142857142856,46.857142857142854,3.696592896534675,75.78015437896084,"(37.5, 52.0]",Q3
36043,2020-05-09,61833,38,2,79,56,1219,2.4285714285714284,50.714285714285715,3.927629952568092,82.0181548918631,"(37.5, 52.0]",Q3
36043,2020-05-10,61833,38,2,81,57,1276,2.5714285714285716,53.0,4.15866700860151,85.71474778839777,"(37.5, 52.0]",Q3
36043,2020-05-11,61833,38,0,81,42,1318,2.0,54.857142857142854,3.2345187844678405,88.7182295168322,"(37.5, 52.0]",Q3
36043,2020-05-12,61833,38,3,84,61,1379,2.2857142857142856,54.142857142857146,3.696592896534675,87.56304423666512,"(37.5, 52.0]",Q3
36043,2020-05-13,61833,38,2,86,54,1433,1.7142857142857142,52.57142857142857,2.772444672401006,85.02163662029753,"(37.5, 52.0]",Q3
36043,2020-05-14,61833,38,1,87,49,1482,1.5714285714285714,51.714285714285715,2.5414076163675894,83.63541428409702,"(37.5, 52.0]",Q3
36043,2020-05-15,61833,38,4,91,50,1532,2.0,52.714285714285715,3.2345187844678405,85.25267367633094,"(37.5, 52.0]",Q3
36043,2020-05-16,61833,38,0,91,157,1689,1.7142857142857142,67.14285714285714,2.772444672401006,108.58741633570608,"(37.5, 52.0]",Q3
36043,2020-05-17,61833,38,1,92,68,1757,1.5714285714285714,68.71428571428571,2.5414076163675894,111.12882395207366,"(37.5, 52.0]",Q3
36043,2020-05-18,61833,38,0,92,65,1822,1.5714285714285714,72.0,2.5414076163675894,116.44267624084227,"(37.5, 52.0]",Q3
36043,2020-05-19,61833,38,1,93,95,1917,1.2857142857142858,76.85714285714286,2.079333504300755,124.29793614597845,"(37.5, 52.0]",Q3
36043,2020-05-20,61833,38,0,93,60,1977,1.0,77.71428571428571,1.6172593922339202,125.68415848217894,"(37.5, 52.0]",Q3
36043,2020-05-21,61833,38,2,95,77,2054,1.1428571428571428,81.71428571428571,1.8482964482673374,132.15319605111463,"(37.5, 52.0]",Q3
36043,2020-05-22,61833,38,5,100,212,2266,1.2857142857142858,104.85714285714286,2.079333504300755,169.58119912852823,"(37.5, 52.0]",Q3
36043,2020-05-23,61833,38,1,101,143,2409,1.4285714285714286,102.85714285714286,2.310370560334172,166.3466803440604,"(37.5, 52.0]",Q3
36043,2020-05-24,61833,38,2,103,237,2646,1.5714285714285714,127.0,2.5414076163675894,205.39194281370789,"(37.5, 52.0]",Q3
36043,2020-05-25,61833,38,0,103,45,2691,1.5714285714285714,124.14285714285714,2.5414076163675894,200.77120169303956,"(37.5, 52.0]",Q3
36043,2020-05-26,61833,38,2,105,328,3019,1.7142857142857142,157.42857142857142,2.772444672401006,254.60283574882575,"(37.5, 52.0]",Q3
36043,2020-05-27,61833,38,1,106,442,3461,1.8571428571428572,212.0,3.0034817284344237,342.8589911535911,"(37.5, 52.0]",Q3
36043,2020-05-28,61833,38,1,107,154,3615,1.7142857142857142,223.0,2.772444672401006,360.6488444681642,"(37.5, 52.0]",Q3
36043,2020-05-29,61833,38,0,107,332,3947,1.0,240.14285714285714,1.6172593922339202,388.3732911921743,"(37.5, 52.0]",Q3
36043,2020-05-30,61833,38,1,108,309,4256,1.0,263.85714285714283,1.6172593922339202,426.7254424937216,"(37.5, 52.0]",Q3
36043,2020-05-31,61833,38,1,109,131,4387,0.8571428571428571,248.71428571428572,1.386222336200503,402.2355145541794,"(37.5, 52.0]",Q3
36043,2020-06-01,61833,38,2,111,186,4573,1.1428571428571428,268.85714285714283,1.8482964482673374,434.8117394548911,"(37.5, 52.0]",Q3
36043,2020-06-02,61833,38,2,113,522,5095,1.1428571428571428,296.57142857142856,1.8482964482673374,479.6329283253741,"(37.5, 52.0]",Q3
36043,2020-06-03,61833,38,0,113,398,5493,1.0,290.2857142857143,1.6172593922339202,469.46729785990374,"(37.5, 52.0]",Q3
36043,2020-06-04,61833,38,2,115,334,5827,1.1428571428571428,316.0,1.8482964482673374,511.0539679459188,"(37.5, 52.0]",Q3
36043,2020-06-05,61833,38,7,122,523,6350,2.142857142857143,343.2857142857143,3.4655558405012576,555.1820456483015,"(37.5, 52.0]",Q3
36043,2020-06-06,61833,38,1,123,357,6707,2.142857142857143,350.14285714285717,3.4655558405012576,566.2718243379056,"(37.5, 52.0]",Q3
36043,2020-06-07,61833,38,1,124,377,7084,2.142857142857143,385.2857142857143,3.4655558405012576,623.1069401221262,"(37.5, 52.0]",Q3
36045,2020-03-02,111755,58,0,0,0,0,0.0,0.0,0.0,0.0,"(52.0, 100.0]",Q4
36045,2020-03-03,111755,58,0,0,0,0,0.0,0.0,0.0,0.0,"(52.0, 100.0]",Q4
36045,2020-03-04,111755,58,0,0,0,0,0.0,0.0,0.0,0.0,"(52.0, 100.0]",Q4
36045,2020-03-05,111755,58,0,0,0,0,0.0,0.0,0.0,0.0,"(52.0, 100.0]",Q4
36045,2020-03-06,111755,58,0,0,0,0,0.0,0.0,0.0,0.0,"(52.0, 100.0]",Q4
36045,2020-03-07,111755,58,0,0,1,1,0.0,1.0,0.0,0.894814549684578,"(52.0, 100.0]",Q4
36045,2020-03-08,111755,58,0,0,0,1,0.0,0.14285714285714285,0.0,0.12783064995493967,"(52.0, 100.0]",Q4
36045,2020-03-09,111755,58,0,0,0,1,0.0,0.14285714285714285,0.0,0.12783064995493967,"(52.0, 100.0]",Q4
36045,2020-03-10,111755,58,0,0,0,1,0.0,0.14285714285714285,0.0,0.12783064995493967,"(52.0, 100.0]",Q4
36045,2020-03-11,111755,58,0,0,1,2,0.0,0.2857142857142857,0.0,0.25566129990987935,"(52.0, 100.0]",Q4
36045,2020-03-12,111755,58,0,0,0,2,0.0,0.2857142857142857,0.0,0.25566129990987935,"(52.0, 100.0]",Q4
36045,2020-03-13,111755,58,0,0,0,2,0.0,0.2857142857142857,0.0,0.25566129990987935,"(52.0, 100.0]",Q4
36045,2020-03-14,111755,58,0,0,0,2,0.0,0.14285714285714285,0.0,0.12783064995493967,"(52.0, 100.0]",Q4
36045,2020-03-15,111755,58,0,0,1,3,0.0,0.2857142857142857,0.0,0.25566129990987935,"(52.0, 100.0]",Q4
36045,2020-03-16,111755,58,0,0,0,3,0.0,0.2857142857142857,0.0,0.25566129990987935,"(52.0, 100.0]",Q4
36045,2020-03-17,111755,58,0,0,2,5,0.0,0.5714285714285714,0.0,0.5113225998197587,"(52.0, 100.0]",Q4
36045,2020-03-18,111755,58,1,1,7,12,0.14285714285714285,1.4285714285714286,0.12783064995493967,1.278306499549397,"(52.0, 100.0]",Q4
36045,2020-03-19,111755,58,0,1,13,25,0.14285714285714285,3.2857142857142856,0.12783064995493967,2.940104948963613,"(52.0, 100.0]",Q4
36045,2020-03-20,111755,58,0,1,18,43,0.14285714285714285,5.857142857142857,0.12783064995493967,5.241056648152527,"(52.0, 100.0]",Q4
36045,2020-03-21,111755,58,0,1,4,47,0.14285714285714285,6.428571428571429,0.12783064995493967,5.752379247972287,"(52.0, 100.0]",Q4
36045,2020-03-22,111755,58,1,2,20,67,0.2857142857142857,9.142857142857142,0.25566129990987935,8.181161597116139,"(52.0, 100.0]",Q4
36045,2020-03-23,111755,58,0,2,1,68,0.2857142857142857,9.285714285714286,0.25566129990987935,8.308992247071082,"(52.0, 100.0]",Q4
36045,2020-03-24,111755,58,0,2,13,81,0.2857142857142857,10.857142857142858,0.25566129990987935,9.715129396575417,"(52.0, 100.0]",Q4
36045,2020-03-25,111755,58,1,3,31,112,0.2857142857142857,14.285714285714286,0.25566129990987935,12.78306499549397,"(52.0, 100.0]",Q4
36045,2020-03-26,111755,58,0,3,23,135,0.2857142857142857,15.714285714285714,0.25566129990987935,14.061371495043367,"(52.0, 100.0]",Q4
36045,2020-03-27,111755,58,3,6,45,180,0.7142857142857143,19.571428571428573,0.6391532497746985,17.51279904382674,"(52.0, 100.0]",Q4
36045,2020-03-28,111755,58,1,7,52,232,0.8571428571428571,26.428571428571427,0.7669838997296382,23.64867024166384,"(52.0, 100.0]",Q4
36045,2020-03-29,111755,58,4,11,100,332,1.2857142857142858,37.857142857142854,1.1504758495944574,33.875122238059014,"(52.0, 100.0]",Q4
36045,2020-03-30,111755,58,1,12,19,351,1.4285714285714286,40.42857142857143,1.278306499549397,36.176073937247935,"(52.0, 100.0]",Q4
36045,2020-03-31,111755,58,0,12,14,365,1.4285714285714286,40.57142857142857,1.278306499549397,36.30390458720287,"(52.0, 100.0]",Q4
36045,2020-04-01,111755,58,3,15,53,418,1.7142857142857142,43.714285714285715,1.5339677994592764,39.11617888621155,"(52.0, 100.0]",Q4
36045,2020-04-02,111755,58,3,18,56,474,2.142857142857143,48.42857142857143,1.9174597493240952,43.33459033472456,"(52.0, 100.0]",Q4
36045,2020-04-03,111755,58,2,20,38,512,2.0,47.42857142857143,1.789629099369156,42.439775785039984,"(52.0, 100.0]",Q4
36045,2020-04-04,111755,58,6,26,75,587,2.7142857142857144,50.714285714285715,2.4287823491438543,45.37988073400359,"(52.0, 100.0]",Q4
36045,2020-04-05,111755,58,7,33,98,685,3.142857142857143,50.42857142857143,2.8122742990086733,45.12421943409372,"(52.0, 100.0]",Q4
36045,2020-04-06,111755,58,6,39,63,748,3.857142857142857,56.714285714285715,3.451427548783372,50.74876803211106,"(52.0, 100.0]",Q4
36045,2020-04-07,111755,58,1,40,25,773,4.0,58.285714285714285,3.579258198738312,52.1549051816154,"(52.0, 100.0]",Q4
36045,2020-04-08,111755,58,2,42,84,857,3.857142857142857,62.714285714285715,3.451427548783372,56.117655330218525,"(52.0, 100.0]",Q4
36045,2020-04-09,111755,58,1,43,52,909,3.5714285714285716,62.142857142857146,3.1957662488734924,55.60633273039877,"(52.0, 100.0]",Q4
36045,2020-04-10,111755,58,1,44,43,952,3.4285714285714284,62.857142857142854,3.067935598918553,56.24548598017347,"(52.0, 100.0]",Q4
36045,2020-04-11,111755,58,2,46,47,999,2.857142857142857,58.857142857142854,2.556612999098794,52.66622778143515,"(52.0, 100.0]",Q4
36045,2020-04-12,111755,58,0,46,24,1023,1.8571428571428572,48.285714285714285,1.6617984494142162,43.206759684769615,"(52.0, 100.0]",Q4
36045,2020-04-13,111755,58,1,47,37,1060,1.1428571428571428,44.57142857142857,1.0226451996395174,39.88316278594119,"(52.0, 100.0]",Q4
36045,2020-04-14,111755,58,0,47,1,1061,1.0,41.142857142857146,0.894814549684578,36.815227187022636,"(52.0, 100.0]",Q4
36045,2020-04-15,111755,58,1,48,33,1094,0.8571428571428571,33.857142857142854,0.7669838997296382,30.295864039320705,"(52.0, 100.0]",Q4
36045,2020-04-16,111755,58,2,50,31,1125,1.0,30.857142857142858,0.894814549684578,27.611420390266975,"(52.0, 100.0]",Q4
36045,2020-04-17,111755,58,0,50,16,1141,0.8571428571428571,27.0,0.7669838997296382,24.159992841483604,"(52.0, 100.0]",Q4
36045,2020-04-18,111755,58,4,54,53,1194,1.1428571428571428,27.857142857142858,1.0226451996395174,24.92697674121324,"(52.0, 100.0]",Q4
36045,2020-04-19,111755,58,0,54,23,1217,1.1428571428571428,27.714285714285715,1.0226451996395174,24.799146091258304,"(52.0, 100.0]",Q4
36045,2020-04-20,111755,58,0,54,7,1224,1.0,23.428571428571427,0.894814549684578,20.964226592610107,"(52.0, 100.0]",Q4
36045,2020-04-21,111755,58,0,54,8,1232,1.0,24.428571428571427,0.894814549684578,21.85904114229469,"(52.0, 100.0]",Q4
36045,2020-04-22,111755,58,2,56,28,1260,1.1428571428571428,23.714285714285715,1.0226451996395174,21.219887892519992,"(52.0, 100.0]",Q4
36045,2020-04-23,111755,58,2,58,37,1297,1.1428571428571428,24.571428571428573,1.0226451996395174,21.98687179224963,"(52.0, 100.0]",Q4
36045,2020-04-24,111755,58,1,59,63,1360,1.2857142857142858,31.285714285714285,1.1504758495944574,27.99491234013179,"(52.0, 100.0]",Q4
36045,2020-04-25,111755,58,1,60,27,1387,0.8571428571428571,27.571428571428573,0.7669838997296382,24.671315441303364,"(52.0, 100.0]",Q4
36045,2020-04-26,111755,58,0,60,52,1439,0.8571428571428571,31.714285714285715,0.7669838997296382,28.37840428999661,"(52.0, 100.0]",Q4
36045,2020-04-27,111755,58,0,60,15,1454,0.8571428571428571,32.857142857142854,0.7669838997296382,29.40104948963613,"(52.0, 100.0]",Q4
36045,2020-04-28,111755,58,0,60,28,1482,0.8571428571428571,35.714285714285715,0.7669838997296382,31.957662488734925,"(52.0, 100.0]",Q4
36045,2020-04-29,111755,58,1,61,36,1518,0.7142857142857143,36.857142857142854,0.6391532497746985,32.98030768837444,"(52.0, 100.0]",Q4
36045,2020-04-30,111755,58,0,61,37,1555,0.42857142857142855,36.857142857142854,0.3834919498648191,32.98030768837444,"(52.0, 100.0]",Q4
36045,2020-05-01,111755,58,1,62,48,1603,0.42857142857142855,34.714285714285715,0.3834919498648191,31.062847939050343,"(52.0, 100.0]",Q4
36045,2020-05-02,111755,58,0,62,48,1651,0.2857142857142857,37.714285714285715,0.25566129990987935,33.74729158810408,"(52.0, 100.0]",Q4
36045,2020-05-03,111755,58,1,63,82,1733,0.42857142857142855,42.0,0.3834919498648191,37.582211086752274,"(52.0, 100.0]",Q4
36045,2020-05-04,111755,58,0,63,13,1746,0.42857142857142855,41.714285714285715,0.3834919498648191,37.32654978684239,"(52.0, 100.0]",Q4
36045,2020-05-05,111755,58,0,63,50,1796,0.42857142857142855,44.857142857142854,0.3834919498648191,40.13882408585106,"(52.0, 100.0]",Q4
36045,2020-05-06,111755,58,1,64,90,1886,0.42857142857142855,52.57142857142857,0.3834919498648191,47.041679183417806,"(52.0, 100.0]",Q4
36045,2020-05-07,111755,58,2,66,82,1968,0.7142857142857143,59.0,0.6391532497746985,52.79405843139009,"(52.0, 100.0]",Q4
36045,2020-05-08,111755,58,1,67,47,2015,0.7142857142857143,58.857142857142854,0.6391532497746985,52.66622778143515,"(52.0, 100.0]",Q4
36045,2020-05-09,111755,58,1,68,64,2079,0.8571428571428571,61.142857142857146,0.7669838997296382,54.711518180714194,"(52.0, 100.0]",Q4
36045,2020-05-10,111755,58,0,68,63,2142,0.7142857142857143,58.42857142857143,0.6391532497746985,52.28273583157034,"(52.0, 100.0]",Q4
36045,2020-05-11,111755,58,0,68,46,2188,0.7142857142857143,63.142857142857146,0.6391532497746985,56.501147280083345,"(52.0, 100.0]",Q4
36045,2020-05-12,111755,58,0,68,80,2268,0.7142857142857143,67.42857142857143,0.6391532497746985,60.33606677873154,"(52.0, 100.0]",Q4
36045,2020-05-13,111755,58,1,69,104,2372,0.7142857142857143,69.42857142857143,0.6391532497746985,62.125695878100686,"(52.0, 100.0]",Q4
36045,2020-05-14,111755,58,2,71,453,2825,0.7142857142857143,122.42857142857143,0.6391532497746985,109.55086701138332,"(52.0, 100.0]",Q4
36045,2020-05-15,111755,58,0,71,237,3062,0.5714285714285714,149.57142857142858,0.5113225998197587,133.8386905028219,"(52.0, 100.0]",Q4
36045,2020-05-16,111755,58,0,71,152,3214,0.42857142857142855,162.14285714285714,0.3834919498648191,145.08778769885654,"(52.0, 100.0]",Q4
36045,2020-05-17,111755,58,0,71,137,3351,0.42857142857142855,172.71428571428572,0.3834919498648191,154.54725579552212,"(52.0, 100.0]",Q4
36045,2020-05-18,111755,58,0,71,90,3441,0.42857142857142855,179.0,0.3834919498648191,160.17180439353945,"(52.0, 100.0]",Q4
36045,2020-05-19,111755,58,0,71,64,3505,0.42857142857142855,176.71428571428572,0.3834919498648191,158.1265139942604,"(52.0, 100.0]",Q4
36045,2020-05-20,111755,58,0,71,324,3829,0.2857142857142857,208.14285714285714,0.25566129990987935,186.24925698434714,"(52.0, 100.0]",Q4
36045,2020-05-21,111755,58,1,72,319,4148,0.14285714285714285,189.0,0.12783064995493967,169.11994989038521,"(52.0, 100.0]",Q4
36045,2020-05-22,111755,58,0,72,331,4479,0.14285714285714285,202.42857142857142,0.12783064995493967,181.13603098614954,"(52.0, 100.0]",Q4
36045,2020-05-23,111755,58,0,72,305,4784,0.14285714285714285,224.28571428571428,0.12783064995493967,200.69412042925532,"(52.0, 100.0]",Q4
36045,2020-05-24,111755,58,0,72,107,4891,0.14285714285714285,220.0,0.12783064995493967,196.85920093060716,"(52.0, 100.0]",Q4
36045,2020-05-25,111755,58,0,72,71,4962,0.14285714285714285,217.28571428571428,0.12783064995493967,194.43041858146327,"(52.0, 100.0]",Q4
36045,2020-05-26,111755,58,0,72,97,5059,0.14285714285714285,222.0,0.12783064995493967,198.64883002997627,"(52.0, 100.0]",Q4
36045,2020-05-27,111755,58,0,72,136,5195,0.14285714285714285,195.14285714285714,0.12783064995493967,174.61666783844763,"(52.0, 100.0]",Q4
36045,2020-05-28,111755,58,2,74,400,5595,0.2857142857142857,206.71428571428572,0.25566129990987935,184.97095048479773,"(52.0, 100.0]",Q4
36045,2020-05-29,111755,58,0,74,227,5822,0.2857142857142857,191.85714285714286,0.25566129990987935,171.67656288948402,"(52.0, 100.0]",Q4
36045,2020-05-30,111755,58,0,74,280,6102,0.2857142857142857,188.28571428571428,0.25566129990987935,168.48079664061052,"(52.0, 100.0]",Q4
36045,2020-05-31,111755,58,0,74,256,6358,0.2857142857142857,209.57142857142858,0.25566129990987935,187.52756348389656,"(52.0, 100.0]",Q4
36045,2020-06-01,111755,58,0,74,228,6586,0.2857142857142857,232.0,0.25566129990987935,207.5969755268221,"(52.0, 100.0]",Q4
36045,2020-06-02,111755,58,0,74,256,6842,0.2857142857142857,254.71428571428572,0.25566129990987935,227.92204886965746,"(52.0, 100.0]",Q4
36045,2020-06-03,111755,58,0,74,253,7095,0.2857142857142857,271.42857142857144,0.25566129990987935,242.87823491438544,"(52.0, 100.0]",Q4
36045,2020-06-04,111755,58,1,75,482,7577,0.14285714285714285,283.14285714285717,0.12783064995493967,253.3603482106905,"(52.0, 100.0]",Q4
36045,2020-06-05,111755,58,0,75,315,7892,0.14285714285714285,295.7142857142857,0.12783064995493967,264.6094454067252,"(52.0, 100.0]",Q4
36045,2020-06-06,111755,58,2,77,275,8167,0.42857142857142855,295.0,0.3834919498648191,263.97029215695045,"(52.0, 100.0]",Q4
36045,2020-06-07,111755,58,1,78,374,8541,0.5714285714285714,311.85714285714283,0.5113225998197587,279.0543088516334,"(52.0, 100.0]",Q4
36047,2020-03-02,2582830,99,0,0,0,0,0.0,0.0,0.0,0.0,"(52.0, 100.0]",Q4
36047,2020-03-03,2582830,99,0,0,2,2,0.0,2.0,0.0,0.07743444206548632,"(52.0, 100.0]",Q4
36047,2020-03-04,2582830,99,1,1,4,6,1.0,4.0,0.03871722103274316,0.15486888413097263,"(52.0, 100.0]",Q4
36047,2020-03-05,2582830,99,0,1,7,13,0.0,7.0,0.0,0.2710205472292021,"(52.0, 100.0]",Q4
36047,2020-03-06,2582830,99,3,4,12,25,3.0,12.0,0.11615166309822945,0.4646066523929178,"(52.0, 100.0]",Q4
36047,2020-03-07,2582830,99,0,4,9,34,0.0,9.0,0.0,0.3484549892946884,"(52.0, 100.0]",Q4
36047,2020-03-08,2582830,99,2,6,10,44,0.8571428571428571,6.285714285714286,0.03318618945663698,0.24336538934867125,"(52.0, 100.0]",Q4
36047,2020-03-09,2582830,99,1,7,31,75,1.0,10.714285714285714,0.03871722103274316,0.41482736820796234,"(52.0, 100.0]",Q4
36047,2020-03-10,2582830,99,7,14,29,104,2.0,14.571428571428571,0.07743444206548632,0.5641652207628288,"(52.0, 100.0]",Q4
36047,2020-03-11,2582830,99,2,16,24,128,2.142857142857143,17.428571428571427,0.08296547364159247,0.674785852284952,"(52.0, 100.0]",Q4
36047,2020-03-12,2582830,99,8,24,59,187,3.2857142857142856,24.857142857142858,0.12721372625044178,0.9623994942424727,"(52.0, 100.0]",Q4
36047,2020-03-13,2582830,99,17,41,136,323,5.285714285714286,42.57142857142857,0.2046481683159281,1.648247409679637,"(52.0, 100.0]",Q4
36047,2020-03-14,2582830,99,17,58,99,422,7.714285714285714,55.42857142857143,0.2986757051097329,2.1460402515291923,"(52.0, 100.0]",Q4
36047,2020-03-15,2582830,99,26,84,166,588,11.142857142857142,77.71428571428571,0.4314204629362809,3.0088811774017534,"(52.0, 100.0]",Q4
36047,2020-03-16,2582830,99,39,123,171,759,16.571428571428573,97.71428571428571,0.6415996628283153,3.7832255980566165,"(52.0, 100.0]",Q4
36047,2020-03-17,2582830,99,264,387,741,1500,53.285714285714285,199.42857142857142,2.0630747778875995,7.7213200802442055,"(52.0, 100.0]",Q4
36047,2020-03-18,2582830,99,273,660,795,2295,92.0,309.57142857142856,3.56198433501237,11.985745425422058,"(52.0, 100.0]",Q4
36047,2020-03-19,2582830,99,674,1334,1553,3848,187.14285714285714,523.0,7.245651364699076,20.24910660012467,"(52.0, 100.0]",Q4
36047,2020-03-20,2582830,99,538,1872,1378,5226,261.57142857142856,700.4285714285714,10.127318815850387,27.118647817648526,"(52.0, 100.0]",Q4
36047,2020-03-21,2582830,99,893,2765,1941,7167,386.7142857142857,963.5714285714286,14.972502476519388,37.30680798083608,"(52.0, 100.0]",Q4
36047,2020-03-22,2582830,99,702,3467,1506,8673,483.2857142857143,1155.0,18.711479821967156,44.71839029281834,"(52.0, 100.0]",Q4
36047,2020-03-23,2582830,99,700,4167,1422,10095,577.7142857142857,1333.7142857142858,22.367491693773328,51.63771079452716,"(52.0, 100.0]",Q4
36047,2020-03-24,2582830,99,779,4946,1474,11569,651.2857142857143,1438.4285714285713,25.215972955468008,55.69195693981297,"(52.0, 100.0]",Q4
36047,2020-03-25,2582830,99,755,5701,1550,13119,720.1428571428571,1546.2857142857142,27.881930175151176,59.867885779773125,"(52.0, 100.0]",Q4
36047,2020-03-26,2582830,99,1106,6807,1905,15024,781.8571428571429,1596.5714285714287,30.27133581602904,61.8148088945625,"(52.0, 100.0]",Q4
36047,2020-03-27,2582830,99,1238,8045,2254,17278,881.8571428571429,1721.7142857142858,34.14305791930336,66.65999255523151,"(52.0, 100.0]",Q4
36047,2020-03-28,2582830,99,973,9018,1790,19068,893.2857142857143,1700.142857142857,34.58554044539185,65.82480678723947,"(52.0, 100.0]",Q4
36047,2020-03-29,2582830,99,1011,10029,1627,20695,937.4285714285714,1717.4285714285713,36.29462920240866,66.49406160794831,"(52.0, 100.0]",Q4
36047,2020-03-30,2582830,99,1888,11917,3113,23808,1107.142857142857,1959.0,42.86549471482278,75.84703600314384,"(52.0, 100.0]",Q4
36047,2020-03-31,2582830,99,1198,13115,2011,25819,1167.0,2035.7142857142858,45.18299694521126,78.81719995951285,"(52.0, 100.0]",Q4
36047,2020-04-01,2582830,99,1189,14304,2041,27860,1229.0,2105.8571428571427,47.583464649241336,81.53293646338096,"(52.0, 100.0]",Q4
36047,2020-04-02,2582830,99,1396,15700,2512,30372,1270.4285714285713,2192.5714285714284,49.187463806312124,84.8902726300774,"(52.0, 100.0]",Q4
36047,2020-04-03,2582830,99,1804,17504,3234,33606,1351.2857142857142,2332.5714285714284,52.31802767838821,90.31068357466145,"(52.0, 100.0]",Q4
36047,2020-04-04,2582830,99,1054,18558,1990,35596,1362.857142857143,2361.1428571428573,52.76604123605281,91.41688988988271,"(52.0, 100.0]",Q4
36047,2020-04-05,2582830,99,1144,19702,2013,37609,1381.857142857143,2416.285714285714,53.50166843567494,93.55186807825967,"(52.0, 100.0]",Q4
36047,2020-04-06,2582830,99,1177,20879,2245,39854,1280.2857142857142,2292.285714285714,49.56910498506345,88.75093267019952,"(52.0, 100.0]",Q4
36047,2020-04-07,2582830,99,1203,22082,2607,42461,1281.0,2377.4285714285716,49.596760142943985,92.0474274895588,"(52.0, 100.0]",Q4
36047,2020-04-08,2582830,99,1312,23394,2565,45026,1298.5714285714287,2452.285714285714,50.277077026805046,94.94568803543842,"(52.0, 100.0]",Q4
36047,2020-04-09,2582830,99,1321,24715,2578,47604,1287.857142857143,2461.714285714286,49.86224965859708,95.31073611946144,"(52.0, 100.0]",Q4
36047,2020-04-10,2582830,99,1528,26243,2887,50491,1248.4285714285713,2412.1428571428573,48.33568494359177,93.3914681625526,"(52.0, 100.0]",Q4
36047,2020-04-11,2582830,99,1228,27471,2670,53161,1273.2857142857142,2509.285714285714,49.29808443783425,97.15256963430478,"(52.0, 100.0]",Q4
36047,2020-04-12,2582830,99,933,28404,2029,55190,1243.142857142857,2511.5714285714284,48.131036775275845,97.24106613952247,"(52.0, 100.0]",Q4
36047,2020-04-13,2582830,99,902,29306,2055,57245,1203.857142857143,2484.4285714285716,46.61000309184665,96.19017014006232,"(52.0, 100.0]",Q4
36047,2020-04-14,2582830,99,2663,31969,5103,62348,1412.4285714285713,2841.0,54.685309192961654,109.99562495402328,"(52.0, 100.0]",Q4
36047,2020-04-15,2582830,99,1552,33521,3724,66072,1446.7142857142858,3006.5714285714284,56.01275677122713,116.40609055073034,"(52.0, 100.0]",Q4
36047,2020-04-16,2582830,99,1184,34705,3347,69419,1427.142857142857,3116.4285714285716,55.25500544530059,120.65945383275599,"(52.0, 100.0]",Q4
36047,2020-04-17,2582830,99,1058,35763,3016,72435,1360.0,3134.8571428571427,52.6554206045307,121.37295690607367,"(52.0, 100.0]",Q4
36047,2020-04-18,2582830,99,719,36482,2390,74825,1287.2857142857142,3094.8571428571427,49.84012553229265,119.82426806476396,"(52.0, 100.0]",Q4
36047,2020-04-19,2582830,99,548,37030,1835,76660,1232.2857142857142,3067.1428571428573,47.710678375491774,118.75124793899936,"(52.0, 100.0]",Q4
36047,2020-04-20,2582830,99,664,37694,2300,78960,1198.2857142857142,3102.1428571428573,46.394292860378506,120.10635067514538,"(52.0, 100.0]",Q4
36047,2020-04-21,2582830,99,787,38481,2827,81787,930.2857142857143,2777.0,36.01807762360335,107.51772280792774,"(52.0, 100.0]",Q4
36047,2020-04-22,2582830,99,873,39354,3526,85313,833.2857142857143,2748.714285714286,32.26250718342726,106.42257855585872,"(52.0, 100.0]",Q4
36047,2020-04-23,2582830,99,1294,40648,5030,90343,849.0,2989.1428571428573,32.87092065679894,115.7313046984454,"(52.0, 100.0]",Q4
36047,2020-04-24,2582830,99,1012,41660,4021,94364,842.4285714285714,3132.714285714286,32.61649320429805,121.28999143243209,"(52.0, 100.0]",Q4
36047,2020-04-25,2582830,99,827,42487,3685,98049,857.8571428571429,3317.714285714286,33.21384461451752,128.45267732348958,"(52.0, 100.0]",Q4
36047,2020-04-26,2582830,99,527,43014,2684,100733,854.8571428571429,3439.0,33.09769295141929,133.14852313160372,"(52.0, 100.0]",Q4
36047,2020-04-27,2582830,99,573,43587,2940,103673,841.8571428571429,3530.4285714285716,32.59436907799363,136.68838334031167,"(52.0, 100.0]",Q4
36047,2020-04-28,2582830,99,649,44236,3873,107546,822.1428571428571,3679.8571428571427,31.831086720490976,142.4738423689187,"(52.0, 100.0]",Q4
36047,2020-04-29,2582830,99,636,44872,3944,111490,788.2857142857143,3739.5714285714284,30.52023223695382,144.78581356773108,"(52.0, 100.0]",Q4
36047,2020-04-30,2582830,99,647,45519,3927,115417,695.8571428571429,3582.0,26.941654807213133,138.685085739286,"(52.0, 100.0]",Q4
36047,2020-05-01,2582830,99,756,46275,4717,120134,659.2857142857143,3681.4285714285716,25.525710723729954,142.53468371625587,"(52.0, 100.0]",Q4
36047,2020-05-02,2582830,99,564,46839,3804,123938,621.7142857142857,3698.4285714285716,24.071049419214027,143.1928764738125,"(52.0, 100.0]",Q4
36047,2020-05-03,2582830,99,344,47183,2545,126483,595.5714285714286,3678.5714285714284,23.0588706407866,142.42406308473375,"(52.0, 100.0]",Q4
36047,2020-05-04,2582830,99,396,47579,3364,129847,570.2857142857143,3739.1428571428573,22.079878051815815,144.76922047300278,"(52.0, 100.0]",Q4
36047,2020-05-05,2582830,99,395,47974,3597,133444,534.0,3699.714285714286,20.674996031484845,143.24265575799748,"(52.0, 100.0]",Q4
36047,2020-05-06,2582830,99,576,48550,5284,138728,525.4285714285714,3891.1428571428573,20.343134136918476,150.65423806997973,"(52.0, 100.0]",Q4
36047,2020-05-07,2582830,99,448,48998,4582,143310,497.0,3984.714285714286,19.242458853273348,154.27706375232927,"(52.0, 100.0]",Q4
36047,2020-05-08,2582830,99,463,49461,4747,148057,455.14285714285717,3989.0,17.62186660147424,154.44299469961246,"(52.0, 100.0]",Q4
36047,2020-05-09,2582830,99,356,49817,3682,151739,425.42857142857144,3971.5714285714284,16.47141203364416,153.7682088473275,"(52.0, 100.0]",Q4
36047,2020-05-10,2582830,99,255,50072,2825,154564,412.7142857142857,4011.5714285714284,15.97915022337071,155.3168976886372,"(52.0, 100.0]",Q4
36047,2020-05-11,2582830,99,259,50331,2984,157548,393.14285714285717,3957.285714285714,15.221398897444168,153.21510568971686,"(52.0, 100.0]",Q4
36047,2020-05-12,2582830,99,336,50667,4615,162163,384.7142857142857,4102.714285714285,14.895068034453903,158.84569583419292,"(52.0, 100.0]",Q4
36047,2020-05-13,2582830,99,428,51095,6107,168270,363.57142857142856,4220.285714285715,14.07647536119019,163.39773482132833,"(52.0, 100.0]",Q4
36047,2020-05-14,2582830,99,486,51581,5741,174011,369.0,4385.857142857143,14.286654561082225,169.80820041803537,"(52.0, 100.0]",Q4
36047,2020-05-15,2582830,99,410,51991,5793,179804,361.42857142857144,4535.285714285715,13.993509887548598,175.59365944664242,"(52.0, 100.0]",Q4
36047,2020-05-16,2582830,99,307,52298,4377,184181,354.42857142857144,4634.571428571428,13.722489340319395,179.43772639203618,"(52.0, 100.0]",Q4
36047,2020-05-17,2582830,99,187,52485,3052,187233,344.7142857142857,4667.0,13.346379193144177,180.6932705598123,"(52.0, 100.0]",Q4
36047,2020-05-18,2582830,99,196,52681,4133,191366,335.7142857142857,4831.142857142857,12.99792420384949,187.04842584075828,"(52.0, 100.0]",Q4
36047,2020-05-19,2582830,99,208,52889,3890,195256,317.42857142857144,4727.571428571428,12.289952162107898,183.0384279480813,"(52.0, 100.0]",Q4
36047,2020-05-20,2582830,99,496,53385,7252,202508,327.14285714285717,4891.142857142857,12.66606230928312,189.37145910272287,"(52.0, 100.0]",Q4
36047,2020-05-21,2582830,99,254,53639,5372,207880,294.0,4838.428571428572,11.382862983626486,187.3305084511397,"(52.0, 100.0]",Q4
36047,2020-05-22,2582830,99,263,53902,6189,214069,273.0,4895.0,10.56980134193888,189.52079695527775,"(52.0, 100.0]",Q4
36047,2020-05-23,2582830,99,273,54175,6813,220882,268.14285714285717,5243.0,10.381746268351272,202.99438987467235,"(52.0, 100.0]",Q4
36047,2020-05-24,2582830,99,185,54360,4990,225872,267.85714285714283,5519.857142857143,10.370684205199058,213.7135290691661,"(52.0, 100.0]",Q4
36047,2020-05-25,2582830,99,200,54560,5214,231086,268.42857142857144,5674.285714285715,10.392808331503485,219.69257420293687,"(52.0, 100.0]",Q4
36047,2020-05-26,2582830,99,219,54779,5940,237026,270.0,5967.142857142857,10.453649678840652,231.0311889339545,"(52.0, 100.0]",Q4
36047,2020-05-27,2582830,99,368,55147,10938,247964,251.71428571428572,6493.714285714285,9.745677637099064,251.41857132348179,"(52.0, 100.0]",Q4
36047,2020-05-28,2582830,99,299,55446,10686,258650,258.14285714285717,7252.857142857143,9.99457405802384,280.81047311890995,"(52.0, 100.0]",Q4
36047,2020-05-29,2582830,99,281,55727,9619,268269,260.7142857142857,7742.857142857143,10.094132626393751,299.78191142495416,"(52.0, 100.0]",Q4
36047,2020-05-30,2582830,99,173,55900,7167,275436,246.42857142857142,7793.428571428572,9.541029468783135,301.7398966028957,"(52.0, 100.0]",Q4
36047,2020-05-31,2582830,99,153,56053,5765,281201,241.85714285714286,7904.142857142857,9.364036458347737,306.026446074378,"(52.0, 100.0]",Q4
36047,2020-06-01,2582830,99,189,56242,7500,288701,240.28571428571428,8230.714285714286,9.303195111010568,318.6703842573567,"(52.0, 100.0]",Q4
36047,2020-06-02,2582830,99,163,56405,7485,296186,232.28571428571428,8451.42857142857,8.993457342748624,327.21582804244065,"(52.0, 100.0]",Q4
36047,2020-06-03,2582830,99,182,56587,7880,304066,205.71428571428572,8014.571428571428,7.964685469592878,310.301933482708,"(52.0, 100.0]",Q4
36047,2020-06-04,2582830,99,183,56770,7659,311725,189.14285714285714,7582.142857142857,7.3230858067645626,293.55950090183467,"(52.0, 100.0]",Q4
36047,2020-06-05,2582830,99,196,56966,9370,321095,177.0,7546.571428571428,6.852948122795539,292.18227403938425,"(52.0, 100.0]",Q4
36047,2020-06-06,2582830,99,165,57131,8378,329473,175.85714285714286,7719.571428571428,6.808699870186689,298.8803532780488,"(52.0, 100.0]",Q4
36047,2020-06-07,2582830,99,129,57260,7254,336727,172.42857142857142,7932.285714285715,6.67595511236014,307.1160592948709,"(52.0, 100.0]",Q4
36049,2020-03-02,26447,19,0,0,0,0,0.0,0.0,0.0,0.0,"(3.999, 24.0]",Q1
36049,2020-03-03,26447,19,0,0,0,0,0.0,0.0,0.0,0.0,"(3.999, 24.0]",Q1
36049,2020-03-04,26447,19,0,0,0,0,0.0,0.0,0.0,0.0,"(3.999, 24.0]",Q1
36049,2020-03-05,26447,19,0,0,0,0,0.0,0.0,0.0,0.0,"(3.999, 24.0]",Q1
36049,2020-03-06,26447,19,0,0,0,0,0.0,0.0,0.0,0.0,"(3.999, 24.0]",Q1
36049,2020-03-07,26447,19,0,0,0,0,0.0,0.0,0.0,0.0,"(3.999, 24.0]",Q1
36049,2020-03-08,26447,19,0,0,0,0,0.0,0.0,0.0,0.0,"(3.999, 24.0]",Q1
36049,2020-03-09,26447,19,0,0,0,0,0.0,0.0,0.0,0.0,"(3.999, 24.0]",Q1
36049,2020-03-10,26447,19,0,0,0,0,0.0,0.0,0.0,0.0,"(3.999, 24.0]",Q1
36049,2020-03-11,26447,19,0,0,0,0,0.0,0.0,0.0,0.0,"(3.999, 24.0]",Q1
36049,2020-03-12,26447,19,0,0,0,0,0.0,0.0,0.0,0.0,"(3.999, 24.0]",Q1
36049,2020-03-13,26447,19,0,0,1,1,0.0,0.14285714285714285,0.0,0.5401638857229283,"(3.999, 24.0]",Q1
36049,2020-03-14,26447,19,0,0,0,1,0.0,0.14285714285714285,0.0,0.5401638857229283,"(3.999, 24.0]",Q1
36049,2020-03-15,26447,19,0,0,2,3,0.0,0.42857142857142855,0.0,1.620491657168785,"(3.999, 24.0]",Q1
36049,2020-03-16,26447,19,0,0,0,3,0.0,0.42857142857142855,0.0,1.620491657168785,"(3.999, 24.0]",Q1
36049,2020-03-17,26447,19,0,0,1,4,0.0,0.5714285714285714,0.0,2.160655542891713,"(3.999, 24.0]",Q1
36049,2020-03-18,26447,19,0,0,0,4,0.0,0.5714285714285714,0.0,2.160655542891713,"(3.999, 24.0]",Q1
36049,2020-03-19,26447,19,0,0,2,6,0.0,0.8571428571428571,0.0,3.24098331433757,"(3.999, 24.0]",Q1
36049,2020-03-20,26447,19,0,0,1,7,0.0,0.8571428571428571,0.0,3.24098331433757,"(3.999, 24.0]",Q1
36049,2020-03-21,26447,19,0,0,4,11,0.0,1.4285714285714286,0.0,5.401638857229284,"(3.999, 24.0]",Q1
36049,2020-03-22,26447,19,0,0,4,15,0.0,1.7142857142857142,0.0,6.48196662867514,"(3.999, 24.0]",Q1
36049,2020-03-23,26447,19,0,0,5,20,0.0,2.4285714285714284,0.0,9.182786057289782,"(3.999, 24.0]",Q1
36049,2020-03-24,26447,19,0,0,0,20,0.0,2.2857142857142856,0.0,8.642622171566853,"(3.999, 24.0]",Q1
36049,2020-03-25,26447,19,0,0,5,25,0.0,3.0,0.0,11.343441600181494,"(3.999, 24.0]",Q1
36049,2020-03-26,26447,19,0,0,5,30,0.0,3.4285714285714284,0.0,12.96393325735028,"(3.999, 24.0]",Q1
36049,2020-03-27,26447,19,0,0,6,36,0.0,4.142857142857143,0.0,15.664752685964924,"(3.999, 24.0]",Q1
36049,2020-03-28,26447,19,2,2,7,43,0.2857142857142857,4.571428571428571,1.0803277714458566,17.285244343133705,"(3.999, 24.0]",Q1
36049,2020-03-29,26447,19,0,2,16,59,0.2857142857142857,6.285714285714286,1.0803277714458566,23.767210971808844,"(3.999, 24.0]",Q1
36049,2020-03-30,26447,19,0,2,5,64,0.2857142857142857,6.285714285714286,1.0803277714458566,23.767210971808844,"(3.999, 24.0]",Q1
36049,2020-03-31,26447,19,0,2,3,67,0.2857142857142857,6.714285714285714,1.0803277714458566,25.38770262897763,"(3.999, 24.0]",Q1
36049,2020-04-01,26447,19,0,2,5,72,0.2857142857142857,6.714285714285714,1.0803277714458566,25.38770262897763,"(3.999, 24.0]",Q1
36049,2020-04-02,26447,19,0,2,5,77,0.2857142857142857,6.714285714285714,1.0803277714458566,25.38770262897763,"(3.999, 24.0]",Q1
36049,2020-04-03,26447,19,0,2,5,82,0.2857142857142857,6.571428571428571,1.0803277714458566,24.847538743254706,"(3.999, 24.0]",Q1
36049,2020-04-04,26447,19,1,3,19,101,0.14285714285714285,8.285714285714286,0.5401638857229283,31.329505371929848,"(3.999, 24.0]",Q1
36049,2020-04-05,26447,19,3,6,11,112,0.5714285714285714,7.571428571428571,2.160655542891713,28.6286859433152,"(3.999, 24.0]",Q1
36049,2020-04-06,26447,19,0,6,11,123,0.5714285714285714,8.428571428571429,2.160655542891713,31.869669257652774,"(3.999, 24.0]",Q1
36049,2020-04-07,26447,19,0,6,6,129,0.5714285714285714,8.857142857142858,2.160655542891713,33.49016091482156,"(3.999, 24.0]",Q1
36049,2020-04-08,26447,19,0,6,8,137,0.5714285714285714,9.285714285714286,2.160655542891713,35.11065257199034,"(3.999, 24.0]",Q1
36049,2020-04-09,26447,19,0,6,23,160,0.5714285714285714,11.857142857142858,2.160655542891713,44.83360251500305,"(3.999, 24.0]",Q1
36049,2020-04-10,26447,19,0,6,0,160,0.5714285714285714,11.142857142857142,2.160655542891713,42.13278308638841,"(3.999, 24.0]",Q1
36049,2020-04-11,26447,19,0,6,6,166,0.42857142857142855,9.285714285714286,1.620491657168785,35.11065257199034,"(3.999, 24.0]",Q1
36049,2020-04-12,26447,19,0,6,3,169,0.0,8.142857142857142,0.0,30.78934148620691,"(3.999, 24.0]",Q1
36049,2020-04-13,26447,19,1,7,11,180,0.14285714285714285,8.142857142857142,0.5401638857229283,30.78934148620691,"(3.999, 24.0]",Q1
36049,2020-04-14,26447,19,0,7,0,180,0.14285714285714285,7.285714285714286,0.5401638857229283,27.548358171869342,"(3.999, 24.0]",Q1
36049,2020-04-15,26447,19,1,8,7,187,0.2857142857142857,7.142857142857143,1.0803277714458566,27.008194286146416,"(3.999, 24.0]",Q1
36049,2020-04-16,26447,19,0,8,2,189,0.2857142857142857,4.142857142857143,1.0803277714458566,15.664752685964924,"(3.999, 24.0]",Q1
36049,2020-04-17,26447,19,0,8,0,189,0.2857142857142857,4.142857142857143,1.0803277714458566,15.664752685964924,"(3.999, 24.0]",Q1
36049,2020-04-18,26447,19,0,8,14,203,0.2857142857142857,5.285714285714286,1.0803277714458566,19.98606377174835,"(3.999, 24.0]",Q1
36049,2020-04-19,26447,19,1,9,7,210,0.42857142857142855,5.857142857142857,1.620491657168785,22.14671931464006,"(3.999, 24.0]",Q1
36049,2020-04-20,26447,19,0,9,1,211,0.2857142857142857,4.428571428571429,1.0803277714458566,16.74508045741078,"(3.999, 24.0]",Q1
36049,2020-04-21,26447,19,0,9,1,212,0.2857142857142857,4.571428571428571,1.0803277714458566,17.285244343133705,"(3.999, 24.0]",Q1
36049,2020-04-22,26447,19,0,9,8,220,0.14285714285714285,4.714285714285714,0.5401638857229283,17.825408228856634,"(3.999, 24.0]",Q1
36049,2020-04-23,26447,19,0,9,3,223,0.14285714285714285,4.857142857142857,0.5401638857229283,18.365572114579564,"(3.999, 24.0]",Q1
36049,2020-04-24,26447,19,0,9,41,264,0.14285714285714285,10.714285714285714,0.5401638857229283,40.51229142921962,"(3.999, 24.0]",Q1
36049,2020-04-25,26447,19,0,9,12,276,0.14285714285714285,10.428571428571429,0.5401638857229283,39.43196365777377,"(3.999, 24.0]",Q1
36049,2020-04-26,26447,19,0,9,14,290,0.0,11.428571428571429,0.0,43.21311085783427,"(3.999, 24.0]",Q1
36049,2020-04-27,26447,19,0,9,6,296,0.0,12.142857142857142,0.0,45.91393028644891,"(3.999, 24.0]",Q1
36049,2020-04-28,26447,19,0,9,4,300,0.0,12.571428571428571,0.0,47.53442194361769,"(3.999, 24.0]",Q1
36049,2020-04-29,26447,19,0,9,14,314,0.0,13.428571428571429,0.0,50.77540525795526,"(3.999, 24.0]",Q1
36049,2020-04-30,26447,19,0,9,4,318,0.0,13.571428571428571,0.0,51.31556914367819,"(3.999, 24.0]",Q1
36049,2020-05-01,26447,19,0,9,12,330,0.0,9.428571428571429,0.0,35.65081645771327,"(3.999, 24.0]",Q1
36049,2020-05-02,26447,19,0,9,1,331,0.0,7.857142857142857,0.0,29.709013714761056,"(3.999, 24.0]",Q1
36049,2020-05-03,26447,19,0,9,9,340,0.0,7.142857142857143,0.0,27.008194286146416,"(3.999, 24.0]",Q1
36049,2020-05-04,26447,19,0,9,6,346,0.0,7.142857142857143,0.0,27.008194286146416,"(3.999, 24.0]",Q1
36049,2020-05-05,26447,19,0,9,4,350,0.0,7.142857142857143,0.0,27.008194286146416,"(3.999, 24.0]",Q1
36049,2020-05-06,26447,19,1,10,25,375,0.14285714285714285,8.714285714285714,0.5401638857229283,32.949997029098625,"(3.999, 24.0]",Q1
36049,2020-05-07,26447,19,0,10,20,395,0.14285714285714285,11.0,0.5401638857229283,41.59261920066548,"(3.999, 24.0]",Q1
36049,2020-05-08,26447,19,1,11,85,480,0.2857142857142857,21.428571428571427,1.0803277714458566,81.02458285843925,"(3.999, 24.0]",Q1
36049,2020-05-09,26447,19,0,11,95,575,0.2857142857142857,34.857142857142854,1.0803277714458566,131.7999881163945,"(3.999, 24.0]",Q1
36049,2020-05-10,26447,19,0,11,65,640,0.2857142857142857,42.857142857142854,1.0803277714458566,162.0491657168785,"(3.999, 24.0]",Q1
36049,2020-05-11,26447,19,0,11,16,656,0.2857142857142857,44.285714285714285,1.0803277714458566,167.45080457410776,"(3.999, 24.0]",Q1
36049,2020-05-12,26447,19,0,11,10,666,0.2857142857142857,45.142857142857146,1.0803277714458566,170.69178788844536,"(3.999, 24.0]",Q1
36049,2020-05-13,26447,19,1,12,31,697,0.2857142857142857,46.0,1.0803277714458566,173.93277120278293,"(3.999, 24.0]",Q1
36049,2020-05-14,26447,19,0,12,236,933,0.2857142857142857,76.85714285714286,1.0803277714458566,290.6081705189354,"(3.999, 24.0]",Q1
36049,2020-05-15,26447,19,1,13,108,1041,0.2857142857142857,80.14285714285714,1.0803277714458566,303.0319398905628,"(3.999, 24.0]",Q1
36049,2020-05-16,26447,19,3,16,62,1103,0.7142857142857143,75.42857142857143,2.700819428614642,285.20653166170615,"(3.999, 24.0]",Q1
36049,2020-05-17,26447,19,1,17,123,1226,0.8571428571428571,83.71428571428571,3.24098331433757,316.536037033636,"(3.999, 24.0]",Q1
36049,2020-05-18,26447,19,1,18,27,1253,1.0,85.28571428571429,3.781147200060498,322.47783977658827,"(3.999, 24.0]",Q1
36049,2020-05-19,26447,19,0,18,34,1287,1.0,88.71428571428571,3.781147200060498,335.4417730339385,"(3.999, 24.0]",Q1
36049,2020-05-20,26447,19,0,18,176,1463,0.8571428571428571,109.42857142857143,3.24098331433757,413.7655364637631,"(3.999, 24.0]",Q1
36049,2020-05-21,26447,19,1,19,101,1564,1.0,90.14285714285714,3.781147200060498,340.84341189116776,"(3.999, 24.0]",Q1
36049,2020-05-22,26447,19,0,19,62,1626,0.8571428571428571,83.57142857142857,3.24098331433757,315.9958731479131,"(3.999, 24.0]",Q1
36049,2020-05-23,26447,19,0,19,77,1703,0.42857142857142855,85.71428571428571,1.620491657168785,324.098331433757,"(3.999, 24.0]",Q1
36049,2020-05-24,26447,19,0,19,43,1746,0.2857142857142857,74.28571428571429,1.0803277714458566,280.88522057592274,"(3.999, 24.0]",Q1
36049,2020-05-25,26447,19,1,20,25,1771,0.2857142857142857,74.0,1.0803277714458566,279.8048928044769,"(3.999, 24.0]",Q1
36049,2020-05-26,26447,19,0,20,22,1793,0.2857142857142857,72.28571428571429,1.0803277714458566,273.3229261758018,"(3.999, 24.0]",Q1
36049,2020-05-27,26447,19,0,20,34,1827,0.2857142857142857,52.0,1.0803277714458566,196.61965440314592,"(3.999, 24.0]",Q1
36049,2020-05-28,26447,19,0,20,148,1975,0.14285714285714285,58.714285714285715,0.5401638857229283,222.00735703212354,"(3.999, 24.0]",Q1
36049,2020-05-29,26447,19,0,20,77,2052,0.14285714285714285,60.857142857142854,0.5401638857229283,230.10981531796747,"(3.999, 24.0]",Q1
36049,2020-05-30,26447,19,0,20,51,2103,0.14285714285714285,57.142857142857146,0.5401638857229283,216.06555428917133,"(3.999, 24.0]",Q1
36049,2020-05-31,26447,19,0,20,64,2167,0.14285714285714285,60.142857142857146,0.5401638857229283,227.40899588935284,"(3.999, 24.0]",Q1
36049,2020-06-01,26447,19,0,20,70,2237,0.0,66.57142857142857,0.0,251.7163707468846,"(3.999, 24.0]",Q1
36049,2020-06-02,26447,19,0,20,93,2330,0.0,76.71428571428571,0.0,290.06800663321246,"(3.999, 24.0]",Q1
36049,2020-06-03,26447,19,0,20,72,2402,0.0,82.14285714285714,0.0,310.5942342906838,"(3.999, 24.0]",Q1
36049,2020-06-04,26447,19,0,20,178,2580,0.0,86.42857142857143,0.0,326.7991508623717,"(3.999, 24.0]",Q1
36049,2020-06-05,26447,19,0,20,109,2689,0.0,91.0,0.0,344.08439520550536,"(3.999, 24.0]",Q1
36049,2020-06-06,26447,19,0,20,59,2748,0.0,92.14285714285714,0.0,348.40570629128877,"(3.999, 24.0]",Q1
36049,2020-06-07,26447,19,0,20,115,2863,0.0,99.42857142857143,0.0,375.95406446315815,"(3.999, 24.0]",Q1
36051,2020-03-02,63227,28,0,0,0,0,0.0,0.0,0.0,0.0,"(24.0, 37.5]",Q2
36051,2020-03-03,63227,28,0,0,0,0,0.0,0.0,0.0,0.0,"(24.0, 37.5]",Q2
36051,2020-03-04,63227,28,0,0,0,0,0.0,0.0,0.0,0.0,"(24.0, 37.5]",Q2
36051,2020-03-05,63227,28,0,0,0,0,0.0,0.0,0.0,0.0,"(24.0, 37.5]",Q2
36051,2020-03-06,63227,28,0,0,0,0,0.0,0.0,0.0,0.0,"(24.0, 37.5]",Q2
36051,2020-03-07,63227,28,0,0,0,0,0.0,0.0,0.0,0.0,"(24.0, 37.5]",Q2
36051,2020-03-08,63227,28,0,0,0,0,0.0,0.0,0.0,0.0,"(24.0, 37.5]",Q2
36051,2020-03-09,63227,28,0,0,0,0,0.0,0.0,0.0,0.0,"(24.0, 37.5]",Q2
36051,2020-03-10,63227,28,0,0,1,1,0.0,0.14285714285714285,0.0,0.22594325661053483,"(24.0, 37.5]",Q2
36051,2020-03-11,63227,28,0,0,0,1,0.0,0.14285714285714285,0.0,0.22594325661053483,"(24.0, 37.5]",Q2
36051,2020-03-12,63227,28,0,0,0,1,0.0,0.14285714285714285,0.0,0.22594325661053483,"(24.0, 37.5]",Q2
36051,2020-03-13,63227,28,0,0,0,1,0.0,0.14285714285714285,0.0,0.22594325661053483,"(24.0, 37.5]",Q2
36051,2020-03-14,63227,28,0,0,0,1,0.0,0.14285714285714285,0.0,0.22594325661053483,"(24.0, 37.5]",Q2
36051,2020-03-15,63227,28,0,0,0,1,0.0,0.14285714285714285,0.0,0.22594325661053483,"(24.0, 37.5]",Q2
36051,2020-03-16,63227,28,0,0,0,1,0.0,0.14285714285714285,0.0,0.22594325661053483,"(24.0, 37.5]",Q2
36051,2020-03-17,63227,28,0,0,4,5,0.0,0.5714285714285714,0.0,0.9037730264421393,"(24.0, 37.5]",Q2
36051,2020-03-18,63227,28,0,0,5,10,0.0,1.2857142857142858,0.0,2.0334893094948137,"(24.0, 37.5]",Q2
36051,2020-03-19,63227,28,1,1,11,21,0.14285714285714285,2.857142857142857,0.22594325661053483,4.5188651322106965,"(24.0, 37.5]",Q2
36051,2020-03-20,63227,28,1,2,13,34,0.2857142857142857,4.714285714285714,0.45188651322106965,7.456127468147649,"(24.0, 37.5]",Q2
36051,2020-03-21,63227,28,0,2,5,39,0.2857142857142857,5.428571428571429,0.45188651322106965,8.585843751200324,"(24.0, 37.5]",Q2
36051,2020-03-22,63227,28,1,3,3,42,0.42857142857142855,5.857142857142857,0.6778297698316045,9.263673521031928,"(24.0, 37.5]",Q2
36051,2020-03-23,63227,28,0,3,1,43,0.42857142857142855,6.0,0.6778297698316045,9.489616777642462,"(24.0, 37.5]",Q2
36051,2020-03-24,63227,28,0,3,9,52,0.42857142857142855,6.714285714285714,0.6778297698316045,10.619333060695137,"(24.0, 37.5]",Q2
36051,2020-03-25,63227,28,0,3,15,67,0.42857142857142855,8.142857142857142,0.6778297698316045,12.878765626800483,"(24.0, 37.5]",Q2
36051,2020-03-26,63227,28,0,3,8,75,0.2857142857142857,7.714285714285714,0.45188651322106965,12.200935856968881,"(24.0, 37.5]",Q2
36051,2020-03-27,63227,28,2,5,11,86,0.42857142857142855,7.428571428571429,0.6778297698316045,11.749049343747812,"(24.0, 37.5]",Q2
36051,2020-03-28,63227,28,5,10,17,103,1.1428571428571428,9.142857142857142,1.8075460528842786,14.460368423074229,"(24.0, 37.5]",Q2
36051,2020-03-29,63227,28,2,12,10,113,1.2857142857142858,10.142857142857142,2.0334893094948137,16.04197121934797,"(24.0, 37.5]",Q2
36051,2020-03-30,63227,28,1,13,10,123,1.4285714285714286,11.428571428571429,2.2594325661053483,18.075460528842786,"(24.0, 37.5]",Q2
36051,2020-03-31,63227,28,1,14,24,147,1.5714285714285714,13.571428571428571,2.4853758227158833,21.46460937800081,"(24.0, 37.5]",Q2
36051,2020-04-01,63227,28,0,14,17,164,1.5714285714285714,13.857142857142858,2.4853758227158833,21.91649589122188,"(24.0, 37.5]",Q2
36051,2020-04-02,63227,28,2,16,12,176,1.8571428571428572,14.428571428571429,2.937262335936953,22.820268917664016,"(24.0, 37.5]",Q2
36051,2020-04-03,63227,28,2,18,18,194,1.8571428571428572,15.428571428571429,2.937262335936953,24.401871713937762,"(24.0, 37.5]",Q2
36051,2020-04-04,63227,28,1,19,27,221,1.2857142857142858,16.857142857142858,2.0334893094948137,26.66130428004311,"(24.0, 37.5]",Q2
36051,2020-04-05,63227,28,3,22,14,235,1.4285714285714286,17.428571428571427,2.2594325661053483,27.565077306485247,"(24.0, 37.5]",Q2
36051,2020-04-06,63227,28,1,23,18,253,1.4285714285714286,18.571428571428573,2.2594325661053483,29.37262335936953,"(24.0, 37.5]",Q2
36051,2020-04-07,63227,28,2,25,23,276,1.5714285714285714,18.428571428571427,2.4853758227158833,29.14668010275899,"(24.0, 37.5]",Q2
36051,2020-04-08,63227,28,1,26,17,293,1.7142857142857142,18.428571428571427,2.711319079326418,29.14668010275899,"(24.0, 37.5]",Q2
36051,2020-04-09,63227,28,3,29,26,319,1.8571428571428572,20.428571428571427,2.937262335936953,32.30988569530648,"(24.0, 37.5]",Q2
36051,2020-04-10,63227,28,1,30,7,326,1.7142857142857142,18.857142857142858,2.711319079326418,29.824509872590596,"(24.0, 37.5]",Q2
36051,2020-04-11,63227,28,0,30,6,332,1.5714285714285714,15.857142857142858,2.4853758227158833,25.079701483769366,"(24.0, 37.5]",Q2
36051,2020-04-12,63227,28,0,30,5,337,1.1428571428571428,14.571428571428571,1.8075460528842786,23.04621217427455,"(24.0, 37.5]",Q2
36051,2020-04-13,63227,28,1,31,20,357,1.1428571428571428,14.857142857142858,1.8075460528842786,23.498098687495624,"(24.0, 37.5]",Q2
36051,2020-04-14,63227,28,0,31,8,365,0.8571428571428571,12.714285714285714,1.355659539663209,20.108949838337598,"(24.0, 37.5]",Q2
36051,2020-04-15,63227,28,1,32,8,373,0.8571428571428571,11.428571428571429,1.355659539663209,18.075460528842786,"(24.0, 37.5]",Q2
36051,2020-04-16,63227,28,2,34,18,391,0.7142857142857143,10.285714285714286,1.1297162830526741,16.26791447595851,"(24.0, 37.5]",Q2
36051,2020-04-17,63227,28,3,37,20,411,1.0,12.142857142857142,1.5816027962737438,19.20517681189546,"(24.0, 37.5]",Q2
36051,2020-04-18,63227,28,2,39,30,441,1.2857142857142858,15.571428571428571,2.0334893094948137,24.627814970548297,"(24.0, 37.5]",Q2
36051,2020-04-19,63227,28,0,39,7,448,1.2857142857142858,15.857142857142858,2.0334893094948137,25.079701483769366,"(24.0, 37.5]",Q2
36051,2020-04-20,63227,28,0,39,21,469,1.1428571428571428,16.0,1.8075460528842786,25.3056447403799,"(24.0, 37.5]",Q2
36051,2020-04-21,63227,28,0,39,15,484,1.1428571428571428,17.0,1.8075460528842786,26.887247536653646,"(24.0, 37.5]",Q2
36051,2020-04-22,63227,28,2,41,22,506,1.2857142857142858,19.0,2.0334893094948137,30.05045312920113,"(24.0, 37.5]",Q2
36051,2020-04-23,63227,28,3,44,54,560,1.4285714285714286,24.142857142857142,2.2594325661053483,38.184410367180384,"(24.0, 37.5]",Q2
36051,2020-04-24,63227,28,14,58,295,855,3.0,63.42857142857143,4.744808388821231,100.31880593507746,"(24.0, 37.5]",Q2
36051,2020-04-25,63227,28,2,60,61,916,3.0,67.85714285714286,4.744808388821231,107.32304689000404,"(24.0, 37.5]",Q2
36051,2020-04-26,63227,28,2,62,15,931,3.2857142857142856,69.0,5.1966949020423,109.13059294288831,"(24.0, 37.5]",Q2
36051,2020-04-27,63227,28,3,65,24,955,3.7142857142857144,69.42857142857143,5.874524671873906,109.80842271271993,"(24.0, 37.5]",Q2
36051,2020-04-28,63227,28,2,67,36,991,4.0,72.42857142857143,6.326411185094975,114.55323110154117,"(24.0, 37.5]",Q2
36051,2020-04-29,63227,28,2,69,34,1025,4.0,74.14285714285714,6.326411185094975,117.26455018086757,"(24.0, 37.5]",Q2
36051,2020-04-30,63227,28,4,73,43,1068,4.142857142857143,72.57142857142857,6.55235444170551,114.77917435815169,"(24.0, 37.5]",Q2
36051,2020-05-01,63227,28,3,76,44,1112,2.5714285714285716,36.714285714285715,4.066978618989627,58.06741694890746,"(24.0, 37.5]",Q2
36051,2020-05-02,63227,28,7,83,52,1164,3.2857142857142856,35.42857142857143,5.1966949020423,56.03392763941264,"(24.0, 37.5]",Q2
36051,2020-05-03,63227,28,2,85,26,1190,3.2857142857142856,37.0,5.1966949020423,58.519303462128526,"(24.0, 37.5]",Q2
36051,2020-05-04,63227,28,1,86,52,1242,3.0,41.0,4.744808388821231,64.84571464722349,"(24.0, 37.5]",Q2
36051,2020-05-05,63227,28,3,89,52,1294,3.142857142857143,43.285714285714285,4.970751645431767,68.46080675299206,"(24.0, 37.5]",Q2
36051,2020-05-06,63227,28,6,95,100,1394,3.7142857142857144,52.714285714285715,5.874524671873906,83.37306168928735,"(24.0, 37.5]",Q2
36051,2020-05-07,63227,28,5,100,56,1450,3.857142857142857,54.57142857142857,6.1004679284844405,86.3103240252243,"(24.0, 37.5]",Q2
36051,2020-05-08,63227,28,1,101,49,1499,3.5714285714285716,55.285714285714285,5.648581415263371,87.44004030827698,"(24.0, 37.5]",Q2
36051,2020-05-09,63227,28,1,102,58,1557,2.7142857142857144,56.142857142857146,4.292921875600162,88.79569984794018,"(24.0, 37.5]",Q2
36051,2020-05-10,63227,28,0,102,46,1603,2.4285714285714284,59.0,3.8410353623790923,93.31456498015089,"(24.0, 37.5]",Q2
36051,2020-05-11,63227,28,0,102,180,1783,2.2857142857142856,77.28571428571429,3.615092105768557,122.23530182629936,"(24.0, 37.5]",Q2
36051,2020-05-12,63227,28,1,103,197,1980,2.0,98.0,3.1632055925474876,154.99707403482688,"(24.0, 37.5]",Q2
36051,2020-05-13,63227,28,3,106,113,2093,1.5714285714285714,99.85714285714286,2.4853758227158833,157.93433637076384,"(24.0, 37.5]",Q2
36051,2020-05-14,63227,28,0,106,76,2169,0.8571428571428571,102.71428571428571,1.355659539663209,162.45320150297454,"(24.0, 37.5]",Q2
36051,2020-05-15,63227,28,1,107,75,2244,0.8571428571428571,106.42857142857143,1.355659539663209,168.32772617484846,"(24.0, 37.5]",Q2
36051,2020-05-16,63227,28,3,110,77,2321,1.1428571428571428,109.14285714285714,1.8075460528842786,172.6206480504486,"(24.0, 37.5]",Q2
36051,2020-05-17,63227,28,0,110,50,2371,1.1428571428571428,109.71428571428571,1.8075460528842786,173.52442107689075,"(24.0, 37.5]",Q2
36051,2020-05-18,63227,28,1,111,67,2438,1.2857142857142858,93.57142857142857,2.0334893094948137,147.99283307990032,"(24.0, 37.5]",Q2
36051,2020-05-19,63227,28,0,111,95,2533,1.1428571428571428,79.0,1.8075460528842786,124.94662090562576,"(24.0, 37.5]",Q2
36051,2020-05-20,63227,28,3,114,105,2638,1.1428571428571428,77.85714285714286,1.8075460528842786,123.13907485274149,"(24.0, 37.5]",Q2
36051,2020-05-21,63227,28,0,114,75,2713,1.1428571428571428,77.71428571428571,1.8075460528842786,122.91313159613095,"(24.0, 37.5]",Q2
36051,2020-05-22,63227,28,0,114,84,2797,1.0,79.0,1.5816027962737438,124.94662090562576,"(24.0, 37.5]",Q2
36051,2020-05-23,63227,28,0,114,65,2862,0.5714285714285714,77.28571428571429,0.9037730264421393,122.23530182629936,"(24.0, 37.5]",Q2
36051,2020-05-24,63227,28,1,115,196,3058,0.7142857142857143,98.14285714285714,1.1297162830526741,155.22301729143743,"(24.0, 37.5]",Q2
36051,2020-05-25,63227,28,3,118,74,3132,1.0,99.14285714285714,1.5816027962737438,156.80462008771116,"(24.0, 37.5]",Q2
36051,2020-05-26,63227,28,0,118,69,3201,1.0,95.42857142857143,1.5816027962737438,150.93009541583726,"(24.0, 37.5]",Q2
36051,2020-05-27,63227,28,0,118,129,3330,0.5714285714285714,98.85714285714286,0.9037730264421393,156.35273357449012,"(24.0, 37.5]",Q2
36051,2020-05-28,63227,28,0,118,122,3452,0.5714285714285714,105.57142857142857,0.9037730264421393,166.97206663518523,"(24.0, 37.5]",Q2
36051,2020-05-29,63227,28,0,118,107,3559,0.5714285714285714,108.85714285714286,0.9037730264421393,172.16876153722754,"(24.0, 37.5]",Q2
36051,2020-05-30,63227,28,1,119,128,3687,0.7142857142857143,117.85714285714286,1.1297162830526741,186.40318670369123,"(24.0, 37.5]",Q2
36051,2020-05-31,63227,28,0,119,136,3823,0.5714285714285714,109.28571428571429,0.9037730264421393,172.84659130705916,"(24.0, 37.5]",Q2
36051,2020-06-01,63227,28,0,119,218,4041,0.14285714285714285,129.85714285714286,0.22594325661053483,205.38242025897614,"(24.0, 37.5]",Q2
36051,2020-06-02,63227,28,1,120,233,4274,0.2857142857142857,153.28571428571428,0.45188651322106965,242.43711434310384,"(24.0, 37.5]",Q2
36051,2020-06-03,63227,28,0,120,172,4446,0.2857142857142857,159.42857142857142,0.45188651322106965,252.15267437735685,"(24.0, 37.5]",Q2
36051,2020-06-04,63227,28,1,121,263,4709,0.42857142857142855,179.57142857142858,0.6778297698316045,284.0106735594423,"(24.0, 37.5]",Q2
36051,2020-06-05,63227,28,0,121,167,4876,0.42857142857142855,188.14285714285714,0.6778297698316045,297.5672689560744,"(24.0, 37.5]",Q2
36051,2020-06-06,63227,28,0,121,133,5009,0.2857142857142857,188.85714285714286,0.45188651322106965,298.69698523912706,"(24.0, 37.5]",Q2
36051,2020-06-07,63227,28,0,121,177,5186,0.2857142857142857,194.71428571428572,0.45188651322106965,307.960658760159,"(24.0, 37.5]",Q2
36053,2020-03-02,70795,14,0,0,0,0,0.0,0.0,0.0,0.0,"(3.999, 24.0]",Q1
36053,2020-03-03,70795,14,0,0,0,0,0.0,0.0,0.0,0.0,"(3.999, 24.0]",Q1
36053,2020-03-04,70795,14,0,0,0,0,0.0,0.0,0.0,0.0,"(3.999, 24.0]",Q1
36053,2020-03-05,70795,14,0,0,0,0,0.0,0.0,0.0,0.0,"(3.999, 24.0]",Q1
36053,2020-03-06,70795,14,0,0,0,0,0.0,0.0,0.0,0.0,"(3.999, 24.0]",Q1
36053,2020-03-07,70795,14,0,0,0,0,0.0,0.0,0.0,0.0,"(3.999, 24.0]",Q1
36053,2020-03-08,70795,14,0,0,0,0,0.0,0.0,0.0,0.0,"(3.999, 24.0]",Q1
36053,2020-03-09,70795,14,0,0,0,0,0.0,0.0,0.0,0.0,"(3.999, 24.0]",Q1
36053,2020-03-10,70795,14,0,0,0,0,0.0,0.0,0.0,0.0,"(3.999, 24.0]",Q1
36053,2020-03-11,70795,14,0,0,0,0,0.0,0.0,0.0,0.0,"(3.999, 24.0]",Q1
36053,2020-03-12,70795,14,0,0,0,0,0.0,0.0,0.0,0.0,"(3.999, 24.0]",Q1
36053,2020-03-13,70795,14,0,0,1,1,0.0,0.14285714285714285,0.0,0.2017898762019109,"(3.999, 24.0]",Q1
36053,2020-03-14,70795,14,0,0,1,2,0.0,0.2857142857142857,0.0,0.4035797524038218,"(3.999, 24.0]",Q1
36053,2020-03-15,70795,14,0,0,1,3,0.0,0.42857142857142855,0.0,0.6053696286057328,"(3.999, 24.0]",Q1
36053,2020-03-16,70795,14,0,0,1,4,0.0,0.5714285714285714,0.0,0.8071595048076436,"(3.999, 24.0]",Q1
36053,2020-03-17,70795,14,0,0,0,4,0.0,0.5714285714285714,0.0,0.8071595048076436,"(3.999, 24.0]",Q1
36053,2020-03-18,70795,14,0,0,7,11,0.0,1.5714285714285714,0.0,2.21968863822102,"(3.999, 24.0]",Q1
36053,2020-03-19,70795,14,0,0,4,15,0.0,2.142857142857143,0.0,3.0268481430286642,"(3.999, 24.0]",Q1
36053,2020-03-20,70795,14,0,0,9,24,0.0,3.2857142857142856,0.0,4.641167152643952,"(3.999, 24.0]",Q1
36053,2020-03-21,70795,14,1,1,9,33,0.14285714285714285,4.428571428571429,0.2017898762019109,6.25548616225924,"(3.999, 24.0]",Q1
36053,2020-03-22,70795,14,3,4,14,47,0.5714285714285714,6.285714285714286,0.8071595048076436,8.87875455288408,"(3.999, 24.0]",Q1
36053,2020-03-23,70795,14,1,5,10,57,0.7142857142857143,7.571428571428571,1.0089493810095547,10.69486343870128,"(3.999, 24.0]",Q1
36053,2020-03-24,70795,14,2,7,15,72,1.0,9.714285714285714,1.4125291334133767,13.721711581729943,"(3.999, 24.0]",Q1
36053,2020-03-25,70795,14,2,9,28,100,1.2857142857142858,12.714285714285714,1.8161088858171988,17.959298981970075,"(3.999, 24.0]",Q1
36053,2020-03-26,70795,14,8,17,23,123,2.4285714285714284,15.428571428571429,3.430427895432486,21.793306629806384,"(3.999, 24.0]",Q1
36053,2020-03-27,70795,14,2,19,28,151,2.7142857142857144,18.142857142857142,3.834007647836308,25.627314277642693,"(3.999, 24.0]",Q1
36053,2020-03-28,70795,14,5,24,34,185,3.2857142857142856,21.714285714285715,4.641167152643952,30.672061182690463,"(3.999, 24.0]",Q1
36053,2020-03-29,70795,14,10,34,30,215,4.285714285714286,24.0,6.0536962860573285,33.90069920192104,"(3.999, 24.0]",Q1
36053,2020-03-30,70795,14,7,41,39,254,5.142857142857143,28.142857142857142,7.264435543268795,39.75260561177645,"(3.999, 24.0]",Q1
36053,2020-03-31,70795,14,10,51,55,309,6.285714285714286,33.857142857142854,8.87875455288408,47.82420065985289,"(3.999, 24.0]",Q1
36053,2020-04-01,70795,14,9,60,67,376,7.285714285714286,39.42857142857143,10.291283686297458,55.694005831727424,"(3.999, 24.0]",Q1
36053,2020-04-02,70795,14,10,70,70,446,7.571428571428571,46.142857142857146,10.69486343870128,65.17813001321724,"(3.999, 24.0]",Q1
36053,2020-04-03,70795,14,4,74,20,466,7.857142857142857,45.0,11.098443191105101,63.56381100360195,"(3.999, 24.0]",Q1
36053,2020-04-04,70795,14,5,79,28,494,7.857142857142857,44.142857142857146,11.098443191105101,62.353071746390484,"(3.999, 24.0]",Q1
36053,2020-04-05,70795,14,3,82,13,507,6.857142857142857,41.714285714285715,9.685914057691726,58.922643850957996,"(3.999, 24.0]",Q1
36053,2020-04-06,70795,14,6,88,64,571,6.714285714285714,45.285714285714285,9.484124181489815,63.96739075600577,"(3.999, 24.0]",Q1
36053,2020-04-07,70795,14,2,90,43,614,5.571428571428571,43.57142857142857,7.8698051718745266,61.54591224158284,"(3.999, 24.0]",Q1
36053,2020-04-08,70795,14,1,91,12,626,4.428571428571429,35.714285714285715,6.25548616225924,50.447469050477736,"(3.999, 24.0]",Q1
36053,2020-04-09,70795,14,8,99,54,680,4.142857142857143,33.42857142857143,5.8519064098554185,47.21883103124716,"(3.999, 24.0]",Q1
36053,2020-04-10,70795,14,0,99,7,687,3.5714285714285716,31.571428571428573,5.044746905047774,44.59556264062232,"(3.999, 24.0]",Q1
36053,2020-04-11,70795,14,2,101,9,696,3.142857142857143,28.857142857142858,4.43937727644204,40.76155499278602,"(3.999, 24.0]",Q1
36053,2020-04-12,70795,14,0,101,7,703,2.7142857142857144,28.0,3.834007647836308,39.550815735574545,"(3.999, 24.0]",Q1
36053,2020-04-13,70795,14,3,104,50,753,2.2857142857142856,26.0,3.2286380192305746,36.725757468747794,"(3.999, 24.0]",Q1
36053,2020-04-14,70795,14,1,105,4,757,2.142857142857143,20.428571428571427,3.0268481430286642,28.855952296873262,"(3.999, 24.0]",Q1
36053,2020-04-15,70795,14,0,105,7,764,2.0,19.714285714285715,2.8250582668267534,27.847002915863712,"(3.999, 24.0]",Q1
36053,2020-04-16,70795,14,0,105,2,766,0.8571428571428571,12.285714285714286,1.2107392572114657,17.353929353364343,"(3.999, 24.0]",Q1
36053,2020-04-17,70795,14,0,105,6,772,0.8571428571428571,12.142857142857142,1.2107392572114657,17.15213947716243,"(3.999, 24.0]",Q1
36053,2020-04-18,70795,14,1,106,7,779,0.7142857142857143,11.857142857142858,1.0089493810095547,16.74855972475861,"(3.999, 24.0]",Q1
36053,2020-04-19,70795,14,0,106,4,783,0.7142857142857143,11.428571428571429,1.0089493810095547,16.143190096152875,"(3.999, 24.0]",Q1
36053,2020-04-20,70795,14,0,106,1,784,0.2857142857142857,4.428571428571429,0.4035797524038218,6.25548616225924,"(3.999, 24.0]",Q1
36053,2020-04-21,70795,14,0,106,3,787,0.14285714285714285,4.285714285714286,0.2017898762019109,6.0536962860573285,"(3.999, 24.0]",Q1
36053,2020-04-22,70795,14,0,106,7,794,0.14285714285714285,4.285714285714286,0.2017898762019109,6.0536962860573285,"(3.999, 24.0]",Q1
36053,2020-04-23,70795,14,0,106,4,798,0.14285714285714285,4.571428571428571,0.2017898762019109,6.457276038461149,"(3.999, 24.0]",Q1
36053,2020-04-24,70795,14,15,121,294,1092,2.2857142857142856,45.714285714285715,3.2286380192305746,64.5727603846115,"(3.999, 24.0]",Q1
36053,2020-04-25,70795,14,2,123,22,1114,2.4285714285714284,47.857142857142854,3.430427895432486,67.59960852764016,"(3.999, 24.0]",Q1
36053,2020-04-26,70795,14,1,124,16,1130,2.5714285714285716,49.57142857142857,3.6322177716343975,70.0210870420631,"(3.999, 24.0]",Q1
36053,2020-04-27,70795,14,2,126,26,1156,2.857142857142857,53.142857142857146,4.035797524038219,75.06583394711087,"(3.999, 24.0]",Q1
36053,2020-04-28,70795,14,0,126,47,1203,2.857142857142857,59.42857142857143,4.035797524038219,83.94458849999496,"(3.999, 24.0]",Q1
36053,2020-04-29,70795,14,5,131,12,1215,3.5714285714285716,60.142857142857146,5.044746905047774,84.95353788100452,"(3.999, 24.0]",Q1
36053,2020-04-30,70795,14,8,139,51,1266,4.714285714285714,66.85714285714286,6.659065914663061,94.43766206249433,"(3.999, 24.0]",Q1
36053,2020-05-01,70795,14,10,149,54,1320,4.0,32.57142857142857,5.650116533653507,46.00809177403569,"(3.999, 24.0]",Q1
36053,2020-05-02,70795,14,2,151,26,1346,4.0,33.142857142857146,5.650116533653507,46.81525127884335,"(3.999, 24.0]",Q1
36053,2020-05-03,70795,14,66,217,141,1487,13.285714285714286,51.0,18.76645848677772,72.0389858040822,"(3.999, 24.0]",Q1
36053,2020-05-04,70795,14,6,223,43,1530,13.857142857142858,53.42857142857143,19.573617991585362,75.4694136995147,"(3.999, 24.0]",Q1
36053,2020-05-05,70795,14,8,231,192,1722,15.0,74.14285714285714,21.18793700120065,104.72894574879179,"(3.999, 24.0]",Q1
36053,2020-05-06,70795,14,15,246,204,1926,16.428571428571427,101.57142857142857,23.205835763219756,143.4726019795587,"(3.999, 24.0]",Q1
36053,2020-05-07,70795,14,3,249,95,2021,15.714285714285714,107.85714285714286,22.196886382210202,152.35135653244276,"(3.999, 24.0]",Q1
36053,2020-05-08,70795,14,1,250,50,2071,14.428571428571429,107.28571428571429,20.38077749639301,151.54419702763514,"(3.999, 24.0]",Q1
36053,2020-05-09,70795,14,1,251,37,2108,14.285714285714286,108.85714285714286,20.178987620191094,153.76388566585615,"(3.999, 24.0]",Q1
36053,2020-05-10,70795,14,0,251,23,2131,4.857142857142857,92.0,6.860855790864972,129.95268027403066,"(3.999, 24.0]",Q1
36053,2020-05-11,70795,14,0,251,17,2148,4.0,88.28571428571429,5.650116533653507,124.70614349278097,"(3.999, 24.0]",Q1
36053,2020-05-12,70795,14,2,253,79,2227,3.142857142857143,72.14285714285714,4.43937727644204,101.90388748196501,"(3.999, 24.0]",Q1
36053,2020-05-13,70795,14,2,255,61,2288,1.2857142857142858,51.714285714285715,1.8161088858171988,73.04793518509177,"(3.999, 24.0]",Q1
36053,2020-05-14,70795,14,1,256,30,2318,1.0,42.42857142857143,1.4125291334133767,59.931593231967554,"(3.999, 24.0]",Q1
36053,2020-05-15,70795,14,2,258,53,2371,1.1428571428571428,42.857142857142854,1.6143190096152873,60.53696286057328,"(3.999, 24.0]",Q1
36053,2020-05-16,70795,14,0,258,56,2427,1.0,45.57142857142857,1.4125291334133767,64.3709705084096,"(3.999, 24.0]",Q1
36053,2020-05-17,70795,14,0,258,44,2471,1.0,48.57142857142857,1.4125291334133767,68.60855790864971,"(3.999, 24.0]",Q1
36053,2020-05-18,70795,14,2,260,103,2574,1.2857142857142858,60.857142857142854,1.8161088858171988,85.96248726201405,"(3.999, 24.0]",Q1
36053,2020-05-19,70795,14,32,292,201,2775,5.571428571428571,78.28571428571429,7.8698051718745266,110.58085215864722,"(3.999, 24.0]",Q1
36053,2020-05-20,70795,14,2,294,101,2876,5.571428571428571,84.0,7.8698051718745266,118.65244720672364,"(3.999, 24.0]",Q1
36053,2020-05-21,70795,14,3,297,135,3011,5.857142857142857,99.0,8.273384924278348,139.84038420792427,"(3.999, 24.0]",Q1
36053,2020-05-22,70795,14,4,301,200,3211,6.142857142857143,120.0,8.676964676682172,169.5034960096052,"(3.999, 24.0]",Q1
36053,2020-05-23,70795,14,0,301,105,3316,6.142857142857143,127.0,8.676964676682172,179.39119994349883,"(3.999, 24.0]",Q1
36053,2020-05-24,70795,14,2,303,67,3383,6.428571428571429,130.28571428571428,9.080544429085993,184.03236709614276,"(3.999, 24.0]",Q1
36053,2020-05-25,70795,14,0,303,179,3562,6.142857142857143,141.14285714285714,8.676964676682172,199.368397687488,"(3.999, 24.0]",Q1
36053,2020-05-26,70795,14,7,310,330,3892,2.5714285714285716,159.57142857142858,3.6322177716343975,225.39929171753454,"(3.999, 24.0]",Q1
36053,2020-05-27,70795,14,0,310,67,3959,2.2857142857142856,154.71428571428572,3.2286380192305746,218.53843592666956,"(3.999, 24.0]",Q1
36053,2020-05-28,70795,14,0,310,141,4100,1.8571428571428572,155.57142857142858,2.6232683906248426,219.74917518388105,"(3.999, 24.0]",Q1
36053,2020-05-29,70795,14,1,311,187,4287,1.4285714285714286,153.71428571428572,2.0178987620191093,217.1259067932562,"(3.999, 24.0]",Q1
36053,2020-05-30,70795,14,5,316,316,4603,2.142857142857143,183.85714285714286,3.0268481430286642,259.7035706718594,"(3.999, 24.0]",Q1
36053,2020-05-31,70795,14,0,316,138,4741,1.8571428571428572,194.0,2.6232683906248426,274.03065188219506,"(3.999, 24.0]",Q1
36053,2020-06-01,70795,14,1,317,98,4839,2.0,182.42857142857142,2.8250582668267534,257.68567190984027,"(3.999, 24.0]",Q1
36053,2020-06-02,70795,14,2,319,222,5061,1.2857142857142858,167.0,1.8161088858171988,235.8923652800339,"(3.999, 24.0]",Q1
36053,2020-06-03,70795,14,0,319,242,5303,1.2857142857142858,192.0,1.8161088858171988,271.20559361536834,"(3.999, 24.0]",Q1
36053,2020-06-04,70795,14,4,323,279,5582,1.8571428571428572,211.71428571428572,2.6232683906248426,299.05259653123204,"(3.999, 24.0]",Q1
36053,2020-06-05,70795,14,2,325,336,5918,2.0,233.0,2.8250582668267534,329.1192880853167,"(3.999, 24.0]",Q1
36053,2020-06-06,70795,14,2,327,123,6041,1.5714285714285714,205.42857142857142,2.21968863822102,290.1738419783479,"(3.999, 24.0]",Q1
36053,2020-06-07,70795,14,0,327,148,6189,1.5714285714285714,206.85714285714286,2.21968863822102,292.1917407403671,"(3.999, 24.0]",Q1
36055,2020-03-02,742474,49,0,0,0,0,0.0,0.0,0.0,0.0,"(37.5, 52.0]",Q3
36055,2020-03-03,742474,49,0,0,0,0,0.0,0.0,0.0,0.0,"(37.5, 52.0]",Q3
36055,2020-03-04,742474,49,0,0,0,0,0.0,0.0,0.0,0.0,"(37.5, 52.0]",Q3
36055,2020-03-05,742474,49,0,0,0,0,0.0,0.0,0.0,0.0,"(37.5, 52.0]",Q3
36055,2020-03-06,742474,49,0,0,0,0,0.0,0.0,0.0,0.0,"(37.5, 52.0]",Q3
36055,2020-03-07,742474,49,0,0,2,2,0.0,2.0,0.0,0.269369701834677,"(37.5, 52.0]",Q3
36055,2020-03-08,742474,49,0,0,1,3,0.0,0.42857142857142855,0.0,0.05772207896457365,"(37.5, 52.0]",Q3
36055,2020-03-09,742474,49,0,0,0,3,0.0,0.42857142857142855,0.0,0.05772207896457365,"(37.5, 52.0]",Q3
36055,2020-03-10,742474,49,0,0,0,3,0.0,0.42857142857142855,0.0,0.05772207896457365,"(37.5, 52.0]",Q3
36055,2020-03-11,742474,49,0,0,0,3,0.0,0.42857142857142855,0.0,0.05772207896457365,"(37.5, 52.0]",Q3
36055,2020-03-12,742474,49,1,1,10,13,0.14285714285714285,1.8571428571428572,0.019240692988191217,0.2501290088464858,"(37.5, 52.0]",Q3
36055,2020-03-13,742474,49,1,2,4,17,0.2857142857142857,2.4285714285714284,0.03848138597638243,0.32709178079925066,"(37.5, 52.0]",Q3
36055,2020-03-14,742474,49,0,2,2,19,0.2857142857142857,2.4285714285714284,0.03848138597638243,0.32709178079925066,"(37.5, 52.0]",Q3
36055,2020-03-15,742474,49,7,9,39,58,1.2857142857142858,7.857142857142857,0.17316623689372096,1.0582381143505168,"(37.5, 52.0]",Q3
36055,2020-03-16,742474,49,1,10,29,87,1.4285714285714286,12.0,0.19240692988191216,1.6162182110080623,"(37.5, 52.0]",Q3
36055,2020-03-17,742474,49,4,14,75,162,2.0,22.714285714285715,0.269369701834677,3.059270185122404,"(37.5, 52.0]",Q3
36055,2020-03-18,742474,49,13,27,153,315,3.857142857142857,44.57142857142857,0.5194987106811628,6.0030962123156595,"(37.5, 52.0]",Q3
36055,2020-03-19,742474,49,5,32,193,508,4.428571428571429,70.71428571428571,0.5964614826339278,9.52414302915465,"(37.5, 52.0]",Q3
36055,2020-03-20,742474,49,10,42,148,656,5.714285714285714,91.28571428571429,0.7696277195276486,12.294802819454189,"(37.5, 52.0]",Q3
36055,2020-03-21,742474,49,15,57,246,902,7.857142857142857,126.14285714285714,1.0582381143505168,16.989531908572843,"(37.5, 52.0]",Q3
36055,2020-03-22,742474,49,19,76,416,1318,9.571428571428571,180.0,1.2891264302088115,24.243273165120936,"(37.5, 52.0]",Q3
36055,2020-03-23,742474,49,20,96,219,1537,12.285714285714286,207.14285714285714,1.6546995969844447,27.899004832877264,"(37.5, 52.0]",Q3
36055,2020-03-24,742474,49,22,118,172,1709,14.857142857142858,221.0,2.0010320707718865,29.765352052731814,"(37.5, 52.0]",Q3
36055,2020-03-25,742474,49,21,139,255,1964,16.0,235.57142857142858,2.154957614677416,31.727902737527316,"(37.5, 52.0]",Q3
36055,2020-03-26,742474,49,21,160,232,2196,18.285714285714285,241.14285714285714,2.4628087024884757,32.47828976406678,"(37.5, 52.0]",Q3
36055,2020-03-27,742474,49,32,192,253,2449,21.428571428571427,256.14285714285717,2.8861039482286825,34.498562527826856,"(37.5, 52.0]",Q3
36055,2020-03-28,742474,49,27,219,282,2731,23.142857142857142,261.2857142857143,3.116992264086977,35.19122747540173,"(37.5, 52.0]",Q3
36055,2020-03-29,742474,49,23,242,129,2860,23.714285714285715,220.28571428571428,3.193955036039742,29.669148587790858,"(37.5, 52.0]",Q3
36055,2020-03-30,742474,49,50,292,383,3243,28.0,243.71428571428572,3.7711758256854786,32.824622237854214,"(37.5, 52.0]",Q3
36055,2020-03-31,742474,49,57,349,356,3599,33.0,270.0,4.4446000802721715,36.3649097476814,"(37.5, 52.0]",Q3
36055,2020-04-01,742474,49,71,420,381,3980,40.142857142857146,288.0,5.406634729681732,38.78923706419349,"(37.5, 52.0]",Q3
36055,2020-04-02,742474,49,44,464,336,4316,43.42857142857143,302.85714285714283,5.849170668410131,40.79026913496538,"(37.5, 52.0]",Q3
36055,2020-04-03,742474,49,48,512,328,4644,45.714285714285715,313.57142857142856,6.157021756221189,42.23332110907972,"(37.5, 52.0]",Q3
36055,2020-04-04,742474,49,36,548,277,4921,47.0,312.85714285714283,6.33018799311491,42.13711764413876,"(37.5, 52.0]",Q3
36055,2020-04-05,742474,49,26,574,225,5146,47.42857142857143,326.57142857142856,6.387910072079484,43.98422417100512,"(37.5, 52.0]",Q3
36055,2020-04-06,742474,49,22,596,305,5451,43.42857142857143,315.42857142857144,5.849170668410131,42.48345011792621,"(37.5, 52.0]",Q3
36055,2020-04-07,742474,49,55,651,420,5871,43.142857142857146,324.57142857142856,5.810689282433748,43.71485446917045,"(37.5, 52.0]",Q3
36055,2020-04-08,742474,49,47,698,382,6253,39.714285714285715,324.7142857142857,5.348912650717158,43.73409516215864,"(37.5, 52.0]",Q3
36055,2020-04-09,742474,49,44,742,380,6633,39.714285714285715,331.0,5.348912650717158,44.58068565363905,"(37.5, 52.0]",Q3
36055,2020-04-10,742474,49,25,767,284,6917,36.42857142857143,324.7142857142857,4.90637671198876,43.73409516215864,"(37.5, 52.0]",Q3
36055,2020-04-11,742474,49,31,798,220,7137,35.714285714285715,316.57142857142856,4.810173247047804,42.63737566183173,"(37.5, 52.0]",Q3
36055,2020-04-12,742474,49,25,823,157,7294,35.57142857142857,306.85714285714283,4.790932554059613,41.32900853863473,"(37.5, 52.0]",Q3
36055,2020-04-13,742474,49,27,850,304,7598,36.285714285714285,306.7142857142857,4.887136019000569,41.30976784564655,"(37.5, 52.0]",Q3
36055,2020-04-14,742474,49,34,884,353,7951,33.285714285714285,297.14285714285717,4.483081466248553,40.02064141543774,"(37.5, 52.0]",Q3
36055,2020-04-15,742474,49,48,932,259,8210,33.42857142857143,279.57142857142856,4.502322159236745,37.65403617789021,"(37.5, 52.0]",Q3
36055,2020-04-16,742474,49,43,975,296,8506,33.285714285714285,267.57142857142856,4.483081466248553,36.03781796688215,"(37.5, 52.0]",Q3
36055,2020-04-17,742474,49,33,1008,260,8766,34.42857142857143,264.14285714285717,4.6370070101540835,35.57604133516556,"(37.5, 52.0]",Q3
36055,2020-04-18,742474,49,24,1032,202,8968,33.42857142857143,261.57142857142856,4.502322159236745,35.229708861378114,"(37.5, 52.0]",Q3
36055,2020-04-19,742474,49,22,1054,188,9156,33.0,266.0,4.4446000802721715,35.82617034401205,"(37.5, 52.0]",Q3
36055,2020-04-20,742474,49,16,1070,229,9385,31.428571428571427,255.28571428571428,4.232952457402067,34.3831183698977,"(37.5, 52.0]",Q3
36055,2020-04-21,742474,49,42,1112,409,9794,32.57142857142857,263.2857142857143,4.386878001307597,35.46059717723641,"(37.5, 52.0]",Q3
36055,2020-04-22,742474,49,40,1152,500,10294,31.428571428571427,297.7142857142857,4.232952457402067,40.0976041873905,"(37.5, 52.0]",Q3
36055,2020-04-23,742474,49,47,1199,470,10764,32.0,322.57142857142856,4.309915229354832,43.44548476733576,"(37.5, 52.0]",Q3
36055,2020-04-24,742474,49,86,1285,1134,11898,39.57142857142857,447.42857142857144,5.329671957728967,60.2618504390149,"(37.5, 52.0]",Q3
36055,2020-04-25,742474,49,31,1316,341,12239,40.57142857142857,467.2857142857143,5.464356808646306,62.93630676437347,"(37.5, 52.0]",Q3
36055,2020-04-26,742474,49,15,1331,234,12473,39.57142857142857,473.85714285714283,5.329671957728967,63.821378641830265,"(37.5, 52.0]",Q3
36055,2020-04-27,742474,49,40,1371,543,13016,43.0,518.7142857142857,5.791448589445556,69.8629562401223,"(37.5, 52.0]",Q3
36055,2020-04-28,742474,49,33,1404,530,13546,41.714285714285715,536.0,5.6182823525518355,72.19108009169344,"(37.5, 52.0]",Q3
36055,2020-04-29,742474,49,37,1441,469,14015,41.285714285714285,531.5714285714286,5.560560273587261,71.59461860905951,"(37.5, 52.0]",Q3
36055,2020-04-30,742474,49,37,1478,579,14594,39.857142857142854,547.1428571428571,5.368153343705349,73.69185414477236,"(37.5, 52.0]",Q3
36055,2020-05-01,742474,49,56,1534,520,15114,35.57142857142857,459.42857142857144,4.790932554059613,61.87806865002296,"(37.5, 52.0]",Q3
36055,2020-05-02,742474,49,32,1566,571,15685,35.714285714285715,492.2857142857143,4.810173247047804,66.30342803730693,"(37.5, 52.0]",Q3
36055,2020-05-03,742474,49,29,1595,914,16599,37.714285714285715,589.4285714285714,5.079542948882481,79.38709926927697,"(37.5, 52.0]",Q3
36055,2020-05-04,742474,49,28,1623,721,17320,36.0,614.8571428571429,4.848654633024187,82.811942621175,"(37.5, 52.0]",Q3
36055,2020-05-05,742474,49,32,1655,842,18162,35.857142857142854,659.4285714285714,4.8294139400359954,88.81503883349066,"(37.5, 52.0]",Q3
36055,2020-05-06,742474,49,33,1688,1088,19250,35.285714285714285,747.8571428571429,4.75245116808323,100.72502779318103,"(37.5, 52.0]",Q3
36055,2020-05-07,742474,49,47,1735,1042,20292,36.714285714285715,814.0,4.944858097965143,109.63346864671355,"(37.5, 52.0]",Q3
36055,2020-05-08,742474,49,40,1775,1114,21406,34.42857142857143,898.8571428571429,4.6370070101540835,121.06244028169914,"(37.5, 52.0]",Q3
36055,2020-05-09,742474,49,46,1821,1148,22554,36.42857142857143,981.2857142857143,4.90637671198876,132.16432013588548,"(37.5, 52.0]",Q3
36055,2020-05-10,742474,49,29,1850,864,23418,36.42857142857143,974.1428571428571,4.90637671198876,131.2022854864759,"(37.5, 52.0]",Q3
36055,2020-05-11,742474,49,40,1890,797,24215,38.142857142857146,985.0,5.1372650278470555,132.66457815357845,"(37.5, 52.0]",Q3
36055,2020-05-12,742474,49,69,1959,1423,25638,43.42857142857143,1068.0,5.849170668410131,143.84342077971755,"(37.5, 52.0]",Q3
36055,2020-05-13,742474,49,60,2019,1401,27039,47.285714285714285,1112.7142857142858,6.368669379091293,149.86575768502138,"(37.5, 52.0]",Q3
36055,2020-05-14,742474,49,72,2091,1332,28371,50.857142857142854,1154.142857142857,6.849686703796073,155.44555865159683,"(37.5, 52.0]",Q3
36055,2020-05-15,742474,49,101,2192,1427,29798,59.57142857142857,1198.857142857143,8.023368976075737,161.4678955569007,"(37.5, 52.0]",Q3
36055,2020-05-16,742474,49,66,2258,1508,31306,62.42857142857143,1250.2857142857142,8.408182835839563,168.39454503264955,"(37.5, 52.0]",Q3
36055,2020-05-17,742474,49,45,2303,1324,32630,64.71428571428571,1316.0,8.71603392365062,177.2452638072175,"(37.5, 52.0]",Q3
36055,2020-05-18,742474,49,73,2376,1304,33934,69.42857142857143,1388.4285714285713,9.350976792260932,187.00029515223042,"(37.5, 52.0]",Q3
36055,2020-05-19,742474,49,89,2465,2033,35967,72.28571428571429,1475.5714285714287,9.735790652024756,198.7371178750271,"(37.5, 52.0]",Q3
36055,2020-05-20,742474,49,65,2530,1852,37819,73.0,1540.0,9.831994116965712,207.4146704127013,"(37.5, 52.0]",Q3
36055,2020-05-21,742474,49,71,2601,2061,39880,72.85714285714286,1644.142857142857,9.81275342397752,221.44113560109272,"(37.5, 52.0]",Q3
36055,2020-05-22,742474,49,60,2661,1198,41078,67.0,1611.4285714285713,9.02388501146168,217.0350169067969,"(37.5, 52.0]",Q3
36055,2020-05-23,742474,49,36,2697,846,41924,62.714285714285715,1516.857142857143,8.446664221815945,204.29767814861432,"(37.5, 52.0]",Q3
36055,2020-05-24,742474,49,36,2733,1729,43653,61.42857142857143,1574.7142857142858,8.273497984922225,212.09015880883177,"(37.5, 52.0]",Q3
36055,2020-05-25,742474,49,29,2762,1595,45248,55.142857142857146,1616.2857142857142,7.42690749344181,217.68920046839543,"(37.5, 52.0]",Q3
36055,2020-05-26,742474,49,29,2791,1297,46545,46.57142857142857,1511.142857142857,6.272465914150336,203.52805042908668,"(37.5, 52.0]",Q3
36055,2020-05-27,742474,49,33,2824,1632,48177,42.0,1479.7142857142858,5.656763738528218,199.29509797168467,"(37.5, 52.0]",Q3
36055,2020-05-28,742474,49,36,2860,1127,49304,37.0,1346.2857142857142,4.983339483941525,181.32429072071403,"(37.5, 52.0]",Q3
36055,2020-05-29,742474,49,49,2909,1322,50626,35.42857142857143,1364.0,4.771691861071423,183.71013665124974,"(37.5, 52.0]",Q3
36055,2020-05-30,742474,49,33,2942,2828,53454,35.0,1647.142857142857,4.713969782106848,221.84519015384473,"(37.5, 52.0]",Q3
36055,2020-05-31,742474,49,22,2964,1994,55448,33.0,1685.0,4.4446000802721715,226.9439737957154,"(37.5, 52.0]",Q3
36055,2020-06-01,742474,49,25,2989,2340,57788,32.42857142857143,1791.4285714285713,4.367637308319407,241.27829007191787,"(37.5, 52.0]",Q3
36055,2020-06-02,742474,49,59,3048,3979,61767,36.714285714285715,2174.5714285714284,4.944858097965143,292.8818286662467,"(37.5, 52.0]",Q3
36055,2020-06-03,742474,49,33,3081,2854,64621,36.714285714285715,2349.1428571428573,4.944858097965143,316.39395549781636,"(37.5, 52.0]",Q3
36055,2020-06-04,742474,49,36,3117,2438,67059,36.714285714285715,2536.4285714285716,4.944858097965143,341.61850400533507,"(37.5, 52.0]",Q3
36055,2020-06-05,742474,49,50,3167,4685,71744,36.857142857142854,3016.8571428571427,4.964098790953334,406.3249545246221,"(37.5, 52.0]",Q3
36055,2020-06-06,742474,49,23,3190,3231,74975,35.42857142857143,3074.4285714285716,4.771691861071423,414.07895379886315,"(37.5, 52.0]",Q3
36055,2020-06-07,742474,49,13,3203,2881,77856,34.142857142857146,3201.1428571428573,4.598525624177701,431.14544847938885,"(37.5, 52.0]",Q3
36057,2020-03-02,49455,79,0,0,0,0,0.0,0.0,0.0,0.0,"(52.0, 100.0]",Q4
36057,2020-03-03,49455,79,0,0,0,0,0.0,0.0,0.0,0.0,"(52.0, 100.0]",Q4
36057,2020-03-04,49455,79,0,0,0,0,0.0,0.0,0.0,0.0,"(52.0, 100.0]",Q4
36057,2020-03-05,49455,79,0,0,0,0,0.0,0.0,0.0,0.0,"(52.0, 100.0]",Q4
36057,2020-03-06,49455,79,0,0,0,0,0.0,0.0,0.0,0.0,"(52.0, 100.0]",Q4
36057,2020-03-07,49455,79,0,0,0,0,0.0,0.0,0.0,0.0,"(52.0, 100.0]",Q4
36057,2020-03-08,49455,79,0,0,0,0,0.0,0.0,0.0,0.0,"(52.0, 100.0]",Q4
36057,2020-03-09,49455,79,0,0,0,0,0.0,0.0,0.0,0.0,"(52.0, 100.0]",Q4
36057,2020-03-10,49455,79,0,0,1,1,0.0,0.14285714285714285,0.0,0.2888628912286783,"(52.0, 100.0]",Q4
36057,2020-03-11,49455,79,0,0,1,2,0.0,0.2857142857142857,0.0,0.5777257824573566,"(52.0, 100.0]",Q4
36057,2020-03-12,49455,79,0,0,0,2,0.0,0.2857142857142857,0.0,0.5777257824573566,"(52.0, 100.0]",Q4
36057,2020-03-13,49455,79,0,0,0,2,0.0,0.2857142857142857,0.0,0.5777257824573566,"(52.0, 100.0]",Q4
36057,2020-03-14,49455,79,1,1,3,5,0.14285714285714285,0.7142857142857143,0.2888628912286783,1.4443144561433916,"(52.0, 100.0]",Q4
36057,2020-03-15,49455,79,0,1,4,9,0.14285714285714285,1.2857142857142858,0.2888628912286783,2.599766021058105,"(52.0, 100.0]",Q4
36057,2020-03-16,49455,79,0,1,1,10,0.14285714285714285,1.4285714285714286,0.2888628912286783,2.888628912286783,"(52.0, 100.0]",Q4
36057,2020-03-17,49455,79,1,2,14,24,0.2857142857142857,3.2857142857142856,0.5777257824573566,6.643846498259601,"(52.0, 100.0]",Q4
36057,2020-03-18,49455,79,0,2,14,38,0.2857142857142857,5.142857142857143,0.5777257824573566,10.39906408423242,"(52.0, 100.0]",Q4
36057,2020-03-19,49455,79,0,2,4,42,0.2857142857142857,5.714285714285714,0.5777257824573566,11.554515649147133,"(52.0, 100.0]",Q4
36057,2020-03-20,49455,79,1,3,27,69,0.42857142857142855,9.571428571428571,0.8665886736860349,19.353813712321447,"(52.0, 100.0]",Q4
36057,2020-03-21,49455,79,0,3,20,89,0.2857142857142857,12.0,0.5777257824573566,24.26448286320898,"(52.0, 100.0]",Q4
36057,2020-03-22,49455,79,0,3,6,95,0.2857142857142857,12.285714285714286,0.5777257824573566,24.84220864566634,"(52.0, 100.0]",Q4
36057,2020-03-23,49455,79,0,3,5,100,0.2857142857142857,12.857142857142858,0.5777257824573566,25.99766021058105,"(52.0, 100.0]",Q4
36057,2020-03-24,49455,79,1,4,5,105,0.2857142857142857,11.571428571428571,0.5777257824573566,23.397894189522944,"(52.0, 100.0]",Q4
36057,2020-03-25,49455,79,1,5,5,110,0.42857142857142855,10.285714285714286,0.8665886736860349,20.79812816846484,"(52.0, 100.0]",Q4
36057,2020-03-26,49455,79,0,5,7,117,0.42857142857142855,10.714285714285714,0.8665886736860349,21.66471684215087,"(52.0, 100.0]",Q4
36057,2020-03-27,49455,79,0,5,10,127,0.2857142857142857,8.285714285714286,0.5777257824573566,16.754047691263345,"(52.0, 100.0]",Q4
36057,2020-03-28,49455,79,1,6,6,133,0.42857142857142855,6.285714285714286,0.8665886736860349,12.709967214061846,"(52.0, 100.0]",Q4
36057,2020-03-29,49455,79,0,6,2,135,0.42857142857142855,5.714285714285714,0.8665886736860349,11.554515649147133,"(52.0, 100.0]",Q4
36057,2020-03-30,49455,79,1,7,8,143,0.5714285714285714,6.142857142857143,1.1554515649147132,12.42110432283317,"(52.0, 100.0]",Q4
36057,2020-03-31,49455,79,0,7,4,147,0.42857142857142855,6.0,0.8665886736860349,12.13224143160449,"(52.0, 100.0]",Q4
36057,2020-04-01,49455,79,1,8,10,157,0.42857142857142855,6.714285714285714,0.8665886736860349,13.576555887747881,"(52.0, 100.0]",Q4
36057,2020-04-02,49455,79,2,10,8,165,0.7142857142857143,6.857142857142857,1.4443144561433916,13.865418778976558,"(52.0, 100.0]",Q4
36057,2020-04-03,49455,79,3,13,11,176,1.1428571428571428,7.0,2.3109031298294265,14.154281670205238,"(52.0, 100.0]",Q4
36057,2020-04-04,49455,79,2,15,14,190,1.2857142857142858,8.142857142857142,2.599766021058105,16.465184800034663,"(52.0, 100.0]",Q4
36057,2020-04-05,49455,79,0,15,8,198,1.2857142857142858,9.0,2.599766021058105,18.198362147406733,"(52.0, 100.0]",Q4
36057,2020-04-06,49455,79,3,18,20,218,1.5714285714285714,10.714285714285714,3.1774918035154616,21.66471684215087,"(52.0, 100.0]",Q4
36057,2020-04-07,49455,79,0,18,9,227,1.5714285714285714,11.428571428571429,3.1774918035154616,23.109031298294266,"(52.0, 100.0]",Q4
36057,2020-04-08,49455,79,10,28,24,251,2.857142857142857,13.428571428571429,5.777257824573566,27.153111775495763,"(52.0, 100.0]",Q4
36057,2020-04-09,49455,79,1,29,13,264,2.7142857142857144,14.142857142857142,5.488394933344888,28.59742623163915,"(52.0, 100.0]",Q4
36057,2020-04-10,49455,79,0,29,8,272,2.2857142857142856,13.714285714285714,4.621806259658853,27.730837557953116,"(52.0, 100.0]",Q4
36057,2020-04-11,49455,79,0,29,1,273,2.0,11.857142857142858,4.044080477201496,23.9756199719803,"(52.0, 100.0]",Q4
36057,2020-04-12,49455,79,0,29,2,275,2.0,11.0,4.044080477201496,22.24244262460823,"(52.0, 100.0]",Q4
36057,2020-04-13,49455,79,3,32,56,331,2.0,16.142857142857142,4.044080477201496,32.64150670884065,"(52.0, 100.0]",Q4
36057,2020-04-14,49455,79,0,32,0,331,2.0,14.857142857142858,4.044080477201496,30.041740687782546,"(52.0, 100.0]",Q4
36057,2020-04-15,49455,79,0,32,5,336,0.5714285714285714,12.142857142857142,1.1554515649147132,24.553345754437654,"(52.0, 100.0]",Q4
36057,2020-04-16,49455,79,1,33,10,346,0.5714285714285714,11.714285714285714,1.1554515649147132,23.68675708075162,"(52.0, 100.0]",Q4
36057,2020-04-17,49455,79,1,34,4,350,0.7142857142857143,11.142857142857142,1.4443144561433916,22.53130551583691,"(52.0, 100.0]",Q4
36057,2020-04-18,49455,79,1,35,4,354,0.8571428571428571,11.571428571428571,1.7331773473720697,23.397894189522944,"(52.0, 100.0]",Q4
36057,2020-04-19,49455,79,0,35,4,358,0.8571428571428571,11.857142857142858,1.7331773473720697,23.9756199719803,"(52.0, 100.0]",Q4
36057,2020-04-20,49455,79,2,37,3,361,0.7142857142857143,4.285714285714286,1.4443144561433916,8.66588673686035,"(52.0, 100.0]",Q4
36057,2020-04-21,49455,79,1,38,3,364,0.8571428571428571,4.714285714285714,1.7331773473720697,9.532475410546384,"(52.0, 100.0]",Q4
36057,2020-04-22,49455,79,1,39,7,371,1.0,5.0,2.022040238600748,10.110201193003741,"(52.0, 100.0]",Q4
36057,2020-04-23,49455,79,0,39,6,377,0.8571428571428571,4.428571428571429,1.7331773473720697,8.95474962808903,"(52.0, 100.0]",Q4
36057,2020-04-24,49455,79,7,46,226,603,1.7142857142857142,36.142857142857146,3.4663546947441395,73.08231148085561,"(52.0, 100.0]",Q4
36057,2020-04-25,49455,79,1,47,35,638,1.7142857142857142,40.57142857142857,3.4663546947441395,82.03706110894464,"(52.0, 100.0]",Q4
36057,2020-04-26,49455,79,0,47,9,647,1.7142857142857142,41.285714285714285,3.4663546947441395,83.48137556508803,"(52.0, 100.0]",Q4
36057,2020-04-27,49455,79,2,49,19,666,1.7142857142857142,43.57142857142857,3.4663546947441395,88.10318182474688,"(52.0, 100.0]",Q4
36057,2020-04-28,49455,79,2,51,18,684,1.8571428571428572,45.714285714285715,3.7552175859728183,92.43612519317706,"(52.0, 100.0]",Q4
36057,2020-04-29,49455,79,2,53,14,698,2.0,46.714285714285715,4.044080477201496,94.45816543177781,"(52.0, 100.0]",Q4
36057,2020-04-30,49455,79,1,54,29,727,2.142857142857143,50.0,4.332943368430175,101.1020119300374,"(52.0, 100.0]",Q4
36057,2020-05-01,49455,79,0,54,27,754,1.1428571428571428,21.571428571428573,2.3109031298294265,43.61829657553042,"(52.0, 100.0]",Q4
36057,2020-05-02,49455,79,2,56,53,807,1.2857142857142858,24.142857142857142,2.599766021058105,48.81782861764663,"(52.0, 100.0]",Q4
36057,2020-05-03,49455,79,0,56,19,826,1.2857142857142858,25.571428571428573,2.599766021058105,51.706457529933424,"(52.0, 100.0]",Q4
36057,2020-05-04,49455,79,5,61,28,854,1.7142857142857142,26.857142857142858,3.4663546947441395,54.306223550991525,"(52.0, 100.0]",Q4
36057,2020-05-05,49455,79,2,63,46,900,1.7142857142857142,30.857142857142858,3.4663546947441395,62.39438450539452,"(52.0, 100.0]",Q4
36057,2020-05-06,49455,79,0,63,34,934,1.4285714285714286,33.714285714285715,2.888628912286783,68.17164232996808,"(52.0, 100.0]",Q4
36057,2020-05-07,49455,79,1,64,36,970,1.4285714285714286,34.714285714285715,2.888628912286783,70.19368256856883,"(52.0, 100.0]",Q4
36057,2020-05-08,49455,79,2,66,36,1006,1.7142857142857142,36.0,3.4663546947441395,72.79344858962693,"(52.0, 100.0]",Q4
36057,2020-05-09,49455,79,1,67,33,1039,1.5714285714285714,33.142857142857146,3.1774918035154616,67.01619076505338,"(52.0, 100.0]",Q4
36057,2020-05-10,49455,79,0,67,30,1069,1.5714285714285714,34.714285714285715,3.1774918035154616,70.19368256856883,"(52.0, 100.0]",Q4
36057,2020-05-11,49455,79,0,67,62,1131,0.8571428571428571,39.57142857142857,1.7331773473720697,80.01502087034389,"(52.0, 100.0]",Q4
36057,2020-05-12,49455,79,1,68,115,1246,0.7142857142857143,49.42857142857143,1.4443144561433916,99.9465603651227,"(52.0, 100.0]",Q4
36057,2020-05-13,49455,79,1,69,177,1423,0.8571428571428571,69.85714285714286,1.7331773473720697,141.2539538108237,"(52.0, 100.0]",Q4
36057,2020-05-14,49455,79,3,72,46,1469,1.1428571428571428,71.28571428571429,2.3109031298294265,144.14258272311048,"(52.0, 100.0]",Q4
36057,2020-05-15,49455,79,3,75,93,1562,1.2857142857142858,79.42857142857143,2.599766021058105,160.60776752314516,"(52.0, 100.0]",Q4
36057,2020-05-16,49455,79,0,75,52,1614,1.1428571428571428,82.14285714285714,2.3109031298294265,166.09616245649002,"(52.0, 100.0]",Q4
36057,2020-05-17,49455,79,0,75,38,1652,1.1428571428571428,83.28571428571429,2.3109031298294265,168.40706558631948,"(52.0, 100.0]",Q4
36057,2020-05-18,49455,79,0,75,25,1677,1.1428571428571428,78.0,2.3109031298294265,157.71913861085835,"(52.0, 100.0]",Q4
36057,2020-05-19,49455,79,0,75,43,1720,1.0,67.71428571428571,2.022040238600748,136.9210104423935,"(52.0, 100.0]",Q4
36057,2020-05-20,49455,79,2,77,96,1816,1.1428571428571428,56.142857142857146,2.3109031298294265,113.52311625287058,"(52.0, 100.0]",Q4
36057,2020-05-21,49455,79,0,77,130,1946,0.7142857142857143,68.14285714285714,1.4443144561433916,137.78759911607955,"(52.0, 100.0]",Q4
36057,2020-05-22,49455,79,0,77,79,2025,0.2857142857142857,66.14285714285714,0.5777257824573566,133.74351863887804,"(52.0, 100.0]",Q4
36057,2020-05-23,49455,79,2,79,131,2156,0.5714285714285714,77.42857142857143,1.1554515649147132,156.56368704594365,"(52.0, 100.0]",Q4
36057,2020-05-24,49455,79,0,79,159,2315,0.5714285714285714,94.71428571428571,1.1554515649147132,191.5160968846137,"(52.0, 100.0]",Q4
36057,2020-05-25,49455,79,1,80,41,2356,0.7142857142857143,97.0,1.4443144561433916,196.13790314427257,"(52.0, 100.0]",Q4
36057,2020-05-26,49455,79,2,82,47,2403,1.0,97.57142857142857,2.022040238600748,197.29335470918727,"(52.0, 100.0]",Q4
36057,2020-05-27,49455,79,0,82,341,2744,0.7142857142857143,132.57142857142858,1.4443144561433916,268.0647630602135,"(52.0, 100.0]",Q4
36057,2020-05-28,49455,79,2,84,182,2926,1.0,140.0,2.022040238600748,283.0856334041047,"(52.0, 100.0]",Q4
36057,2020-05-29,49455,79,5,89,222,3148,1.7142857142857142,160.42857142857142,3.4663546947441395,324.3930268498057,"(52.0, 100.0]",Q4
36057,2020-05-30,49455,79,2,91,95,3243,1.7142857142857142,155.28571428571428,3.4663546947441395,313.9939627655733,"(52.0, 100.0]",Q4
36057,2020-05-31,49455,79,0,91,186,3429,1.7142857142857142,159.14285714285714,3.4663546947441395,321.79326082874763,"(52.0, 100.0]",Q4
36057,2020-06-01,49455,79,2,93,104,3533,1.8571428571428572,168.14285714285714,3.7552175859728183,339.99162297615436,"(52.0, 100.0]",Q4
36057,2020-06-02,49455,79,1,94,213,3746,1.7142857142857142,191.85714285714286,3.4663546947441395,387.942862920115,"(52.0, 100.0]",Q4
36057,2020-06-03,49455,79,2,96,311,4057,2.0,187.57142857142858,4.044080477201496,379.27697618325465,"(52.0, 100.0]",Q4
36057,2020-06-04,49455,79,0,96,314,4371,1.7142857142857142,206.42857142857142,3.4663546947441395,417.4068778254401,"(52.0, 100.0]",Q4
36057,2020-06-05,49455,79,2,98,370,4741,1.2857142857142858,227.57142857142858,2.599766021058105,460.15858572728456,"(52.0, 100.0]",Q4
36057,2020-06-06,49455,79,2,100,226,4967,1.2857142857142858,246.28571428571428,2.599766021058105,497.99962447824134,"(52.0, 100.0]",Q4
36057,2020-06-07,49455,79,0,100,246,5213,1.2857142857142858,254.85714285714286,2.599766021058105,515.3313979519621,"(52.0, 100.0]",Q4
36059,2020-03-02,1358343,8,0,0,0,0,0.0,0.0,0.0,0.0,"(3.999, 24.0]",Q1
36059,2020-03-03,1358343,8,0,0,0,0,0.0,0.0,0.0,0.0,"(3.999, 24.0]",Q1
36059,2020-03-04,1358343,8,0,0,0,0,0.0,0.0,0.0,0.0,"(3.999, 24.0]",Q1
36059,2020-03-05,1358343,8,1,1,1,1,1.0,1.0,0.07361910798671617,0.07361910798671617,"(3.999, 24.0]",Q1
36059,2020-03-06,1358343,8,3,4,10,11,3.0,10.0,0.2208573239601485,0.7361910798671617,"(3.999, 24.0]",Q1
36059,2020-03-07,1358343,8,2,6,5,16,2.0,5.0,0.14723821597343234,0.36809553993358085,"(3.999, 24.0]",Q1
36059,2020-03-08,1358343,8,4,10,11,27,1.4285714285714286,3.857142857142857,0.10517015426673738,0.28395941652019097,"(3.999, 24.0]",Q1
36059,2020-03-09,1358343,8,4,14,15,42,2.0,6.0,0.14723821597343234,0.441714647920297,"(3.999, 24.0]",Q1
36059,2020-03-10,1358343,8,6,20,22,64,2.857142857142857,9.142857142857142,0.21034030853347477,0.6730889873071193,"(3.999, 24.0]",Q1
36059,2020-03-11,1358343,8,11,31,58,122,4.428571428571429,17.428571428571427,0.3260274782268859,1.2830758820541959,"(3.999, 24.0]",Q1
36059,2020-03-12,1358343,8,14,45,86,208,6.285714285714286,29.571428571428573,0.4627486787736445,2.177022193321464,"(3.999, 24.0]",Q1
36059,2020-03-13,1358343,8,19,64,100,308,8.571428571428571,42.42857142857143,0.6310209256004242,3.1235535817221005,"(3.999, 24.0]",Q1
36059,2020-03-14,1358343,8,20,84,82,390,11.142857142857142,53.42857142857143,0.8203272032805515,3.933363769575978,"(3.999, 24.0]",Q1
36059,2020-03-15,1358343,8,23,107,109,499,13.857142857142858,67.42857142857143,1.0201504963873527,4.964031281390005,"(3.999, 24.0]",Q1
36059,2020-03-16,1358343,8,24,131,112,611,16.714285714285715,81.28571428571429,1.2304908049208274,5.984181777777358,"(3.999, 24.0]",Q1
36059,2020-03-17,1358343,8,52,183,218,829,23.285714285714285,109.28571428571429,1.7142735145478194,8.04551680140541,"(3.999, 24.0]",Q1
36059,2020-03-18,1358343,8,186,369,632,1461,48.285714285714285,191.28571428571428,3.5547512142157234,14.082283656316136,"(3.999, 24.0]",Q1
36059,2020-03-19,1358343,8,385,754,1036,2497,101.28571428571429,327.0,7.456563937511681,24.07344831165619,"(3.999, 24.0]",Q1
36059,2020-03-20,1358343,8,479,1233,1706,4203,167.0,556.4285714285714,12.2943910337816,40.963775086894216,"(3.999, 24.0]",Q1
36059,2020-03-21,1358343,8,667,1900,1968,6171,259.42857142857144,825.8571428571429,19.09890001483951,60.798866181600886,"(3.999, 24.0]",Q1
36059,2020-03-22,1358343,8,542,2442,1323,7494,333.57142857142856,999.2857142857143,24.557231021283176,73.5665229095828,"(3.999, 24.0]",Q1
36059,2020-03-23,1358343,8,427,2869,993,8487,391.14285714285717,1125.142857142857,28.7955882382327,82.83201350048236,"(3.999, 24.0]",Q1
36059,2020-03-24,1358343,8,416,3285,896,9383,443.14285714285717,1222.0,32.62378185354194,89.96254995976716,"(3.999, 24.0]",Q1
36059,2020-03-25,1358343,8,629,3914,1735,11118,506.42857142857144,1379.5714285714287,37.2828196875584,101.5628179753883,"(3.999, 24.0]",Q1
36059,2020-03-26,1358343,8,743,4657,1412,12530,557.5714285714286,1433.2857142857142,41.0479112103076,105.51721577581762,"(3.999, 24.0]",Q1
36059,2020-03-27,1358343,8,880,5537,1827,14357,614.8571428571429,1450.5714285714287,45.26523439640377,106.78977464244515,"(3.999, 24.0]",Q1
36059,2020-03-28,1358343,8,908,6445,2107,16464,649.2857142857143,1470.4285714285713,47.799835114232145,108.25163978675278,"(3.999, 24.0]",Q1
36059,2020-03-29,1358343,8,899,7344,1830,18294,700.2857142857143,1542.857142857143,51.55440962155466,113.58376660807637,"(3.999, 24.0]",Q1
36059,2020-03-30,1358343,8,1200,8544,2261,20555,810.7142857142857,1724.0,59.68406254637346,126.91934216909867,"(3.999, 24.0]",Q1
36059,2020-03-31,1358343,8,1010,9554,1845,22400,895.5714285714286,1859.5714285714287,65.93116970981765,136.89998980901206,"(3.999, 24.0]",Q1
36059,2020-04-01,1358343,8,1033,10587,1908,24308,953.2857142857143,1884.2857142857142,70.18004394219385,138.7194334778266,"(3.999, 24.0]",Q1
36059,2020-04-02,1358343,8,1437,12024,2663,26971,1052.4285714285713,2063.0,77.47885264830542,151.87621977659546,"(3.999, 24.0]",Q1
36059,2020-04-03,1358343,8,1322,13346,2694,29665,1115.5714285714287,2186.8571428571427,82.12737346689522,160.99447215152156,"(3.999, 24.0]",Q1
36059,2020-04-04,1358343,8,1052,14398,2195,31860,1136.142857142857,2199.4285714285716,83.64182368833623,161.91996950906886,"(3.999, 24.0]",Q1
36059,2020-04-05,1358343,8,1218,15616,2363,34223,1181.7142857142858,2275.5714285714284,86.99675160944517,167.52553873148597,"(3.999, 24.0]",Q1
36059,2020-04-06,1358343,8,994,16610,2097,36320,1152.2857142857142,2252.1428571428573,84.83024643155036,165.8007482015115,"(3.999, 24.0]",Q1
36059,2020-04-07,1358343,8,1938,18548,4179,40499,1284.857142857143,2585.5714285714284,94.5900367475036,190.34746220736798,"(3.999, 24.0]",Q1
36059,2020-04-08,1358343,8,1592,20140,3598,44097,1364.7142857142858,2827.0,100.46904837101422,208.12121827844663,"(3.999, 24.0]",Q1
36059,2020-04-09,1358343,8,1372,21512,3021,47118,1355.4285714285713,2878.1428571428573,99.78544236828041,211.88630980119584,"(3.999, 24.0]",Q1
36059,2020-04-10,1358343,8,1072,22584,2527,49645,1319.7142857142858,2854.285714285714,97.156188511612,210.12996822494128,"(3.999, 24.0]",Q1
36059,2020-04-11,1358343,8,969,23553,2307,51952,1307.857142857143,2870.285714285714,96.28327623119807,211.30787395272876,"(3.999, 24.0]",Q1
36059,2020-04-12,1358343,8,805,24358,2072,54024,1248.857142857143,2828.714285714286,91.93974885998182,208.2474224635667,"(3.999, 24.0]",Q1
36059,2020-04-13,1358343,8,892,25250,2283,56307,1234.2857142857142,2855.285714285714,90.86701328646109,210.20358733292798,"(3.999, 24.0]",Q1
36059,2020-04-14,1358343,8,1465,26715,3155,59462,1166.7142857142858,2709.0,85.89246498964442,199.4341635360141,"(3.999, 24.0]",Q1
36059,2020-04-15,1358343,8,1057,27772,2814,62276,1090.2857142857142,2597.0,80.26586173637396,191.18882344150188,"(3.999, 24.0]",Q1
36059,2020-04-16,1358343,8,767,28539,2386,64662,1003.8571428571429,2506.285714285714,73.90306740323636,184.51051864556405,"(3.999, 24.0]",Q1
36059,2020-04-17,1358343,8,641,29180,1973,66635,942.2857142857143,2427.1428571428573,69.37023375433998,178.68409209918684,"(3.999, 24.0]",Q1
36059,2020-04-18,1358343,8,833,30013,2658,69293,922.8571428571429,2477.285714285714,67.93991965631236,182.37556451394929,"(3.999, 24.0]",Q1
36059,2020-04-19,1358343,8,664,30677,2196,71489,902.7142857142857,2495.0,66.45702048115135,183.67967442685685,"(3.999, 24.0]",Q1
36059,2020-04-20,1358343,8,402,31079,1385,72874,832.7142857142857,2366.714285714286,61.30368292208122,174.23539457370381,"(3.999, 24.0]",Q1
36059,2020-04-21,1358343,8,476,31555,1697,74571,691.4285714285714,2158.4285714285716,50.90235466510089,158.90158608161352,"(3.999, 24.0]",Q1
36059,2020-04-22,1358343,8,569,32124,1980,76551,621.7142857142857,2039.2857142857142,45.770051136884106,150.1303952157676,"(3.999, 24.0]",Q1
36059,2020-04-23,1358343,8,641,32765,2787,79338,603.7142857142857,2096.5714285714284,44.444907193123214,154.34771840186377,"(3.999, 24.0]",Q1
36059,2020-04-24,1358343,8,1033,33798,4225,83563,659.7142857142857,2418.285714285714,48.56757724037932,178.03203714273306,"(3.999, 24.0]",Q1
36059,2020-04-25,1358343,8,724,34522,3334,86897,644.1428571428571,2514.8571428571427,47.42122255887188,185.1415395711645,"(3.999, 24.0]",Q1
36059,2020-04-26,1358343,8,343,34865,1871,88768,598.2857142857143,2468.4285714285716,44.04526060690962,181.72350955749553,"(3.999, 24.0]",Q1
36059,2020-04-27,1358343,8,220,35085,1499,90267,572.2857142857143,2484.714285714286,42.131163799255,182.92244931613632,"(3.999, 24.0]",Q1
36059,2020-04-28,1358343,8,420,35505,2509,92776,564.2857142857143,2600.714285714286,41.54221093536127,191.4622658425954,"(3.999, 24.0]",Q1
36059,2020-04-29,1358343,8,349,35854,2424,95200,532.8571428571429,2664.1428571428573,39.228467541493046,196.13182069203853,"(3.999, 24.0]",Q1
36059,2020-04-30,1358343,8,307,36161,2108,97308,485.14285714285717,2567.1428571428573,35.71578438898401,188.9907672173271,"(3.999, 24.0]",Q1
36059,2020-05-01,1358343,8,358,36519,2384,99692,388.7142857142857,2304.1428571428573,28.616798975979243,169.62894181682074,"(3.999, 24.0]",Q1
36059,2020-05-02,1358343,8,261,36780,2194,101886,322.57142857142856,2141.285714285714,23.747420833429302,157.63954423041267,"(3.999, 24.0]",Q1
36059,2020-05-03,1358343,8,185,36965,1736,103622,300.0,2122.0,22.08573239601485,156.21974714781172,"(3.999, 24.0]",Q1
36059,2020-05-04,1358343,8,187,37152,1822,105444,295.2857142857143,2168.1428571428573,21.738670886934617,159.61674313062733,"(3.999, 24.0]",Q1
36059,2020-05-05,1358343,8,198,37350,1765,107209,263.57142857142856,2061.8571428571427,19.403893462213045,151.79208365318203,"(3.999, 24.0]",Q1
36059,2020-05-06,1358343,8,243,37593,2658,109867,248.42857142857142,2095.285714285714,18.289089826985627,154.25306526302373,"(3.999, 24.0]",Q1
36059,2020-05-07,1358343,8,219,37812,2050,111917,235.85714285714286,2087.0,17.36359246943834,153.64307836827663,"(3.999, 24.0]",Q1
36059,2020-05-08,1358343,8,216,38028,2390,114307,215.57142857142858,2087.8571428571427,15.870176278850673,153.70618046083666,"(3.999, 24.0]",Q1
36059,2020-05-09,1358343,8,189,38217,2260,116567,205.28571428571428,2097.285714285714,15.112951168130161,154.40030347899713,"(3.999, 24.0]",Q1
36059,2020-05-10,1358343,8,120,38337,1756,118323,196.0,2100.1428571428573,14.42934516539637,154.61064378753062,"(3.999, 24.0]",Q1
36059,2020-05-11,1358343,8,97,38434,1558,119881,183.14285714285714,2062.4285714285716,13.482813776995732,151.83415171488875,"(3.999, 24.0]",Q1
36059,2020-05-12,1358343,8,153,38587,2374,122255,176.71428571428572,2149.4285714285716,13.009548082795416,158.2390141097331,"(3.999, 24.0]",Q1
36059,2020-05-13,1358343,8,156,38743,2633,124888,164.28571428571428,2145.8571428571427,12.094567740674798,157.97608872406622,"(3.999, 24.0]",Q1
36059,2020-05-14,1358343,8,121,38864,2363,127251,150.28571428571428,2190.5714285714284,11.063900228860772,161.26791455261508,"(3.999, 24.0]",Q1
36059,2020-05-15,1358343,8,169,39033,2478,129729,143.57142857142858,2203.1428571428573,10.569600503807107,162.1934119101624,"(3.999, 24.0]",Q1
36059,2020-05-16,1358343,8,103,39136,2020,131749,131.28571428571428,2168.8571428571427,9.665137177113165,159.66932820776069,"(3.999, 24.0]",Q1
36059,2020-05-17,1358343,8,89,39225,1749,133498,126.85714285714286,2167.8571428571427,9.33910969888628,159.59570909977396,"(3.999, 24.0]",Q1
36059,2020-05-18,1358343,8,70,39295,1635,135133,123.0,2178.8571428571427,9.055150282366089,160.40551928762784,"(3.999, 24.0]",Q1
36059,2020-05-19,1358343,8,73,39368,2281,137414,111.57142857142857,2165.5714285714284,8.213789048232188,159.42743685294718,"(3.999, 24.0]",Q1
36059,2020-05-20,1358343,8,119,39487,3112,140526,106.28571428571429,2234.0,7.824659477445262,164.46508724232393,"(3.999, 24.0]",Q1
36059,2020-05-21,1358343,8,121,39608,3097,143623,106.28571428571429,2338.8571428571427,7.824659477445262,172.18457656550243,"(3.999, 24.0]",Q1
36059,2020-05-22,1358343,8,118,39726,4188,147811,99.0,2583.1428571428573,7.2882916906849005,190.16867294511454,"(3.999, 24.0]",Q1
36059,2020-05-23,1358343,8,111,39837,3739,151550,100.14285714285714,2828.714285714286,7.37242781409829,208.2474224635667,"(3.999, 24.0]",Q1
36059,2020-05-24,1358343,8,70,39907,2891,154441,97.42857142857143,2991.8571428571427,7.17260452099149,220.25785408082808,"(3.999, 24.0]",Q1
36059,2020-05-25,1358343,8,67,39974,2269,156710,97.0,3082.4285714285716,7.141053474711468,226.92564186133924,"(3.999, 24.0]",Q1
36059,2020-05-26,1358343,8,60,40034,2390,159100,95.14285714285714,3098.0,7.004332274164709,228.07199654284668,"(3.999, 24.0]",Q1
36059,2020-05-27,1358343,8,106,40140,4664,163764,93.28571428571429,3319.714285714286,6.867611073617952,244.39440448504433,"(3.999, 24.0]",Q1
36059,2020-05-28,1358343,8,86,40226,4760,168524,88.28571428571429,3557.285714285714,6.499515533684371,261.88420113960274,"(3.999, 24.0]",Q1
36059,2020-05-29,1358343,8,81,40307,4710,173234,83.0,3631.8571428571427,6.110385962897443,267.3740831923264,"(3.999, 24.0]",Q1
36059,2020-05-30,1358343,8,89,40396,4112,177346,79.85714285714286,3685.1428571428573,5.87901162351062,271.29692994647576,"(3.999, 24.0]",Q1
36059,2020-05-31,1358343,8,83,40479,3878,181224,81.71428571428571,3826.1428571428573,6.015732824057378,281.67722417260273,"(3.999, 24.0]",Q1
36059,2020-06-01,1358343,8,93,40572,3851,185075,85.42857142857143,4052.1428571428573,6.289175225150896,298.31514257760057,"(3.999, 24.0]",Q1
36059,2020-06-02,1358343,8,72,40644,4433,189508,87.14285714285714,4344.0,6.41537941027098,319.80140509429503,"(3.999, 24.0]",Q1
36059,2020-06-03,1358343,8,69,40713,5104,194612,81.85714285714286,4406.857142857143,6.026249839484052,324.4288918820315,"(3.999, 24.0]",Q1
36059,2020-06-04,1358343,8,84,40797,5177,199789,81.57142857142857,4466.428571428572,6.005215808630704,328.8144873149544,"(3.999, 24.0]",Q1
36059,2020-06-05,1358343,8,56,40853,5533,205322,78.0,4584.0,5.742290422963862,337.4699910111069,"(3.999, 24.0]",Q1
36059,2020-06-06,1358343,8,51,40904,4119,209441,72.57142857142857,4585.0,5.342643836750259,337.5436101190936,"(3.999, 24.0]",Q1
36059,2020-06-07,1358343,8,43,40947,4033,213474,66.85714285714286,4607.142857142857,4.92196321968331,339.17374751022805,"(3.999, 24.0]",Q1
36061,2020-03-02,1628701,81,0,0,0,0,0.0,0.0,0.0,0.0,"(52.0, 100.0]",Q4
36061,2020-03-03,1628701,81,0,0,3,3,0.0,3.0,0.0,0.1841958714337377,"(52.0, 100.0]",Q4
36061,2020-03-04,1628701,81,1,1,4,7,1.0,4.0,0.061398623811245896,0.24559449524498358,"(52.0, 100.0]",Q4
36061,2020-03-05,1628701,81,1,2,18,25,1.0,18.0,0.061398623811245896,1.1051752286024261,"(52.0, 100.0]",Q4
36061,2020-03-06,1628701,81,3,5,14,39,3.0,14.0,0.1841958714337377,0.8595807333574425,"(52.0, 100.0]",Q4
36061,2020-03-07,1628701,81,0,5,22,61,0.0,22.0,0.0,1.3507697238474097,"(52.0, 100.0]",Q4
36061,2020-03-08,1628701,81,0,5,24,85,0.7142857142857143,12.142857142857142,0.04385615986517564,0.7455547177079859,"(52.0, 100.0]",Q4
36061,2020-03-09,1628701,81,7,12,47,132,1.7142857142857142,18.857142857142858,0.10525478367642153,1.1578026204406369,"(52.0, 100.0]",Q4
36061,2020-03-10,1628701,81,12,24,78,210,3.4285714285714284,29.571428571428573,0.21050956735284307,1.8156450184182715,"(52.0, 100.0]",Q4
36061,2020-03-11,1628701,81,3,27,70,280,3.7142857142857144,39.0,0.22805203129891333,2.39454632863859,"(52.0, 100.0]",Q4
36061,2020-03-12,1628701,81,18,45,186,466,6.142857142857143,63.0,0.37716297484051053,3.8681133001084915,"(52.0, 100.0]",Q4
36061,2020-03-13,1628701,81,39,84,268,734,11.285714285714286,99.28571428571429,0.6929273258697751,6.096006221259414,"(52.0, 100.0]",Q4
36061,2020-03-14,1628701,81,28,112,193,927,15.285714285714286,123.71428571428571,0.9385218211147588,7.59588688864842,"(52.0, 100.0]",Q4
36061,2020-03-15,1628701,81,60,172,317,1244,23.857142857142858,165.57142857142858,1.4647957394968663,10.165857856747714,"(52.0, 100.0]",Q4
36061,2020-03-16,1628701,81,69,241,398,1642,32.714285714285715,215.71428571428572,2.0086121218250446,13.244560279283043,"(52.0, 100.0]",Q4
36061,2020-03-17,1628701,81,161,402,598,2240,54.0,290.0,3.3155256858072786,17.80560090526131,"(52.0, 100.0]",Q4
36061,2020-03-18,1628701,81,335,737,1074,3314,101.42857142857143,433.42857142857144,6.227574700854942,26.611917806188583,"(52.0, 100.0]",Q4
36061,2020-03-19,1628701,81,437,1174,1235,4549,161.28571428571428,583.2857142857143,9.902720897556659,35.81294014590243,"(52.0, 100.0]",Q4
36061,2020-03-20,1628701,81,370,1544,1263,5812,208.57142857142858,725.4285714285714,12.805998680631289,44.54031595907238,"(52.0, 100.0]",Q4
36061,2020-03-21,1628701,81,522,2066,1370,7182,279.14285714285717,893.5714285714286,17.13898727531064,54.86405599133472,"(52.0, 100.0]",Q4
36061,2020-03-22,1628701,81,607,2673,1367,8549,357.2857142857143,1043.5714285714287,21.936851164560853,64.07384956302162,"(52.0, 100.0]",Q4
36061,2020-03-23,1628701,81,405,3078,990,9539,405.2857142857143,1128.142857142857,24.883985107500656,69.26641889105841,"(52.0, 100.0]",Q4
36061,2020-03-24,1628701,81,442,3520,1065,10604,445.42857142857144,1194.857142857143,27.34870129192353,73.36258422246581,"(52.0, 100.0]",Q4
36061,2020-03-25,1628701,81,542,4062,1232,11836,475.0,1217.4285714285713,29.1643463103418,74.74843887420535,"(52.0, 100.0]",Q4
36061,2020-03-26,1628701,81,523,4585,1062,12898,487.2857142857143,1192.7142857142858,29.91867226002282,73.23101574287028,"(52.0, 100.0]",Q4
36061,2020-03-27,1628701,81,631,5216,1314,14212,524.5714285714286,1200.0,32.20796380498499,73.67834857349507,"(52.0, 100.0]",Q4
36061,2020-03-28,1628701,81,590,5806,1160,15372,534.2857142857143,1170.0,32.80440757915138,71.83638985915769,"(52.0, 100.0]",Q4
36061,2020-03-29,1628701,81,422,6228,788,16160,507.85714285714283,1087.2857142857142,31.181729664139876,66.75784654677035,"(52.0, 100.0]",Q4
36061,2020-03-30,1628701,81,648,6876,1422,17582,542.5714285714286,1149.0,33.31313903358742,70.54701875912154,"(52.0, 100.0]",Q4
36061,2020-03-31,1628701,81,497,7373,1015,18597,550.4285714285714,1141.857142857143,33.79555679210435,70.10845716046977,"(52.0, 100.0]",Q4
36061,2020-04-01,1628701,81,470,7843,1002,19599,540.1428571428571,1109.0,33.16402809004582,68.0910738066717,"(52.0, 100.0]",Q4
36061,2020-04-02,1628701,81,609,8452,1294,20893,552.4285714285714,1142.142857142857,33.918354039726836,70.12599962441584,"(52.0, 100.0]",Q4
36061,2020-04-03,1628701,81,848,9300,1820,22713,583.4285714285714,1214.4285714285713,35.82171137787546,74.56424300277162,"(52.0, 100.0]",Q4
36061,2020-04-04,1628701,81,598,9898,1278,23991,584.5714285714286,1231.2857142857142,35.89188123365974,75.59924837558977,"(52.0, 100.0]",Q4
36061,2020-04-05,1628701,81,542,10440,1162,25153,601.7142857142857,1284.7142857142858,36.94442907042396,78.87968913350491,"(52.0, 100.0]",Q4
36061,2020-04-06,1628701,81,572,11012,1249,26402,590.8571428571429,1260.0,36.27781544047329,77.36226600216983,"(52.0, 100.0]",Q4
36061,2020-04-07,1628701,81,492,11504,1257,27659,590.1428571428571,1294.5714285714287,36.23395928060811,79.48490413964434,"(52.0, 100.0]",Q4
36061,2020-04-08,1628701,81,602,12106,1424,29083,609.0,1354.857142857143,37.391761901048746,83.18636403226515,"(52.0, 100.0]",Q4
36061,2020-04-09,1628701,81,616,12722,1659,30742,610.0,1407.0,37.453160524859996,86.38786370242298,"(52.0, 100.0]",Q4
36061,2020-04-10,1628701,81,715,13437,1685,32427,591.0,1387.7142857142858,36.286586672446326,85.20374738606323,"(52.0, 100.0]",Q4
36061,2020-04-11,1628701,81,708,14145,1783,34210,606.7142857142857,1459.857142857143,37.25142218948019,89.63321953244598,"(52.0, 100.0]",Q4
36061,2020-04-12,1628701,81,356,14501,1033,35243,580.1428571428571,1441.4285714285713,35.61997304249565,88.50173060792443,"(52.0, 100.0]",Q4
36061,2020-04-13,1628701,81,379,14880,1206,36449,552.5714285714286,1435.2857142857142,33.92712527169987,88.12456763308393,"(52.0, 100.0]",Q4
36061,2020-04-14,1628701,81,1737,16617,4068,40517,730.4285714285714,1836.857142857143,44.84730907812861,112.78050070928569,"(52.0, 100.0]",Q4
36061,2020-04-15,1628701,81,474,17091,1533,42050,712.1428571428571,1852.4285714285713,43.72459138558011,113.7365649943465,"(52.0, 100.0]",Q4
36061,2020-04-16,1628701,81,399,17490,1476,43526,681.1428571428571,1826.2857142857142,41.82123404743149,112.13142954328109,"(52.0, 100.0]",Q4
36061,2020-04-17,1628701,81,442,17932,1585,45111,642.1428571428571,1812.0,39.4266877187929,111.25430634597755,"(52.0, 100.0]",Q4
36061,2020-04-18,1628701,81,288,18220,1093,46204,582.1428571428571,1713.4285714285713,35.742770290118145,105.20215628458331,"(52.0, 100.0]",Q4
36061,2020-04-19,1628701,81,248,18468,954,47158,566.7142857142857,1702.142857142857,34.79547723703035,104.50922895871354,"(52.0, 100.0]",Q4
36061,2020-04-20,1628701,81,231,18699,1099,48257,545.5714285714286,1686.857142857143,33.49733490502115,103.57070713759879,"(52.0, 100.0]",Q4
36061,2020-04-21,1628701,81,326,19025,1430,49687,344.0,1310.0,21.121126591068588,80.43219719273213,"(52.0, 100.0]",Q4
36061,2020-04-22,1628701,81,323,19348,1581,51268,322.42857142857144,1316.857142857143,19.79667056314028,80.8532163274378,"(52.0, 100.0]",Q4
36061,2020-04-23,1628701,81,506,19854,2654,53922,337.7142857142857,1485.142857142857,20.735192384255043,91.18572759167319,"(52.0, 100.0]",Q4
36061,2020-04-24,1628701,81,426,20280,2110,56032,335.42857142857144,1560.142857142857,20.594852672686482,95.79062437751664,"(52.0, 100.0]",Q4
36061,2020-04-25,1628701,81,493,20773,2354,58386,364.7142857142857,1740.2857142857142,22.392955227158684,106.85114789551393,"(52.0, 100.0]",Q4
36061,2020-04-26,1628701,81,324,21097,2007,60393,375.57142857142856,1890.7142857142858,23.05956885710935,116.0872551631199,"(52.0, 100.0]",Q4
36061,2020-04-27,1628701,81,215,21312,1650,62043,373.2857142857143,1969.4285714285713,22.919229145540786,120.92020398026227,"(52.0, 100.0]",Q4
36061,2020-04-28,1628701,81,292,21604,2260,64303,368.42857142857144,2088.0,22.621007258457595,128.20032651788142,"(52.0, 100.0]",Q4
36061,2020-04-29,1628701,81,316,21920,2299,66602,367.42857142857144,2190.5714285714284,22.559608634646352,134.49807107452062,"(52.0, 100.0]",Q4
36061,2020-04-30,1628701,81,255,22175,2205,68807,331.57142857142856,2126.4285714285716,20.35802940941453,130.55978791862788,"(52.0, 100.0]",Q4
36061,2020-05-01,1628701,81,321,22496,2606,71413,316.57142857142856,2197.285714285714,19.43705005224584,134.9103189772533,"(52.0, 100.0]",Q4
36061,2020-05-02,1628701,81,245,22741,2214,73627,281.14285714285717,2177.285714285714,17.261784522933134,133.68234650102838,"(52.0, 100.0]",Q4
36061,2020-05-03,1628701,81,159,22900,1524,75151,257.57142857142856,2108.285714285714,15.814531247382334,129.4458414580524,"(52.0, 100.0]",Q4
36061,2020-05-04,1628701,81,154,23054,2246,77397,248.85714285714286,2193.4285714285716,15.279486097027192,134.67349571398137,"(52.0, 100.0]",Q4
36061,2020-05-05,1628701,81,203,23257,2499,79896,236.14285714285714,2227.5714285714284,14.498846451427067,136.76982015553673,"(52.0, 100.0]",Q4
36061,2020-05-06,1628701,81,272,23529,2966,82862,229.85714285714286,2322.8571428571427,14.112912244613522,142.62023188155118,"(52.0, 100.0]",Q4
36061,2020-05-07,1628701,81,201,23730,3036,85898,222.14285714285714,2441.5714285714284,13.639265718069625,149.90912565114334,"(52.0, 100.0]",Q4
36061,2020-05-08,1628701,81,151,23881,2633,88531,197.85714285714286,2445.4285714285716,12.148156282653654,150.14594891441533,"(52.0, 100.0]",Q4
36061,2020-05-09,1628701,81,96,23977,2336,90867,176.57142857142858,2462.8571428571427,10.841242718671419,151.2160392151256,"(52.0, 100.0]",Q4
36061,2020-05-10,1628701,81,85,24062,1496,92363,166.0,2458.8571428571427,10.192171552666819,150.97044471988062,"(52.0, 100.0]",Q4
36061,2020-05-11,1628701,81,129,24191,1984,94347,162.42857142857142,2421.4285714285716,9.97289075334094,148.67238194294544,"(52.0, 100.0]",Q4
36061,2020-05-12,1628701,81,157,24348,2825,97172,155.85714285714286,2468.0,9.569414082581325,151.53180356615488,"(52.0, 100.0]",Q4
36061,2020-05-13,1628701,81,177,24525,3697,100869,142.28571428571428,2572.4285714285716,8.736147045142987,157.94357413844355,"(52.0, 100.0]",Q4
36061,2020-05-14,1628701,81,307,24832,3933,104802,157.42857142857142,2700.5714285714284,9.66589763428471,165.81136921825606,"(52.0, 100.0]",Q4
36061,2020-05-15,1628701,81,150,24982,3469,108271,157.28571428571428,2820.0,9.657126402311675,173.14411914771344,"(52.0, 100.0]",Q4
36061,2020-05-16,1628701,81,148,25130,3096,111367,164.71428571428572,2928.5714285714284,10.113230464909503,179.81025544722013,"(52.0, 100.0]",Q4
36061,2020-05-17,1628701,81,86,25216,2019,113386,164.85714285714286,3003.285714285714,10.122001696882538,184.39760976911748,"(52.0, 100.0]",Q4
36061,2020-05-18,1628701,81,77,25293,2830,116216,157.42857142857142,3124.1428571428573,9.66589763428471,191.81807201830523,"(52.0, 100.0]",Q4
36061,2020-05-19,1628701,81,98,25391,3685,119901,149.0,3247.0,9.148394947875637,199.36133151511544,"(52.0, 100.0]",Q4
36061,2020-05-20,1628701,81,131,25522,4219,124120,142.42857142857142,3321.5714285714284,8.744918277116023,203.93991460503975,"(52.0, 100.0]",Q4
36061,2020-05-21,1628701,81,150,25672,4363,128483,120.0,3383.0,7.367834857349507,207.71154435344488,"(52.0, 100.0]",Q4
36061,2020-05-22,1628701,81,134,25806,4582,133065,117.71428571428571,3542.0,7.227495145780945,217.47392553943297,"(52.0, 100.0]",Q4
36061,2020-05-23,1628701,81,103,25909,4187,137252,111.28571428571429,3697.8571428571427,6.832789706994365,227.04333962201426,"(52.0, 100.0]",Q4
36061,2020-05-24,1628701,81,100,26009,3356,140608,113.28571428571429,3888.8571428571427,6.955586954616857,238.77047676996222,"(52.0, 100.0]",Q4
36061,2020-05-25,1628701,81,83,26092,3635,144243,114.14285714285714,4003.8571428571427,7.008214346455068,245.83131850825552,"(52.0, 100.0]",Q4
36061,2020-05-26,1628701,81,121,26213,3599,147842,117.42857142857143,3991.5714285714284,7.209952681834875,245.0769925585745,"(52.0, 100.0]",Q4
36061,2020-05-27,1628701,81,134,26347,6888,154730,117.85714285714286,4372.857142857143,7.236266377753981,268.4874106946053,"(52.0, 100.0]",Q4
36061,2020-05-28,1628701,81,133,26480,7418,162148,115.42857142857143,4809.285714285715,7.0871554342123835,295.2835243722276,"(52.0, 100.0]",Q4
36061,2020-05-29,1628701,81,96,26576,5678,167826,110.0,4965.857142857143,6.753848619237048,304.8967946146741,"(52.0, 100.0]",Q4
36061,2020-05-30,1628701,81,77,26653,4425,172251,106.28571428571429,4999.857142857143,6.525796587938136,306.9843478242565,"(52.0, 100.0]",Q4
36061,2020-05-31,1628701,81,68,26721,4385,176636,101.71428571428571,5146.857142857143,6.2451171648010115,316.0099455245096,"(52.0, 100.0]",Q4
36061,2020-06-01,1628701,81,93,26814,5161,181797,103.14285714285714,5364.857142857143,6.332829484531363,329.39484551536117,"(52.0, 100.0]",Q4
36061,2020-06-02,1628701,81,72,26886,4211,186008,96.14285714285714,5452.285714285715,5.903039117852641,334.7628394828587,"(52.0, 100.0]",Q4
36061,2020-06-03,1628701,81,82,26968,4377,190385,88.71428571428571,5093.571428571428,5.446935055254814,312.7382759985675,"(52.0, 100.0]",Q4
36061,2020-06-04,1628701,81,69,27037,4416,194801,79.57142857142857,4664.714285714285,4.8855762089805665,286.407037615516,"(52.0, 100.0]",Q4
36061,2020-06-05,1628701,81,85,27122,5322,200123,78.0,4613.857142857143,4.78909265727718,283.28447903311553,"(52.0, 100.0]",Q4
36061,2020-06-06,1628701,81,56,27178,4711,204834,75.0,4654.714285714285,4.604896785843442,285.7930513774035,"(52.0, 100.0]",Q4
36061,2020-06-07,1628701,81,39,27217,4045,208879,70.85714285714286,4606.142857142857,4.350531058625424,282.8108325065716,"(52.0, 100.0]",Q4
36063,2020-03-02,210433,34,0,0,0,0,0.0,0.0,0.0,0.0,"(24.0, 37.5]",Q2
36063,2020-03-03,210433,34,0,0,0,0,0.0,0.0,0.0,0.0,"(24.0, 37.5]",Q2
36063,2020-03-04,210433,34,0,0,0,0,0.0,0.0,0.0,0.0,"(24.0, 37.5]",Q2
36063,2020-03-05,210433,34,0,0,0,0,0.0,0.0,0.0,0.0,"(24.0, 37.5]",Q2
36063,2020-03-06,210433,34,0,0,0,0,0.0,0.0,0.0,0.0,"(24.0, 37.5]",Q2
36063,2020-03-07,210433,34,0,0,0,0,0.0,0.0,0.0,0.0,"(24.0, 37.5]",Q2
36063,2020-03-08,210433,34,0,0,1,1,0.0,0.14285714285714285,0.0,0.0678872338735573,"(24.0, 37.5]",Q2
36063,2020-03-09,210433,34,0,0,0,1,0.0,0.14285714285714285,0.0,0.0678872338735573,"(24.0, 37.5]",Q2
36063,2020-03-10,210433,34,0,0,0,1,0.0,0.14285714285714285,0.0,0.0678872338735573,"(24.0, 37.5]",Q2
36063,2020-03-11,210433,34,0,0,1,2,0.0,0.2857142857142857,0.0,0.1357744677471146,"(24.0, 37.5]",Q2
36063,2020-03-12,210433,34,0,0,1,3,0.0,0.42857142857142855,0.0,0.20366170162067193,"(24.0, 37.5]",Q2
36063,2020-03-13,210433,34,0,0,0,3,0.0,0.42857142857142855,0.0,0.20366170162067193,"(24.0, 37.5]",Q2
36063,2020-03-14,210433,34,0,0,1,4,0.0,0.5714285714285714,0.0,0.2715489354942292,"(24.0, 37.5]",Q2
36063,2020-03-15,210433,34,0,0,0,4,0.0,0.42857142857142855,0.0,0.20366170162067193,"(24.0, 37.5]",Q2
36063,2020-03-16,210433,34,0,0,1,5,0.0,0.5714285714285714,0.0,0.2715489354942292,"(24.0, 37.5]",Q2
36063,2020-03-17,210433,34,0,0,1,6,0.0,0.7142857142857143,0.0,0.33943616936778653,"(24.0, 37.5]",Q2
36063,2020-03-18,210433,34,1,1,10,16,0.14285714285714285,2.0,0.0678872338735573,0.9504212742298024,"(24.0, 37.5]",Q2
36063,2020-03-19,210433,34,2,3,4,20,0.42857142857142855,2.4285714285714284,0.20366170162067193,1.1540829758504743,"(24.0, 37.5]",Q2
36063,2020-03-20,210433,34,1,4,6,26,0.5714285714285714,3.2857142857142856,0.2715489354942292,1.5614063790918182,"(24.0, 37.5]",Q2
36063,2020-03-21,210433,34,2,6,9,35,0.8571428571428571,4.428571428571429,0.40732340324134386,2.104504250080277,"(24.0, 37.5]",Q2
36063,2020-03-22,210433,34,4,10,38,73,1.4285714285714286,9.857142857142858,0.6788723387355731,4.684219137275455,"(24.0, 37.5]",Q2
36063,2020-03-23,210433,34,1,11,15,88,1.5714285714285714,11.857142857142858,0.7467595726091304,5.634640411505257,"(24.0, 37.5]",Q2
36063,2020-03-24,210433,34,1,12,16,104,1.7142857142857142,14.0,0.8146468064826877,6.652948919608616,"(24.0, 37.5]",Q2
36063,2020-03-25,210433,34,2,14,10,114,1.8571428571428572,14.0,0.882534040356245,6.652948919608616,"(24.0, 37.5]",Q2
36063,2020-03-26,210433,34,9,23,55,169,2.857142857142857,21.285714285714285,1.3577446774711461,10.11519784716004,"(24.0, 37.5]",Q2
36063,2020-03-27,210433,34,10,33,57,226,4.142857142857143,28.571428571428573,1.9687297823331622,13.577446774711463,"(24.0, 37.5]",Q2
36063,2020-03-28,210433,34,5,38,18,244,4.571428571428571,29.857142857142858,2.1723914839538336,14.188431879573479,"(24.0, 37.5]",Q2
36063,2020-03-29,210433,34,3,41,6,250,4.428571428571429,25.285714285714285,2.104504250080277,12.016040395619642,"(24.0, 37.5]",Q2
36063,2020-03-30,210433,34,1,42,15,265,4.428571428571429,25.285714285714285,2.104504250080277,12.016040395619642,"(24.0, 37.5]",Q2
36063,2020-03-31,210433,34,4,46,13,278,4.857142857142857,24.857142857142858,2.3081659517009485,11.812378693998973,"(24.0, 37.5]",Q2
36063,2020-04-01,210433,34,30,76,89,367,8.857142857142858,36.142857142857146,4.209008500160554,17.17547017001,"(24.0, 37.5]",Q2
36063,2020-04-02,210433,34,18,94,61,428,10.142857142857142,37.0,4.819993605022569,17.582793573251344,"(24.0, 37.5]",Q2
36063,2020-04-03,210433,34,7,101,47,475,9.714285714285714,35.57142857142857,4.616331903401897,16.903921234515767,"(24.0, 37.5]",Q2
36063,2020-04-04,210433,34,15,116,54,529,11.142857142857142,40.714285714285715,5.29520424213747,19.347861653963836,"(24.0, 37.5]",Q2
36063,2020-04-05,210433,34,4,120,44,573,11.285714285714286,46.142857142857146,5.363091476011028,21.927576541159013,"(24.0, 37.5]",Q2
36063,2020-04-06,210433,34,6,126,44,617,12.0,50.285714285714285,5.702527645378814,23.896306323492173,"(24.0, 37.5]",Q2
36063,2020-04-07,210433,34,8,134,39,656,12.571428571428571,54.0,5.974076580873043,25.661374404204665,"(24.0, 37.5]",Q2
36063,2020-04-08,210433,34,12,146,53,709,10.0,48.857142857142854,4.7521063711490115,23.2174339847566,"(24.0, 37.5]",Q2
36063,2020-04-09,210433,34,10,156,79,788,8.857142857142858,51.42857142857143,4.209008500160554,24.439404194480634,"(24.0, 37.5]",Q2
36063,2020-04-10,210433,34,11,167,46,834,9.428571428571429,51.285714285714285,4.480557435654783,24.371516960607075,"(24.0, 37.5]",Q2
36063,2020-04-11,210433,34,16,183,62,896,9.571428571428571,52.42857142857143,4.548444669528339,24.914614831595532,"(24.0, 37.5]",Q2
36063,2020-04-12,210433,34,6,189,29,925,9.857142857142858,50.285714285714285,4.684219137275455,23.896306323492173,"(24.0, 37.5]",Q2
36063,2020-04-13,210433,34,8,197,48,973,10.142857142857142,50.857142857142854,4.819993605022569,24.1678552589864,"(24.0, 37.5]",Q2
36063,2020-04-14,210433,34,7,204,57,1030,10.0,53.42857142857143,4.7521063711490115,25.389825468710438,"(24.0, 37.5]",Q2
36063,2020-04-15,210433,34,12,216,82,1112,10.0,57.57142857142857,4.7521063711490115,27.358555251043597,"(24.0, 37.5]",Q2
36063,2020-04-16,210433,34,11,227,56,1168,10.142857142857142,54.285714285714285,4.819993605022569,25.797148871951777,"(24.0, 37.5]",Q2
36063,2020-04-17,210433,34,7,234,53,1221,9.571428571428571,55.285714285714285,4.548444669528339,26.272359509066675,"(24.0, 37.5]",Q2
36063,2020-04-18,210433,34,12,246,69,1290,9.0,56.285714285714285,4.2768957340341105,26.74757014618158,"(24.0, 37.5]",Q2
36063,2020-04-19,210433,34,9,255,48,1338,9.428571428571429,59.0,4.480557435654783,28.03742758977917,"(24.0, 37.5]",Q2
36063,2020-04-20,210433,34,5,260,53,1391,9.0,59.714285714285715,4.2768957340341105,28.376863759146957,"(24.0, 37.5]",Q2
36063,2020-04-21,210433,34,8,268,49,1440,9.142857142857142,58.57142857142857,4.344782967907667,27.833765888158496,"(24.0, 37.5]",Q2
36063,2020-04-22,210433,34,27,295,195,1635,11.285714285714286,74.71428571428571,5.363091476011028,35.505023315870474,"(24.0, 37.5]",Q2
36063,2020-04-23,210433,34,37,332,192,1827,15.0,94.14285714285714,7.128159556723517,44.73768712267427,"(24.0, 37.5]",Q2
36063,2020-04-24,210433,34,12,344,107,1934,15.714285714285714,101.85714285714286,7.467595726091304,48.40359775184636,"(24.0, 37.5]",Q2
36063,2020-04-25,210433,34,24,368,142,2076,17.428571428571427,112.28571428571429,8.28224253257399,53.35936582461604,"(24.0, 37.5]",Q2
36063,2020-04-26,210433,34,10,378,95,2171,17.571428571428573,119.0,8.35012976644755,56.55006581667324,"(24.0, 37.5]",Q2
36063,2020-04-27,210433,34,8,386,89,2260,18.0,124.14285714285714,8.553791468068221,58.9940062361213,"(24.0, 37.5]",Q2
36063,2020-04-28,210433,34,15,401,130,2390,19.0,135.71428571428572,9.029002105183123,64.49287217987944,"(24.0, 37.5]",Q2
36063,2020-04-29,210433,34,19,420,154,2544,17.857142857142858,129.85714285714286,8.485904234194663,61.7094955910636,"(24.0, 37.5]",Q2
36063,2020-04-30,210433,34,20,440,239,2783,15.428571428571429,136.57142857142858,7.33182125834419,64.9001955831208,"(24.0, 37.5]",Q2
36063,2020-05-01,210433,34,17,457,269,3052,16.142857142857142,159.71428571428572,7.671257427711976,75.89792747063707,"(24.0, 37.5]",Q2
36063,2020-05-02,210433,34,17,474,184,3236,15.142857142857142,165.71428571428572,7.196046790597075,78.74919129332649,"(24.0, 37.5]",Q2
36063,2020-05-03,210433,34,19,493,318,3554,16.428571428571427,197.57142857142858,7.80703189545909,93.88804444712977,"(24.0, 37.5]",Q2
36063,2020-05-04,210433,34,15,508,198,3752,17.428571428571427,213.14285714285714,8.28224253257399,101.28775293934751,"(24.0, 37.5]",Q2
36063,2020-05-05,210433,34,41,549,353,4105,21.142857142857142,245.0,10.047310613286482,116.42660609315078,"(24.0, 37.5]",Q2
36063,2020-05-06,210433,34,39,588,282,4387,24.0,263.2857142857143,11.405055290757629,125.11617202896612,"(24.0, 37.5]",Q2
36063,2020-05-07,210433,34,17,605,257,4644,23.571428571428573,265.85714285714283,11.201393589136957,126.33814223869015,"(24.0, 37.5]",Q2
36063,2020-05-08,210433,34,22,627,273,4917,24.285714285714285,266.42857142857144,11.540829758504742,126.60969117418439,"(24.0, 37.5]",Q2
36063,2020-05-09,210433,34,16,643,359,5276,24.142857142857142,291.42857142857144,11.472942524631186,138.4899571020569,"(24.0, 37.5]",Q2
36063,2020-05-10,210433,34,12,655,176,5452,23.142857142857142,271.14285714285717,10.997731887516284,128.84996989201179,"(24.0, 37.5]",Q2
36063,2020-05-11,210433,34,16,671,186,5638,23.285714285714285,269.42857142857144,11.065619121389842,128.0353230855291,"(24.0, 37.5]",Q2
36063,2020-05-12,210433,34,19,690,343,5981,20.142857142857142,268.0,9.57209997617158,127.35645074679351,"(24.0, 37.5]",Q2
36063,2020-05-13,210433,34,20,710,330,6311,17.428571428571427,274.85714285714283,8.28224253257399,130.61503797272425,"(24.0, 37.5]",Q2
36063,2020-05-14,210433,34,33,743,530,6841,19.714285714285715,313.85714285714283,9.36843827455091,149.1482528202054,"(24.0, 37.5]",Q2
36063,2020-05-15,210433,34,27,770,383,7224,20.428571428571427,329.57142857142856,9.707874443918696,156.61584854629672,"(24.0, 37.5]",Q2
36063,2020-05-16,210433,34,22,792,421,7645,21.285714285714285,338.42857142857144,10.11519784716004,160.82485704645728,"(24.0, 37.5]",Q2
36063,2020-05-17,210433,34,26,818,325,7970,23.285714285714285,359.7142857142857,11.065619121389842,170.94005489361732,"(24.0, 37.5]",Q2
36063,2020-05-18,210433,34,27,845,271,8241,24.857142857142858,371.85714285714283,11.812378693998973,176.71046977286966,"(24.0, 37.5]",Q2
36063,2020-05-19,210433,34,13,858,370,8611,24.0,375.7142857142857,11.405055290757629,178.54342508745572,"(24.0, 37.5]",Q2
36063,2020-05-20,210433,34,22,880,540,9151,24.285714285714285,405.7142857142857,11.540829758504742,192.79974420090278,"(24.0, 37.5]",Q2
36063,2020-05-21,210433,34,17,897,655,9806,22.0,423.57142857142856,10.454634016527825,201.28564843509741,"(24.0, 37.5]",Q2
36063,2020-05-22,210433,34,30,927,501,10307,22.428571428571427,440.42857142857144,10.658295718148496,209.2963420321772,"(24.0, 37.5]",Q2
36063,2020-05-23,210433,34,14,941,355,10662,21.285714285714285,431.0,10.11519784716004,204.8157845965224,"(24.0, 37.5]",Q2
36063,2020-05-24,210433,34,14,955,501,11163,19.571428571428573,456.14285714285717,9.300551040677352,216.7639377582685,"(24.0, 37.5]",Q2
36063,2020-05-25,210433,34,10,965,366,11529,17.142857142857142,469.7142857142857,8.146468064826877,223.21322497625644,"(24.0, 37.5]",Q2
36063,2020-05-26,210433,34,7,972,247,11776,16.285714285714285,452.14285714285717,7.7391446615855335,214.8630952098089,"(24.0, 37.5]",Q2
36063,2020-05-27,210433,34,12,984,502,12278,14.857142857142858,446.7142857142857,7.06027232284996,212.28338032261374,"(24.0, 37.5]",Q2
36063,2020-05-28,210433,34,24,1008,583,12861,15.857142857142858,436.42857142857144,7.535482959964861,207.3954994837176,"(24.0, 37.5]",Q2
36063,2020-05-29,210433,34,12,1020,447,13308,13.285714285714286,428.7142857142857,6.31351275024083,203.72958885454548,"(24.0, 37.5]",Q2
36063,2020-05-30,210433,34,17,1037,495,13803,13.714285714285714,448.7142857142857,6.517174451861502,213.2338015968435,"(24.0, 37.5]",Q2
36063,2020-05-31,210433,34,9,1046,420,14223,13.0,437.14285714285717,6.177738282493716,207.7349356530854,"(24.0, 37.5]",Q2
36063,2020-06-01,210433,34,2,1048,485,14708,11.857142857142858,454.14285714285717,5.634640411505257,215.81351648403873,"(24.0, 37.5]",Q2
36063,2020-06-02,210433,34,19,1067,655,15363,13.571428571428571,512.4285714285714,6.449287217987944,243.51150790445007,"(24.0, 37.5]",Q2
36063,2020-06-03,210433,34,18,1085,739,16102,14.428571428571429,546.2857142857143,6.856610621229289,259.6007823324832,"(24.0, 37.5]",Q2
36063,2020-06-04,210433,34,14,1099,726,16828,13.0,566.7142857142857,6.177738282493716,269.30865677640185,"(24.0, 37.5]",Q2
36063,2020-06-05,210433,34,10,1109,999,17827,12.714285714285714,645.5714285714286,6.0419638147466,306.7824098746055,"(24.0, 37.5]",Q2
36063,2020-06-06,210433,34,3,1112,521,18348,10.714285714285714,649.2857142857143,5.091542540516798,308.547477955318,"(24.0, 37.5]",Q2
36063,2020-06-07,210433,34,4,1116,419,18767,10.0,649.1428571428571,4.7521063711490115,308.4795907214444,"(24.0, 37.5]",Q2
36065,2020-03-02,229577,56,0,0,0,0,0.0,0.0,0.0,0.0,"(52.0, 100.0]",Q4
36065,2020-03-03,229577,56,0,0,0,0,0.0,0.0,0.0,0.0,"(52.0, 100.0]",Q4
36065,2020-03-04,229577,56,0,0,2,2,0.0,2.0,0.0,0.8711674078849363,"(52.0, 100.0]",Q4
36065,2020-03-05,229577,56,0,0,0,2,0.0,0.0,0.0,0.0,"(52.0, 100.0]",Q4
36065,2020-03-06,229577,56,0,0,0,2,0.0,0.0,0.0,0.0,"(52.0, 100.0]",Q4
36065,2020-03-07,229577,56,0,0,0,2,0.0,0.0,0.0,0.0,"(52.0, 100.0]",Q4
36065,2020-03-08,229577,56,0,0,0,2,0.0,0.2857142857142857,0.0,0.12445248684070517,"(52.0, 100.0]",Q4
36065,2020-03-09,229577,56,0,0,0,2,0.0,0.2857142857142857,0.0,0.12445248684070517,"(52.0, 100.0]",Q4
36065,2020-03-10,229577,56,0,0,0,2,0.0,0.2857142857142857,0.0,0.12445248684070517,"(52.0, 100.0]",Q4
36065,2020-03-11,229577,56,0,0,1,3,0.0,0.14285714285714285,0.0,0.06222624342035259,"(52.0, 100.0]",Q4
36065,2020-03-12,229577,56,0,0,1,4,0.0,0.2857142857142857,0.0,0.12445248684070517,"(52.0, 100.0]",Q4
36065,2020-03-13,229577,56,0,0,1,5,0.0,0.42857142857142855,0.0,0.18667873026105775,"(52.0, 100.0]",Q4
36065,2020-03-14,229577,56,0,0,1,6,0.0,0.5714285714285714,0.0,0.24890497368141035,"(52.0, 100.0]",Q4
36065,2020-03-15,229577,56,0,0,3,9,0.0,1.0,0.0,0.43558370394246815,"(52.0, 100.0]",Q4
36065,2020-03-16,229577,56,0,0,1,10,0.0,1.1428571428571428,0.0,0.4978099473628207,"(52.0, 100.0]",Q4
36065,2020-03-17,229577,56,0,0,4,14,0.0,1.7142857142857142,0.0,0.746714921044231,"(52.0, 100.0]",Q4
36065,2020-03-18,229577,56,2,2,14,28,0.2857142857142857,3.5714285714285716,0.12445248684070517,1.5556560855088146,"(52.0, 100.0]",Q4
36065,2020-03-19,229577,56,0,2,7,35,0.2857142857142857,4.428571428571429,0.12445248684070517,1.9290135460309303,"(52.0, 100.0]",Q4
36065,2020-03-20,229577,56,2,4,59,94,0.5714285714285714,12.714285714285714,0.24890497368141035,5.538135664411381,"(52.0, 100.0]",Q4
36065,2020-03-21,229577,56,1,5,30,124,0.7142857142857143,16.857142857142858,0.31113121710176295,7.342696723601605,"(52.0, 100.0]",Q4
36065,2020-03-22,229577,56,2,7,36,160,1.0,21.571428571428573,0.43558370394246815,9.396162756473242,"(52.0, 100.0]",Q4
36065,2020-03-23,229577,56,1,8,24,184,1.1428571428571428,24.857142857142858,0.4978099473628207,10.82736635514135,"(52.0, 100.0]",Q4
36065,2020-03-24,229577,56,1,9,48,232,1.2857142857142858,31.142857142857142,0.5600361907831733,13.565321065636864,"(52.0, 100.0]",Q4
36065,2020-03-25,229577,56,4,13,22,254,1.5714285714285714,32.285714285714285,0.6844886776238784,14.063131012999685,"(52.0, 100.0]",Q4
36065,2020-03-26,229577,56,0,13,41,295,1.5714285714285714,37.142857142857146,0.6844886776238784,16.178823289291675,"(52.0, 100.0]",Q4
36065,2020-03-27,229577,56,10,23,43,338,2.7142857142857144,34.857142857142854,1.1822986249866991,15.18320339456603,"(52.0, 100.0]",Q4
36065,2020-03-28,229577,56,3,26,26,364,3.0,34.285714285714285,1.3067511118274042,14.934298420884621,"(52.0, 100.0]",Q4
36065,2020-03-29,229577,56,8,34,26,390,3.857142857142857,32.857142857142854,1.6801085723495197,14.312035986681094,"(52.0, 100.0]",Q4
36065,2020-03-30,229577,56,6,40,57,447,4.571428571428571,37.57142857142857,1.9912397894512828,16.36550201955273,"(52.0, 100.0]",Q4
36065,2020-03-31,229577,56,10,50,58,505,5.857142857142857,39.0,2.551275980234456,16.987764453756256,"(52.0, 100.0]",Q4
36065,2020-04-01,229577,56,11,61,82,587,6.857142857142857,47.57142857142857,2.986859684176924,20.72133905897741,"(52.0, 100.0]",Q4
36065,2020-04-02,229577,56,10,71,77,664,8.285714285714286,52.714285714285715,3.6091221183804505,22.961483822110104,"(52.0, 100.0]",Q4
36065,2020-04-03,229577,56,9,80,58,722,8.142857142857142,54.857142857142854,3.546895874960097,23.89487747341539,"(52.0, 100.0]",Q4
36065,2020-04-04,229577,56,7,87,55,777,8.714285714285714,59.0,3.7958008486415076,25.69943853260562,"(52.0, 100.0]",Q4
36065,2020-04-05,229577,56,13,100,87,864,9.428571428571429,67.71428571428571,4.106932065743271,29.495239381247124,"(52.0, 100.0]",Q4
36065,2020-04-06,229577,56,18,118,90,954,11.142857142857142,72.42857142857143,4.853646986787501,31.54870541411876,"(52.0, 100.0]",Q4
36065,2020-04-07,229577,56,7,125,59,1013,10.714285714285714,72.57142857142857,4.666968256526443,31.610931657539115,"(52.0, 100.0]",Q4
36065,2020-04-08,229577,56,33,158,104,1117,13.857142857142858,75.71428571428571,6.035945611774201,32.97990901278687,"(52.0, 100.0]",Q4
36065,2020-04-09,229577,56,14,172,85,1202,14.428571428571429,76.85714285714286,6.284850585455611,33.47771896014969,"(52.0, 100.0]",Q4
36065,2020-04-10,229577,56,9,181,42,1244,14.428571428571429,74.57142857142857,6.284850585455611,32.482099065424045,"(52.0, 100.0]",Q4
36065,2020-04-11,229577,56,14,195,83,1327,15.428571428571429,78.57142857142857,6.720434289398079,34.224433881193924,"(52.0, 100.0]",Q4
36065,2020-04-12,229577,56,11,206,61,1388,15.142857142857142,74.85714285714286,6.5959818025573735,32.606551552264754,"(52.0, 100.0]",Q4
36065,2020-04-13,229577,56,23,229,100,1488,15.857142857142858,76.28571428571429,6.907113019659137,33.22881398646828,"(52.0, 100.0]",Q4
36065,2020-04-14,229577,56,17,246,79,1567,17.285714285714285,79.14285714285714,7.529375453862662,34.47333885487533,"(52.0, 100.0]",Q4
36065,2020-04-15,229577,56,3,249,32,1599,13.0,68.85714285714286,5.662588151252086,29.99304932860995,"(52.0, 100.0]",Q4
36065,2020-04-16,229577,56,12,261,82,1681,12.714285714285714,68.42857142857143,5.538135664411381,29.806370598348888,"(52.0, 100.0]",Q4
36065,2020-04-17,229577,56,7,268,85,1766,12.428571428571429,74.57142857142857,5.413683177570675,32.482099065424045,"(52.0, 100.0]",Q4
36065,2020-04-18,229577,56,7,275,52,1818,11.428571428571429,70.14285714285714,4.978099473628207,30.553085519393118,"(52.0, 100.0]",Q4
36065,2020-04-19,229577,56,4,279,75,1893,10.428571428571429,72.14285714285714,4.542515769685739,31.424252927278054,"(52.0, 100.0]",Q4
36065,2020-04-20,229577,56,5,284,133,2026,7.857142857142857,76.85714285714286,3.422443388119392,33.47771896014969,"(52.0, 100.0]",Q4
36065,2020-04-21,229577,56,17,301,117,2143,7.857142857142857,82.28571428571429,3.422443388119392,35.842316210123094,"(52.0, 100.0]",Q4
36065,2020-04-22,229577,56,16,317,174,2317,9.714285714285714,102.57142857142857,4.231384552583975,44.67844277581316,"(52.0, 100.0]",Q4
36065,2020-04-23,229577,56,6,323,67,2384,8.857142857142858,100.42857142857143,3.8580270920618607,43.745049124507865,"(52.0, 100.0]",Q4
36065,2020-04-24,229577,56,41,364,401,2785,13.714285714285714,145.57142857142858,5.973719368353848,63.40854204533929,"(52.0, 100.0]",Q4
36065,2020-04-25,229577,56,20,384,112,2897,15.571428571428571,154.14285714285714,6.782660532818432,67.14211665056044,"(52.0, 100.0]",Q4
36065,2020-04-26,229577,56,13,397,128,3025,16.857142857142858,161.71428571428572,7.342696723601605,70.44010755183913,"(52.0, 100.0]",Q4
36065,2020-04-27,229577,56,14,411,132,3157,18.142857142857142,161.57142857142858,7.902732914384779,70.37788130841878,"(52.0, 100.0]",Q4
36065,2020-04-28,229577,56,11,422,124,3281,17.285714285714285,162.57142857142858,7.529375453862662,70.81346501236125,"(52.0, 100.0]",Q4
36065,2020-04-29,229577,56,17,439,145,3426,17.428571428571427,158.42857142857142,7.591601697283015,69.00890395317101,"(52.0, 100.0]",Q4
36065,2020-04-30,229577,56,12,451,149,3575,18.285714285714285,170.14285714285714,7.964959157805131,74.11145591363993,"(52.0, 100.0]",Q4
36065,2020-05-01,229577,56,23,474,185,3760,15.714285714285714,139.28571428571428,6.844886776238784,60.670587334843766,"(52.0, 100.0]",Q4
36065,2020-05-02,229577,56,15,489,149,3909,15.0,144.57142857142858,6.533755559137022,62.972958341396826,"(52.0, 100.0]",Q4
36065,2020-05-03,229577,56,61,550,241,4150,21.857142857142858,160.71428571428572,9.520615243313946,70.00452384789666,"(52.0, 100.0]",Q4
36065,2020-05-04,229577,56,24,574,247,4397,23.285714285714285,177.14285714285714,10.14287767751747,77.1605418412372,"(52.0, 100.0]",Q4
36065,2020-05-05,229577,56,5,579,234,4631,22.428571428571427,192.85714285714286,9.769520216995355,84.00542861747599,"(52.0, 100.0]",Q4
36065,2020-05-06,229577,56,30,609,375,5006,24.285714285714285,225.71428571428572,10.57846138145994,98.3174646041571,"(52.0, 100.0]",Q4
36065,2020-05-07,229577,56,11,620,323,5329,24.142857142857142,250.57142857142858,10.516235138039587,109.14483095929843,"(52.0, 100.0]",Q4
36065,2020-05-08,229577,56,18,638,296,5625,23.428571428571427,266.42857142857144,10.205103920937823,116.0519439789576,"(52.0, 100.0]",Q4
36065,2020-05-09,229577,56,22,660,329,5954,24.428571428571427,292.14285714285717,10.640687624880291,127.25266779462105,"(52.0, 100.0]",Q4
36065,2020-05-10,229577,56,9,669,269,6223,17.0,296.14285714285717,7.404922967021958,128.9950026103909,"(52.0, 100.0]",Q4
36065,2020-05-11,229577,56,7,676,161,6384,14.571428571428571,283.85714285714283,6.347076828875964,123.64354567624058,"(52.0, 100.0]",Q4
36065,2020-05-12,229577,56,10,686,397,6781,15.285714285714286,307.14285714285717,6.6582080459777275,133.78642335375807,"(52.0, 100.0]",Q4
36065,2020-05-13,229577,56,12,698,376,7157,12.714285714285714,307.2857142857143,5.538135664411381,133.84864959717842,"(52.0, 100.0]",Q4
36065,2020-05-14,229577,56,15,713,268,7425,13.285714285714286,299.42857142857144,5.787040638092791,130.42620620905902,"(52.0, 100.0]",Q4
36065,2020-05-15,229577,56,38,751,342,7767,16.142857142857142,306.0,7.031565506499843,133.28861340639523,"(52.0, 100.0]",Q4
36065,2020-05-16,229577,56,9,760,209,7976,14.285714285714286,288.85714285714283,6.2226243420352585,125.82146419595293,"(52.0, 100.0]",Q4
36065,2020-05-17,229577,56,12,772,318,8294,14.714285714285714,295.85714285714283,6.409303072296317,128.8705501235502,"(52.0, 100.0]",Q4
36065,2020-05-18,229577,56,13,785,326,8620,15.571428571428571,319.42857142857144,6.782660532818432,139.1378802879084,"(52.0, 100.0]",Q4
36065,2020-05-19,229577,56,17,802,775,9395,16.571428571428573,373.42857142857144,7.218244236760901,162.65940030080168,"(52.0, 100.0]",Q4
36065,2020-05-20,229577,56,15,817,779,10174,17.0,431.0,7.404922967021958,187.73657639920376,"(52.0, 100.0]",Q4
36065,2020-05-21,229577,56,11,828,815,10989,16.428571428571427,509.14285714285717,7.156017993340547,221.77433155013662,"(52.0, 100.0]",Q4
36065,2020-05-22,229577,56,36,864,1305,12294,16.142857142857142,646.7142857142857,7.031565506499843,281.6982039639361,"(52.0, 100.0]",Q4
36065,2020-05-23,229577,56,14,878,659,12953,16.857142857142858,711.0,7.342696723601605,309.7000135030948,"(52.0, 100.0]",Q4
36065,2020-05-24,229577,56,27,905,930,13883,19.0,798.4285714285714,8.276090374906893,347.7824744763506,"(52.0, 100.0]",Q4
36065,2020-05-25,229577,56,12,917,427,14310,18.857142857142858,812.8571428571429,8.213864131486542,354.06732506180623,"(52.0, 100.0]",Q4
36065,2020-05-26,229577,56,12,929,488,14798,18.142857142857142,771.8571428571429,7.902732914384779,336.20839320016506,"(52.0, 100.0]",Q4
36065,2020-05-27,229577,56,30,959,927,15725,20.285714285714285,793.0,8.836126565690067,345.4178772263772,"(52.0, 100.0]",Q4
36065,2020-05-28,229577,56,29,988,1284,17009,22.857142857142858,860.0,9.956198947256414,374.6019853905226,"(52.0, 100.0]",Q4
36065,2020-05-29,229577,56,18,1006,757,17766,20.285714285714285,781.7142857142857,8.836126565690067,340.5020039961693,"(52.0, 100.0]",Q4
36065,2020-05-30,229577,56,21,1027,1108,18874,21.285714285714285,845.8571428571429,9.271710269632536,368.4415872919077,"(52.0, 100.0]",Q4
36065,2020-05-31,229577,56,9,1036,677,19551,18.714285714285715,809.7142857142857,8.151637888066189,352.6983477065585,"(52.0, 100.0]",Q4
36065,2020-06-01,229577,56,13,1049,613,20164,18.857142857142858,836.2857142857143,8.213864131486542,364.2724289827441,"(52.0, 100.0]",Q4
36065,2020-06-02,229577,56,9,1058,1128,21292,18.428571428571427,927.7142857142857,8.027185401225482,404.0972247717697,"(52.0, 100.0]",Q4
36065,2020-06-03,229577,56,11,1069,892,22184,15.714285714285714,922.7142857142857,6.844886776238784,401.91930625205737,"(52.0, 100.0]",Q4
36065,2020-06-04,229577,56,8,1077,1050,23234,12.714285714285714,889.2857142857143,5.538135664411381,387.3583652916949,"(52.0, 100.0]",Q4
36065,2020-06-05,229577,56,50,1127,1505,24739,17.285714285714285,996.1428571428571,7.529375453862662,433.9035953701185,"(52.0, 100.0]",Q4
36065,2020-06-06,229577,56,16,1143,1276,26015,16.571428571428573,1020.1428571428571,7.218244236760901,444.3576042647378,"(52.0, 100.0]",Q4
36065,2020-06-07,229577,56,27,1170,1207,27222,19.142857142857142,1095.857142857143,8.338316618327246,477.33751327752475,"(52.0, 100.0]",Q4
36067,2020-03-02,461809,45,0,0,0,0,0.0,0.0,0.0,0.0,"(37.5, 52.0]",Q3
36067,2020-03-03,461809,45,0,0,0,0,0.0,0.0,0.0,0.0,"(37.5, 52.0]",Q3
36067,2020-03-04,461809,45,0,0,0,0,0.0,0.0,0.0,0.0,"(37.5, 52.0]",Q3
36067,2020-03-05,461809,45,0,0,0,0,0.0,0.0,0.0,0.0,"(37.5, 52.0]",Q3
36067,2020-03-06,461809,45,0,0,0,0,0.0,0.0,0.0,0.0,"(37.5, 52.0]",Q3
36067,2020-03-07,461809,45,0,0,0,0,0.0,0.0,0.0,0.0,"(37.5, 52.0]",Q3
36067,2020-03-08,461809,45,0,0,0,0,0.0,0.0,0.0,0.0,"(37.5, 52.0]",Q3
36067,2020-03-09,461809,45,0,0,1,1,0.0,0.14285714285714285,0.0,0.030934248327153187,"(37.5, 52.0]",Q3
36067,2020-03-10,461809,45,0,0,0,1,0.0,0.14285714285714285,0.0,0.030934248327153187,"(37.5, 52.0]",Q3
36067,2020-03-11,461809,45,0,0,3,4,0.0,0.5714285714285714,0.0,0.12373699330861275,"(37.5, 52.0]",Q3
36067,2020-03-12,461809,45,0,0,1,5,0.0,0.7142857142857143,0.0,0.15467124163576593,"(37.5, 52.0]",Q3
36067,2020-03-13,461809,45,0,0,9,14,0.0,2.0,0.0,0.4330794765801446,"(37.5, 52.0]",Q3
36067,2020-03-14,461809,45,0,0,18,32,0.0,4.571428571428571,0.0,0.989895946468902,"(37.5, 52.0]",Q3
36067,2020-03-15,461809,45,1,1,27,59,0.14285714285714285,8.428571428571429,0.030934248327153187,1.8251206513020382,"(37.5, 52.0]",Q3
36067,2020-03-16,461809,45,1,2,55,114,0.2857142857142857,16.142857142857142,0.061868496654306375,3.4955700609683102,"(37.5, 52.0]",Q3
36067,2020-03-17,461809,45,0,2,15,129,0.2857142857142857,18.285714285714285,0.061868496654306375,3.959583785875608,"(37.5, 52.0]",Q3
36067,2020-03-18,461809,45,3,5,98,227,0.7142857142857143,31.857142857142858,0.15467124163576593,6.89833737695516,"(37.5, 52.0]",Q3
36067,2020-03-19,461809,45,3,8,60,287,1.1428571428571428,40.285714285714285,0.2474739866172255,8.723458028257198,"(37.5, 52.0]",Q3
36067,2020-03-20,461809,45,9,17,133,420,2.4285714285714284,58.0,0.5258822215616041,12.559304820824194,"(37.5, 52.0]",Q3
36067,2020-03-21,461809,45,12,29,157,577,4.142857142857143,77.85714285714286,0.8970932014874425,16.859165338298485,"(37.5, 52.0]",Q3
36067,2020-03-22,461809,45,23,52,538,1115,7.285714285714286,150.85714285714286,1.5776466646848126,32.666566233473766,"(37.5, 52.0]",Q3
36067,2020-03-23,461809,45,8,60,129,1244,8.285714285714286,161.42857142857142,1.794186402974885,34.9557006096831,"(37.5, 52.0]",Q3
36067,2020-03-24,461809,45,5,65,124,1368,9.0,177.0,1.9488576446106507,38.3275336773428,"(37.5, 52.0]",Q3
36067,2020-03-25,461809,45,18,83,266,1634,11.142857142857142,201.0,2.4128713695179482,43.52448739630453,"(37.5, 52.0]",Q3
36067,2020-03-26,461809,45,32,115,444,2078,15.285714285714286,255.85714285714286,3.309964571005391,55.403238753931355,"(37.5, 52.0]",Q3
36067,2020-03-27,461809,45,14,129,352,2430,16.0,287.14285714285717,3.464635812641157,62.17783913757791,"(37.5, 52.0]",Q3
36067,2020-03-28,461809,45,23,152,487,2917,17.571428571428573,334.2857142857143,3.804912544239842,72.38614108553845,"(37.5, 52.0]",Q3
36067,2020-03-29,461809,45,28,180,206,3123,18.285714285714285,286.85714285714283,3.959583785875608,62.11597064092359,"(37.5, 52.0]",Q3
36067,2020-03-30,461809,45,14,194,139,3262,19.142857142857142,288.2857142857143,4.145189275838527,62.42531312419513,"(37.5, 52.0]",Q3
36067,2020-03-31,461809,45,23,217,163,3425,21.714285714285715,293.85714285714283,4.702005745727285,63.63174880895409,"(37.5, 52.0]",Q3
36067,2020-04-01,461809,45,17,234,191,3616,21.571428571428573,283.14285714285717,4.671071497400131,61.31168018441762,"(37.5, 52.0]",Q3
36067,2020-04-02,461809,45,18,252,195,3811,19.571428571428573,247.57142857142858,4.237992020819987,53.609052350956475,"(37.5, 52.0]",Q3
36067,2020-04-03,461809,45,10,262,221,4032,19.0,228.85714285714286,4.114255027511374,49.556665820099404,"(37.5, 52.0]",Q3
36067,2020-04-04,461809,45,6,268,131,4163,16.571428571428573,178.0,3.58837280594977,38.544073415632866,"(37.5, 52.0]",Q3
36067,2020-04-05,461809,45,3,271,89,4252,13.0,161.28571428571428,2.81501659777094,34.92476636135595,"(37.5, 52.0]",Q3
36067,2020-04-06,461809,45,64,335,689,4941,20.142857142857142,239.85714285714286,4.361729014128599,51.93860294129019,"(37.5, 52.0]",Q3
36067,2020-04-07,461809,45,12,347,126,5067,18.571428571428573,234.57142857142858,4.021452282529914,50.79403575318554,"(37.5, 52.0]",Q3
36067,2020-04-08,461809,45,11,358,245,5312,17.714285714285715,242.28571428571428,3.8358467925669952,52.4644851628518,"(37.5, 52.0]",Q3
36067,2020-04-09,461809,45,11,369,148,5460,16.714285714285715,235.57142857142858,3.619307054276923,51.010575491475606,"(37.5, 52.0]",Q3
36067,2020-04-10,461809,45,11,380,116,5576,16.857142857142858,220.57142857142858,3.6502413026040763,47.762479417124524,"(37.5, 52.0]",Q3
36067,2020-04-11,461809,45,17,397,169,5745,18.428571428571427,226.0,3.9905180342027604,48.93798085355635,"(37.5, 52.0]",Q3
36067,2020-04-12,461809,45,19,416,142,5887,20.714285714285715,233.57142857142858,4.485466007437212,50.577496014895466,"(37.5, 52.0]",Q3
36067,2020-04-13,461809,45,15,431,120,6007,13.714285714285714,152.28571428571428,2.9696878394067054,32.975908716745295,"(37.5, 52.0]",Q3
36067,2020-04-14,461809,45,18,449,219,6226,14.571428571428571,165.57142857142858,3.1552933293696253,35.85279381117054,"(37.5, 52.0]",Q3
36067,2020-04-15,461809,45,13,462,134,6360,14.857142857142858,149.71428571428572,3.217161826023932,32.41909224685654,"(37.5, 52.0]",Q3
36067,2020-04-16,461809,45,21,483,181,6541,16.285714285714285,154.42857142857142,3.5265043092954627,33.43992244165259,"(37.5, 52.0]",Q3
36067,2020-04-17,461809,45,9,492,152,6693,16.0,159.57142857142858,3.464635812641157,34.553555381430115,"(37.5, 52.0]",Q3
36067,2020-04-18,461809,45,6,498,118,6811,14.428571428571429,152.28571428571428,3.124359081042472,32.975908716745295,"(37.5, 52.0]",Q3
36067,2020-04-19,461809,45,11,509,113,6924,13.285714285714286,148.14285714285714,2.8768850944252464,32.07881551525785,"(37.5, 52.0]",Q3
36067,2020-04-20,461809,45,5,514,101,7025,11.857142857142858,145.42857142857142,2.5675426111537147,31.49106479704194,"(37.5, 52.0]",Q3
36067,2020-04-21,461809,45,12,526,152,7177,11.0,135.85714285714286,2.3819371211907954,29.41847015912268,"(37.5, 52.0]",Q3
36067,2020-04-22,461809,45,74,600,705,7882,19.714285714285715,217.42857142857142,4.26892626914714,47.08192595392715,"(37.5, 52.0]",Q3
36067,2020-04-23,461809,45,39,639,722,8604,22.285714285714285,294.7142857142857,4.8257427390358965,63.817354298917024,"(37.5, 52.0]",Q3
36067,2020-04-24,461809,45,25,664,530,9134,24.571428571428573,348.7142857142857,5.320690712270348,75.51050016658093,"(37.5, 52.0]",Q3
36067,2020-04-25,461809,45,28,692,280,9414,27.714285714285715,371.85714285714283,6.001244175467718,80.52184839557974,"(37.5, 52.0]",Q3
36067,2020-04-26,461809,45,34,726,256,9670,31.0,392.2857142857143,6.712731886992242,84.94544590636265,"(37.5, 52.0]",Q3
36067,2020-04-27,461809,45,16,742,268,9938,32.57142857142857,416.14285714285717,7.053008618590925,90.11146537699723,"(37.5, 52.0]",Q3
36067,2020-04-28,461809,45,40,782,386,10324,36.57142857142857,449.57142857142856,7.919167571751216,97.35007948555106,"(37.5, 52.0]",Q3
36067,2020-04-29,461809,45,50,832,343,10667,33.142857142857146,397.85714285714283,7.17674561189954,86.15188159112162,"(37.5, 52.0]",Q3
36067,2020-04-30,461809,45,28,860,334,11001,31.571428571428573,342.42857142857144,6.8364688803008535,74.14939324018619,"(37.5, 52.0]",Q3
36067,2020-05-01,461809,45,43,903,433,11434,34.142857142857146,328.57142857142856,7.393285350189612,71.14877115245233,"(37.5, 52.0]",Q3
36067,2020-05-02,461809,45,49,952,593,12027,37.142857142857146,373.2857142857143,8.042904565059828,80.83119087885127,"(37.5, 52.0]",Q3
36067,2020-05-03,461809,45,19,971,436,12463,35.0,399.0,7.578890840152531,86.39935557773885,"(37.5, 52.0]",Q3
36067,2020-05-04,461809,45,31,1002,176,12639,37.142857142857146,385.85714285714283,8.042904565059828,83.55340473164075,"(37.5, 52.0]",Q3
36067,2020-05-05,461809,45,54,1056,731,13370,39.142857142857146,435.14285714285717,8.475984041639974,94.2257204045086,"(37.5, 52.0]",Q3
36067,2020-05-06,461809,45,59,1115,534,13904,40.42857142857143,462.42857142857144,8.754392276584353,100.13416183499487,"(37.5, 52.0]",Q3
36067,2020-05-07,461809,45,54,1169,407,14311,44.142857142857146,472.85714285714283,9.558682733090334,102.39236196287703,"(37.5, 52.0]",Q3
36067,2020-05-08,461809,45,49,1218,464,14775,45.0,477.2857142857143,9.744288223053253,103.35132366101878,"(37.5, 52.0]",Q3
36067,2020-05-09,461809,45,47,1265,507,15282,44.714285714285715,465.0,9.682419726398948,100.69097830488361,"(37.5, 52.0]",Q3
36067,2020-05-10,461809,45,22,1287,240,15522,45.142857142857146,437.0,9.775222471380408,94.6278656327616,"(37.5, 52.0]",Q3
36067,2020-05-11,461809,45,21,1308,329,15851,43.714285714285715,458.85714285714283,9.465879988108874,99.36080562681603,"(37.5, 52.0]",Q3
36067,2020-05-12,461809,45,87,1395,1066,16917,48.42857142857143,506.7142857142857,10.48671018290493,109.72377881641236,"(37.5, 52.0]",Q3
36067,2020-05-13,461809,45,28,1423,683,17600,44.0,528.0,9.527748484763181,114.33298181715817,"(37.5, 52.0]",Q3
36067,2020-05-14,461809,45,17,1440,385,17985,38.714285714285715,524.8571428571429,8.383181296658513,113.65242835396081,"(37.5, 52.0]",Q3
36067,2020-05-15,461809,45,29,1469,1088,19073,35.857142857142854,614.0,7.764496330115449,132.95539931010438,"(37.5, 52.0]",Q3
36067,2020-05-16,461809,45,32,1501,648,19721,33.714285714285715,634.1428571428571,7.300482605208153,137.31712832423298,"(37.5, 52.0]",Q3
36067,2020-05-17,461809,45,19,1520,483,20204,33.285714285714285,668.8571428571429,7.207679860226692,144.83415066773122,"(37.5, 52.0]",Q3
36067,2020-05-18,461809,45,145,1665,1578,21782,51.0,847.2857142857143,11.043526652793688,183.47102682834557,"(37.5, 52.0]",Q3
36067,2020-05-19,461809,45,53,1718,1844,23626,46.142857142857146,958.4285714285714,9.99176220967048,207.53787202687073,"(37.5, 52.0]",Q3
36067,2020-05-20,461809,45,53,1771,1137,24763,49.714285714285715,1023.2857142857143,10.765118417849308,221.5820207673983,"(37.5, 52.0]",Q3
36067,2020-05-21,461809,45,57,1828,1344,26107,55.42857142857143,1160.2857142857142,12.002488350935437,251.24796491313816,"(37.5, 52.0]",Q3
36067,2020-05-22,461809,45,76,1904,2502,28609,62.142857142857146,1362.2857142857142,13.456398022311635,294.9889920477328,"(37.5, 52.0]",Q3
36067,2020-05-23,461809,45,49,1953,1352,29961,64.57142857142857,1462.857142857143,13.982280243873241,316.7667028700486,"(37.5, 52.0]",Q3
36067,2020-05-24,461809,45,28,1981,1175,31136,65.85714285714286,1561.7142857142858,14.260688478817618,338.17320271243864,"(37.5, 52.0]",Q3
36067,2020-05-25,461809,45,31,2012,1129,32265,49.57142857142857,1497.5714285714287,10.734184169522155,324.2837252135469,"(37.5, 52.0]",Q3
36067,2020-05-26,461809,45,21,2033,676,32941,45.0,1330.7142857142858,9.744288223053253,288.1525231674319,"(37.5, 52.0]",Q3
36067,2020-05-27,461809,45,21,2054,817,33758,40.42857142857143,1285.0,8.754392276584353,278.2535637027429,"(37.5, 52.0]",Q3
36067,2020-05-28,461809,45,38,2092,1731,35489,37.714285714285715,1340.2857142857142,8.166641558368442,290.2251178053512,"(37.5, 52.0]",Q3
36067,2020-05-29,461809,45,41,2133,2101,37590,32.714285714285715,1283.0,7.08394286691808,277.82048422616276,"(37.5, 52.0]",Q3
36067,2020-05-30,461809,45,37,2170,1829,39419,31.0,1351.142857142857,6.712731886992242,292.5761206782148,"(37.5, 52.0]",Q3
36067,2020-05-31,461809,45,27,2197,1074,40493,30.857142857142858,1336.7142857142858,6.681797638665088,289.4517615971724,"(37.5, 52.0]",Q3
36067,2020-06-01,461809,45,31,2228,1035,41528,30.857142857142858,1323.2857142857142,6.681797638665088,286.5439422544199,"(37.5, 52.0]",Q3
36067,2020-06-02,461809,45,28,2256,1522,43050,31.857142857142858,1444.142857142857,6.89833737695516,312.71431633919156,"(37.5, 52.0]",Q3
36067,2020-06-03,461809,45,39,2295,2189,45239,34.42857142857143,1640.142857142857,7.455153846843919,355.1561050440457,"(37.5, 52.0]",Q3
36067,2020-06-04,461809,45,34,2329,1601,46840,33.857142857142854,1621.5714285714287,7.331416853535305,351.13465276151584,"(37.5, 52.0]",Q3
36067,2020-06-05,461809,45,46,2375,2186,49026,34.57142857142857,1633.7142857142858,7.486088095171071,353.7640638693238,"(37.5, 52.0]",Q3
36067,2020-06-06,461809,45,17,2392,1345,50371,31.714285714285715,1564.5714285714287,6.867403128628007,338.7918876789817,"(37.5, 52.0]",Q3
36067,2020-06-07,461809,45,16,2408,2040,52411,30.142857142857142,1702.5714285714287,6.527126397029322,368.6743715630117,"(37.5, 52.0]",Q3
36069,2020-03-02,109864,17,0,0,0,0,0.0,0.0,0.0,0.0,"(3.999, 24.0]",Q1
36069,2020-03-03,109864,17,0,0,0,0,0.0,0.0,0.0,0.0,"(3.999, 24.0]",Q1
36069,2020-03-04,109864,17,0,0,0,0,0.0,0.0,0.0,0.0,"(3.999, 24.0]",Q1
36069,2020-03-05,109864,17,0,0,0,0,0.0,0.0,0.0,0.0,"(3.999, 24.0]",Q1
36069,2020-03-06,109864,17,0,0,0,0,0.0,0.0,0.0,0.0,"(3.999, 24.0]",Q1
36069,2020-03-07,109864,17,0,0,0,0,0.0,0.0,0.0,0.0,"(3.999, 24.0]",Q1
36069,2020-03-08,109864,17,0,0,0,0,0.0,0.0,0.0,0.0,"(3.999, 24.0]",Q1
36069,2020-03-09,109864,17,0,0,0,0,0.0,0.0,0.0,0.0,"(3.999, 24.0]",Q1
36069,2020-03-10,109864,17,0,0,0,0,0.0,0.0,0.0,0.0,"(3.999, 24.0]",Q1
36069,2020-03-11,109864,17,0,0,0,0,0.0,0.0,0.0,0.0,"(3.999, 24.0]",Q1
36069,2020-03-12,109864,17,0,0,2,2,0.0,0.2857142857142857,0.0,0.2600617906814659,"(3.999, 24.0]",Q1
36069,2020-03-13,109864,17,0,0,4,6,0.0,0.8571428571428571,0.0,0.7801853720443978,"(3.999, 24.0]",Q1
36069,2020-03-14,109864,17,0,0,3,9,0.0,1.2857142857142858,0.0,1.1702780580665968,"(3.999, 24.0]",Q1
36069,2020-03-15,109864,17,1,1,5,14,0.14285714285714285,2.0,0.13003089534073295,1.8204325347702612,"(3.999, 24.0]",Q1
36069,2020-03-16,109864,17,0,1,1,15,0.14285714285714285,2.142857142857143,0.13003089534073295,1.9504634301109942,"(3.999, 24.0]",Q1
36069,2020-03-17,109864,17,0,1,3,18,0.14285714285714285,2.5714285714285716,0.13003089534073295,2.3405561161331936,"(3.999, 24.0]",Q1
36069,2020-03-18,109864,17,0,1,8,26,0.14285714285714285,3.7142857142857144,0.13003089534073295,3.3808032788590565,"(3.999, 24.0]",Q1
36069,2020-03-19,109864,17,2,3,15,41,0.42857142857142855,5.571428571428571,0.3900926860221989,5.071204918288585,"(3.999, 24.0]",Q1
36069,2020-03-20,109864,17,1,4,25,66,0.5714285714285714,8.571428571428571,0.5201235813629318,7.801853720443977,"(3.999, 24.0]",Q1
36069,2020-03-21,109864,17,2,6,25,91,0.8571428571428571,11.714285714285714,0.7801853720443978,10.662533417940102,"(3.999, 24.0]",Q1
36069,2020-03-22,109864,17,0,6,5,96,0.7142857142857143,11.714285714285714,0.6501544767036649,10.662533417940102,"(3.999, 24.0]",Q1
36069,2020-03-23,109864,17,1,7,13,109,0.8571428571428571,13.428571428571429,0.7801853720443978,12.222904162028899,"(3.999, 24.0]",Q1
36069,2020-03-24,109864,17,2,9,19,128,1.1428571428571428,15.714285714285714,1.0402471627258636,14.303398487480626,"(3.999, 24.0]",Q1
36069,2020-03-25,109864,17,2,11,21,149,1.4285714285714286,17.571428571428573,1.3003089534073298,15.993800126910156,"(3.999, 24.0]",Q1
36069,2020-03-26,109864,17,3,14,29,178,1.5714285714285714,19.571428571428573,1.4303398487480625,17.814232661680418,"(3.999, 24.0]",Q1
36069,2020-03-27,109864,17,2,16,34,212,1.7142857142857142,20.857142857142858,1.5603707440887955,18.98451071974701,"(3.999, 24.0]",Q1
36069,2020-03-28,109864,17,2,18,26,238,1.7142857142857142,21.0,1.5603707440887955,19.114541615087745,"(3.999, 24.0]",Q1
36069,2020-03-29,109864,17,2,20,16,254,2.0,22.571428571428573,1.8204325347702612,20.544881463835807,"(3.999, 24.0]",Q1
36069,2020-03-30,109864,17,2,22,26,280,2.142857142857143,24.428571428571427,1.9504634301109942,22.235283103265335,"(3.999, 24.0]",Q1
36069,2020-03-31,109864,17,2,24,37,317,2.142857142857143,27.0,1.9504634301109942,24.575839219398528,"(3.999, 24.0]",Q1
36069,2020-04-01,109864,17,2,26,29,346,2.142857142857143,28.142857142857142,1.9504634301109942,25.616086382124394,"(3.999, 24.0]",Q1
36069,2020-04-02,109864,17,2,28,29,375,2.0,28.142857142857142,1.8204325347702612,25.616086382124394,"(3.999, 24.0]",Q1
36069,2020-04-03,109864,17,3,31,36,411,2.142857142857143,28.428571428571427,1.9504634301109942,25.87614817280586,"(3.999, 24.0]",Q1
36069,2020-04-04,109864,17,1,32,33,444,2.0,29.428571428571427,1.8204325347702612,26.78636444019099,"(3.999, 24.0]",Q1
36069,2020-04-05,109864,17,0,32,26,470,1.7142857142857142,30.857142857142858,1.5603707440887955,28.086673393598318,"(3.999, 24.0]",Q1
36069,2020-04-06,109864,17,1,33,32,502,1.5714285714285714,31.714285714285715,1.4303398487480625,28.866858765642718,"(3.999, 24.0]",Q1
36069,2020-04-07,109864,17,6,39,50,552,2.142857142857143,33.57142857142857,1.9504634301109942,30.557260405072242,"(3.999, 24.0]",Q1
36069,2020-04-08,109864,17,4,43,38,590,2.4285714285714284,34.857142857142854,2.21052522079246,31.72753846313884,"(3.999, 24.0]",Q1
36069,2020-04-09,109864,17,8,51,50,640,3.2857142857142856,37.857142857142854,2.990710592836858,34.45818726529423,"(3.999, 24.0]",Q1
36069,2020-04-10,109864,17,5,56,39,679,3.5714285714285716,38.285714285714285,3.2507723835183246,34.848279951316435,"(3.999, 24.0]",Q1
36069,2020-04-11,109864,17,1,57,27,706,3.5714285714285716,37.42857142857143,3.2507723835183246,34.068094579272035,"(3.999, 24.0]",Q1
36069,2020-04-12,109864,17,0,57,12,718,3.5714285714285716,35.42857142857143,3.2507723835183246,32.24766204450178,"(3.999, 24.0]",Q1
36069,2020-04-13,109864,17,4,61,48,766,4.0,37.714285714285715,3.6408650695405225,34.328156369953504,"(3.999, 24.0]",Q1
36069,2020-04-14,109864,17,1,62,25,791,3.2857142857142856,34.142857142857146,2.990710592836858,31.07738398643518,"(3.999, 24.0]",Q1
36069,2020-04-15,109864,17,3,65,31,822,3.142857142857143,33.142857142857146,2.860679697496125,30.16716771905005,"(3.999, 24.0]",Q1
36069,2020-04-16,109864,17,2,67,34,856,2.2857142857142856,30.857142857142858,2.080494325451727,28.086673393598318,"(3.999, 24.0]",Q1
36069,2020-04-17,109864,17,2,69,33,889,1.8571428571428572,30.0,1.6904016394295283,27.306488021553925,"(3.999, 24.0]",Q1
36069,2020-04-18,109864,17,1,70,24,913,1.8571428571428572,29.571428571428573,1.6904016394295283,26.91639533553172,"(3.999, 24.0]",Q1
36069,2020-04-19,109864,17,1,71,20,933,2.0,30.714285714285715,1.8204325347702612,27.956642498257587,"(3.999, 24.0]",Q1
36069,2020-04-20,109864,17,1,72,43,976,1.5714285714285714,30.0,1.4303398487480625,27.306488021553925,"(3.999, 24.0]",Q1
36069,2020-04-21,109864,17,1,73,66,1042,1.5714285714285714,35.857142857142854,1.4303398487480625,32.637754730523966,"(3.999, 24.0]",Q1
36069,2020-04-22,109864,17,0,73,31,1073,1.1428571428571428,35.857142857142854,1.0402471627258636,32.637754730523966,"(3.999, 24.0]",Q1
36069,2020-04-23,109864,17,0,73,37,1110,0.8571428571428571,36.285714285714285,0.7801853720443978,33.02784741654617,"(3.999, 24.0]",Q1
36069,2020-04-24,109864,17,9,82,239,1349,1.8571428571428572,65.71428571428571,1.6904016394295283,59.81421185673716,"(3.999, 24.0]",Q1
36069,2020-04-25,109864,17,2,84,34,1383,2.0,67.14285714285714,1.8204325347702612,61.114520810144484,"(3.999, 24.0]",Q1
36069,2020-04-26,109864,17,2,86,40,1423,2.142857142857143,70.0,1.9504634301109942,63.71513871695915,"(3.999, 24.0]",Q1
36069,2020-04-27,109864,17,4,90,50,1473,2.5714285714285716,71.0,2.3405561161331936,64.62535498434427,"(3.999, 24.0]",Q1
36069,2020-04-28,109864,17,0,90,60,1533,2.4285714285714284,70.14285714285714,2.21052522079246,63.845169612299884,"(3.999, 24.0]",Q1
36069,2020-04-29,109864,17,0,90,78,1611,2.4285714285714284,76.85714285714286,2.21052522079246,69.95662169331433,"(3.999, 24.0]",Q1
36069,2020-04-30,109864,17,1,91,91,1702,2.5714285714285716,84.57142857142857,2.3405561161331936,76.9782900417139,"(3.999, 24.0]",Q1
36069,2020-05-01,109864,17,1,92,62,1764,1.4285714285714286,59.285714285714285,1.3003089534073298,53.96282156640417,"(3.999, 24.0]",Q1
36069,2020-05-02,109864,17,3,95,90,1854,1.5714285714285714,67.28571428571429,1.4303398487480625,61.24455170548523,"(3.999, 24.0]",Q1
36069,2020-05-03,109864,17,1,96,81,1935,1.4285714285714286,73.14285714285714,1.3003089534073298,66.57581841445527,"(3.999, 24.0]",Q1
36069,2020-05-04,109864,17,1,97,86,2021,1.0,78.28571428571429,0.9102162673851306,71.25693064672167,"(3.999, 24.0]",Q1
36069,2020-05-05,109864,17,2,99,105,2126,1.2857142857142858,84.71428571428571,1.1702780580665968,77.10832093705464,"(3.999, 24.0]",Q1
36069,2020-05-06,109864,17,2,101,121,2247,1.5714285714285714,90.85714285714286,1.4303398487480625,82.69964943670617,"(3.999, 24.0]",Q1
36069,2020-05-07,109864,17,3,104,108,2355,1.8571428571428572,93.28571428571429,1.6904016394295283,84.91017465749863,"(3.999, 24.0]",Q1
36069,2020-05-08,109864,17,0,104,69,2424,1.7142857142857142,94.28571428571429,1.5603707440887955,85.82039092488375,"(3.999, 24.0]",Q1
36069,2020-05-09,109864,17,2,106,109,2533,1.5714285714285714,97.0,1.4303398487480625,88.29097793635768,"(3.999, 24.0]",Q1
36069,2020-05-10,109864,17,1,107,92,2625,1.5714285714285714,98.57142857142857,1.4303398487480625,89.72131778510574,"(3.999, 24.0]",Q1
36069,2020-05-11,109864,17,0,107,74,2699,1.4285714285714286,96.85714285714286,1.3003089534073298,88.16094704101695,"(3.999, 24.0]",Q1
36069,2020-05-12,109864,17,2,109,140,2839,1.4285714285714286,101.85714285714286,1.3003089534073298,92.7120283779426,"(3.999, 24.0]",Q1
36069,2020-05-13,109864,17,20,129,334,3173,4.0,132.28571428571428,3.6408650695405225,120.40860908551872,"(3.999, 24.0]",Q1
36069,2020-05-14,109864,17,4,133,135,3308,4.142857142857143,136.14285714285714,3.770895964881256,123.91944325971849,"(3.999, 24.0]",Q1
36069,2020-05-15,109864,17,6,139,136,3444,5.0,145.71428571428572,4.5510813369256535,132.63151324754764,"(3.999, 24.0]",Q1
36069,2020-05-16,109864,17,7,146,160,3604,5.714285714285714,153.0,5.201235813629319,139.263088909925,"(3.999, 24.0]",Q1
36069,2020-05-17,109864,17,2,148,96,3700,5.857142857142857,153.57142857142858,5.331266708970051,139.78321249128794,"(3.999, 24.0]",Q1
36069,2020-05-18,109864,17,4,152,157,3857,6.428571428571429,165.42857142857142,5.851390290332984,150.57577680456876,"(3.999, 24.0]",Q1
36069,2020-05-19,109864,17,18,170,351,4208,8.714285714285714,195.57142857142858,7.93188461578471,178.01229572146343,"(3.999, 24.0]",Q1
36069,2020-05-20,109864,17,6,176,264,4472,6.714285714285714,185.57142857142858,6.111452081014449,168.91013304761213,"(3.999, 24.0]",Q1
36069,2020-05-21,109864,17,4,180,191,4663,6.714285714285714,193.57142857142858,6.111452081014449,176.19186318669318,"(3.999, 24.0]",Q1
36069,2020-05-22,109864,17,2,182,125,4788,6.142857142857143,192.0,5.591328499651517,174.76152333794508,"(3.999, 24.0]",Q1
36069,2020-05-23,109864,17,2,184,201,4989,5.428571428571429,197.85714285714286,4.941174022947853,180.09279004691513,"(3.999, 24.0]",Q1
36069,2020-05-24,109864,17,1,185,99,5088,5.285714285714286,198.28571428571428,4.811143127607119,180.48288273293736,"(3.999, 24.0]",Q1
36069,2020-05-25,109864,17,10,195,218,5306,6.142857142857143,207.0,5.591328499651517,188.41476734872205,"(3.999, 24.0]",Q1
36069,2020-05-26,109864,17,3,198,182,5488,4.0,182.85714285714286,3.6408650695405225,166.4395460361382,"(3.999, 24.0]",Q1
36069,2020-05-27,109864,17,3,201,246,5734,3.5714285714285716,180.28571428571428,3.2507723835183246,164.09898992000498,"(3.999, 24.0]",Q1
36069,2020-05-28,109864,17,4,205,209,5943,3.5714285714285716,182.85714285714286,3.2507723835183246,166.4395460361382,"(3.999, 24.0]",Q1
36069,2020-05-29,109864,17,1,206,126,6069,3.4285714285714284,183.0,3.120741488177591,166.5695769314789,"(3.999, 24.0]",Q1
36069,2020-05-30,109864,17,1,207,328,6397,3.2857142857142856,201.14285714285714,2.990710592836858,183.083500639752,"(3.999, 24.0]",Q1
36069,2020-05-31,109864,17,1,208,188,6585,3.2857142857142856,213.85714285714286,2.990710592836858,194.65625032507725,"(3.999, 24.0]",Q1
36069,2020-06-01,109864,17,1,209,206,6791,2.0,212.14285714285714,1.8204325347702612,193.09587958098842,"(3.999, 24.0]",Q1
36069,2020-06-02,109864,17,6,215,485,7276,2.4285714285714284,255.42857142857142,2.21052522079246,232.4952408692305,"(3.999, 24.0]",Q1
36069,2020-06-03,109864,17,3,218,421,7697,2.4285714285714284,280.42857142857144,2.21052522079246,255.2506475538588,"(3.999, 24.0]",Q1
36069,2020-06-04,109864,17,1,219,379,8076,2.0,304.7142857142857,1.8204325347702612,277.3558997617834,"(3.999, 24.0]",Q1
36069,2020-06-05,109864,17,1,220,505,8581,2.0,358.85714285714283,1.8204325347702612,326.63760909592116,"(3.999, 24.0]",Q1
36069,2020-06-06,109864,17,1,221,236,8817,2.0,345.7142857142857,1.8204325347702612,314.6747667245738,"(3.999, 24.0]",Q1
36069,2020-06-07,109864,17,0,221,293,9110,1.8571428571428572,360.7142857142857,1.6904016394295283,328.3280107353507,"(3.999, 24.0]",Q1
36071,2020-03-02,381951,36,0,0,0,0,0.0,0.0,0.0,0.0,"(24.0, 37.5]",Q2
36071,2020-03-03,381951,36,0,0,0,0,0.0,0.0,0.0,0.0,"(24.0, 37.5]",Q2
36071,2020-03-04,381951,36,0,0,0,0,0.0,0.0,0.0,0.0,"(24.0, 37.5]",Q2
36071,2020-03-05,381951,36,0,0,0,0,0.0,0.0,0.0,0.0,"(24.0, 37.5]",Q2
36071,2020-03-06,381951,36,0,0,0,0,0.0,0.0,0.0,0.0,"(24.0, 37.5]",Q2
36071,2020-03-07,381951,36,0,0,0,0,0.0,0.0,0.0,0.0,"(24.0, 37.5]",Q2
36071,2020-03-08,381951,36,0,0,0,0,0.0,0.0,0.0,0.0,"(24.0, 37.5]",Q2
36071,2020-03-09,381951,36,0,0,1,1,0.0,0.14285714285714285,0.0,0.03740195544903478,"(24.0, 37.5]",Q2
36071,2020-03-10,381951,36,0,0,0,1,0.0,0.14285714285714285,0.0,0.03740195544903478,"(24.0, 37.5]",Q2
36071,2020-03-11,381951,36,1,1,4,5,0.14285714285714285,0.7142857142857143,0.03740195544903478,0.18700977724517395,"(24.0, 37.5]",Q2
36071,2020-03-12,381951,36,0,1,12,17,0.14285714285714285,2.4285714285714284,0.03740195544903478,0.6358332426335913,"(24.0, 37.5]",Q2
36071,2020-03-13,381951,36,5,6,22,39,0.8571428571428571,5.571428571428571,0.22441173269420872,1.4586762625123566,"(24.0, 37.5]",Q2
36071,2020-03-14,381951,36,0,6,12,51,0.8571428571428571,7.285714285714286,0.22441173269420872,1.9074997279007742,"(24.0, 37.5]",Q2
36071,2020-03-15,381951,36,5,11,36,87,1.5714285714285714,12.428571428571429,0.41142150993938265,3.2539701240660266,"(24.0, 37.5]",Q2
36071,2020-03-16,381951,36,4,15,36,123,2.142857142857143,17.428571428571427,0.5610293317355218,4.563038564782244,"(24.0, 37.5]",Q2
36071,2020-03-17,381951,36,17,32,83,206,4.571428571428571,29.285714285714285,1.196862574369113,7.667400867052131,"(24.0, 37.5]",Q2
36071,2020-03-18,381951,36,19,51,94,300,7.142857142857143,42.142857142857146,1.8700977724517394,11.033576857465263,"(24.0, 37.5]",Q2
36071,2020-03-19,381951,36,33,84,180,480,11.857142857142858,66.14285714285714,3.1043623022698874,17.317105372903107,"(24.0, 37.5]",Q2
36071,2020-03-20,381951,36,79,163,377,857,22.428571428571427,116.85714285714286,5.872107005498461,30.59479955731046,"(24.0, 37.5]",Q2
36071,2020-03-21,381951,36,84,247,393,1250,34.42857142857143,171.28571428571428,9.013871263217384,44.84494458339271,"(24.0, 37.5]",Q2
36071,2020-03-22,381951,36,142,389,472,1722,54.0,233.57142857142858,14.137939159735149,61.152197159171884,"(24.0, 37.5]",Q2
36071,2020-03-23,381951,36,109,498,340,2062,69.0,277.0,18.065144481883802,72.52239161567846,"(24.0, 37.5]",Q2
36071,2020-03-24,381951,36,140,638,298,2360,86.57142857142857,307.7142857142857,22.66558500211508,80.56381203722093,"(24.0, 37.5]",Q2
36071,2020-03-25,381951,36,113,751,322,2682,100.0,340.2857142857143,26.18136881432435,89.09145787960085,"(24.0, 37.5]",Q2
36071,2020-03-26,381951,36,160,911,394,3076,118.14285714285714,370.85714285714283,30.931417156351767,97.0954763456943,"(24.0, 37.5]",Q2
36071,2020-03-27,381951,36,190,1101,498,3574,134.0,388.14285714285717,35.08303421119463,101.62111295502751,"(24.0, 37.5]",Q2
36071,2020-03-28,381951,36,146,1247,373,3947,142.85714285714286,385.2857142857143,37.40195544903479,100.87307384604681,"(24.0, 37.5]",Q2
36071,2020-03-29,381951,36,188,1435,394,4341,149.42857142857142,374.14285714285717,39.122445399690385,97.95572132102212,"(24.0, 37.5]",Q2
36071,2020-03-30,381951,36,121,1556,306,4647,151.14285714285714,369.2857142857143,39.5712688650788,96.68405483575492,"(24.0, 37.5]",Q2
36071,2020-03-31,381951,36,200,1756,477,5124,159.71428571428572,394.85714285714283,41.81538619202089,103.37900486113215,"(24.0, 37.5]",Q2
36071,2020-04-01,381951,36,237,1993,628,5752,177.42857142857142,438.57142857142856,46.453228667701204,114.8240032285368,"(24.0, 37.5]",Q2
36071,2020-04-02,381951,36,404,2397,1114,6866,212.28571428571428,541.4285714285714,55.57930579726569,141.75341115184185,"(24.0, 37.5]",Q2
36071,2020-04-03,381951,36,344,2741,1046,7912,234.28571428571428,619.7142857142857,61.33920693641705,162.2496827379129,"(24.0, 37.5]",Q2
36071,2020-04-04,381951,36,361,3102,1077,8989,265.0,720.2857142857143,69.38062735795954,188.58065937403342,"(24.0, 37.5]",Q2
36071,2020-04-05,381951,36,295,3397,827,9816,280.2857142857143,782.1428571428571,73.38263659100625,204.77570608346545,"(24.0, 37.5]",Q2
36071,2020-04-06,381951,36,202,3599,604,10420,291.85714285714283,824.7142857142857,76.41219498237805,215.9214888072778,"(24.0, 37.5]",Q2
36071,2020-04-07,381951,36,266,3865,711,11131,301.2857142857143,858.1428571428571,78.88072404201436,224.67354638235196,"(24.0, 37.5]",Q2
36071,2020-04-08,381951,36,225,4090,578,11709,299.57142857142856,851.0,78.43190057662595,222.80344860990022,"(24.0, 37.5]",Q2
36071,2020-04-09,381951,36,442,4532,1335,13044,305.0,882.5714285714286,79.85317488368926,231.06928076413692,"(24.0, 37.5]",Q2
36071,2020-04-10,381951,36,315,4847,879,13923,300.85714285714283,858.7142857142857,78.76851817566725,224.8231542041481,"(24.0, 37.5]",Q2
36071,2020-04-11,381951,36,180,5027,563,14486,275.0,785.2857142857143,71.99876423939197,205.59854910334423,"(24.0, 37.5]",Q2
36071,2020-04-12,381951,36,155,5182,492,14978,255.0,737.4285714285714,66.76249047652709,193.06889402791757,"(24.0, 37.5]",Q2
36071,2020-04-13,381951,36,396,5578,1161,16139,282.7142857142857,817.0,74.01846983363984,213.90178321302994,"(24.0, 37.5]",Q2
36071,2020-04-14,381951,36,138,5716,341,16480,264.42857142857144,764.1428571428571,69.23101953616339,200.06305969688708,"(24.0, 37.5]",Q2
36071,2020-04-15,381951,36,172,5888,521,17001,256.85714285714283,756.0,67.24871589736453,197.9311482362921,"(24.0, 37.5]",Q2
36071,2020-04-16,381951,36,196,6084,512,17513,221.71428571428572,638.4285714285714,58.04783485690199,167.14933890173646,"(24.0, 37.5]",Q2
36071,2020-04-17,381951,36,182,6266,575,18088,202.71428571428572,595.0,53.073374782180366,155.7791444452299,"(24.0, 37.5]",Q2
36071,2020-04-18,381951,36,113,6379,411,18499,193.14285714285714,573.2857142857143,50.56744376709503,150.0940472169766,"(24.0, 37.5]",Q2
36071,2020-04-19,381951,36,103,6482,278,18777,185.71428571428572,542.7142857142857,48.62254208374522,142.09002875088314,"(24.0, 37.5]",Q2
36071,2020-04-20,381951,36,79,6561,298,19075,140.42857142857142,419.42857142857144,36.76612220640119,109.81214119836615,"(24.0, 37.5]",Q2
36071,2020-04-21,381951,36,129,6690,430,19505,139.14285714285714,432.14285714285717,36.42950460735988,113.14091523333023,"(24.0, 37.5]",Q2
36071,2020-04-22,381951,36,126,6816,399,19904,132.57142857142858,414.7142857142857,34.709014656704284,108.57787666854797,"(24.0, 37.5]",Q2
36071,2020-04-23,381951,36,339,7155,1213,21117,153.0,514.8571428571429,40.057494285916256,134.79664743832137,"(24.0, 37.5]",Q2
36071,2020-04-24,381951,36,818,7973,2748,23865,243.85714285714286,825.2857142857143,63.84513795150239,216.071096629074,"(24.0, 37.5]",Q2
36071,2020-04-25,381951,36,133,8106,643,24508,246.71428571428572,858.4285714285714,64.59317706048309,224.74835029325004,"(24.0, 37.5]",Q2
36071,2020-04-26,381951,36,132,8238,587,25095,250.85714285714286,902.5714285714286,65.67783376850508,236.30555452700176,"(24.0, 37.5]",Q2
36071,2020-04-27,381951,36,136,8374,645,25740,259.0,952.1428571428571,67.80974522910007,249.28403306781686,"(24.0, 37.5]",Q2
36071,2020-04-28,381951,36,114,8488,602,26342,256.85714285714283,976.7142857142857,67.24871589736453,255.7171694050508,"(24.0, 37.5]",Q2
36071,2020-04-29,381951,36,162,8650,880,27222,262.0,1045.4285714285713,68.59518629352979,273.70750997603653,"(24.0, 37.5]",Q2
36071,2020-04-30,381951,36,101,8751,787,28009,228.0,984.5714285714286,59.693520896659514,257.77427695474773,"(24.0, 37.5]",Q2
36071,2020-05-01,381951,36,159,8910,839,28848,133.85714285714286,711.8571428571429,35.045632255745595,186.37394400254036,"(24.0, 37.5]",Q2
36071,2020-05-02,381951,36,57,8967,510,29358,123.0,692.8571428571429,32.20308364161895,181.39948392781872,"(24.0, 37.5]",Q2
36071,2020-05-03,381951,36,48,9015,421,29779,111.0,669.1428571428571,29.06131938390003,175.19075932327894,"(24.0, 37.5]",Q2
36071,2020-05-04,381951,36,129,9144,869,30648,110.0,701.1428571428571,28.79950569575679,183.5687973438627,"(24.0, 37.5]",Q2
36071,2020-05-05,381951,36,71,9215,509,31157,103.85714285714286,687.8571428571429,27.191221611448288,180.0904154871025,"(24.0, 37.5]",Q2
36071,2020-05-06,381951,36,113,9328,1181,32338,96.85714285714286,730.8571428571429,25.358525794445587,191.34840407726196,"(24.0, 37.5]",Q2
36071,2020-05-07,381951,36,74,9402,842,33180,93.0,738.7142857142857,24.348672997321646,193.40551162695886,"(24.0, 37.5]",Q2
36071,2020-05-08,381951,36,84,9486,690,33870,82.28571428571429,717.4285714285714,21.54352633864404,187.8326202650527,"(24.0, 37.5]",Q2
36071,2020-05-09,381951,36,57,9543,535,34405,82.28571428571429,721.0,21.54352633864404,188.76766915127857,"(24.0, 37.5]",Q2
36071,2020-05-10,381951,36,41,9584,402,34807,81.28571428571429,718.2857142857143,21.281712650500797,188.05703199774692,"(24.0, 37.5]",Q2
36071,2020-05-11,381951,36,48,9632,516,35323,69.71428571428571,667.8571428571429,18.252154259128975,174.85414172423765,"(24.0, 37.5]",Q2
36071,2020-05-12,381951,36,61,9693,614,35937,68.28571428571429,682.8571428571429,17.87813470463863,178.7813470463863,"(24.0, 37.5]",Q2
36071,2020-05-13,381951,36,78,9771,939,36876,63.285714285714285,648.2857142857143,16.569066263922412,169.73007382771988,"(24.0, 37.5]",Q2
36071,2020-05-14,381951,36,54,9825,766,37642,60.42857142857143,637.4285714285714,15.821027154941714,166.88752521359322,"(24.0, 37.5]",Q2
36071,2020-05-15,381951,36,54,9879,715,38357,56.142857142857146,641.0,14.698968491470673,167.8225740998191,"(24.0, 37.5]",Q2
36071,2020-05-16,381951,36,64,9943,662,39019,57.142857142857146,659.1428571428571,14.960782179613915,172.5726224418465,"(24.0, 37.5]",Q2
36071,2020-05-17,381951,36,22,9965,367,39386,54.42857142857143,654.1428571428571,14.250145026082253,171.26355400113027,"(24.0, 37.5]",Q2
36071,2020-05-18,381951,36,23,9988,362,39748,50.857142857142854,632.1428571428571,13.315096139856383,165.5036528619789,"(24.0, 37.5]",Q2
36071,2020-05-19,381951,36,55,10043,819,40567,50.0,661.4285714285714,13.090684407162176,173.17105372903106,"(24.0, 37.5]",Q2
36071,2020-05-20,381951,36,49,10092,919,41486,45.857142857142854,658.5714285714286,12.006027699140166,172.42301462005034,"(24.0, 37.5]",Q2
36071,2020-05-21,381951,36,50,10142,753,42239,45.285714285714285,656.7142857142857,11.856419877344026,171.9367891992129,"(24.0, 37.5]",Q2
36071,2020-05-22,381951,36,55,10197,764,43003,45.42857142857143,663.7142857142857,11.893821832793062,173.7694850162156,"(24.0, 37.5]",Q2
36071,2020-05-23,381951,36,28,10225,638,43641,40.285714285714285,660.2857142857143,10.54735143662781,172.87183808543878,"(24.0, 37.5]",Q2
36071,2020-05-24,381951,36,19,10244,478,44119,39.857142857142854,676.1428571428571,10.435145570280705,177.02345514028164,"(24.0, 37.5]",Q2
36071,2020-05-25,381951,36,33,10277,617,44736,41.285714285714285,712.5714285714286,10.809165124771054,186.5609537797855,"(24.0, 37.5]",Q2
36071,2020-05-26,381951,36,15,10292,528,45264,35.57142857142857,671.0,9.313086906809662,175.6769847441164,"(24.0, 37.5]",Q2
36071,2020-05-27,381951,36,33,10325,1013,46277,33.285714285714285,684.4285714285714,8.714655619625105,179.19276855632566,"(24.0, 37.5]",Q2
36071,2020-05-28,381951,36,36,10361,868,47145,31.285714285714285,700.8571428571429,8.191028243338618,183.49399343296466,"(24.0, 37.5]",Q2
36071,2020-05-29,381951,36,28,10389,776,47921,27.428571428571427,702.5714285714286,7.181175446214679,183.94281689835307,"(24.0, 37.5]",Q2
36071,2020-05-30,381951,36,17,10406,683,48604,25.857142857142858,709.0,6.769753936275296,185.62590489355966,"(24.0, 37.5]",Q2
36071,2020-05-31,381951,36,16,10422,713,49317,25.428571428571427,742.5714285714286,6.6575480699281915,194.4153644240828,"(24.0, 37.5]",Q2
36071,2020-06-01,381951,36,27,10449,1027,50344,24.571428571428573,801.1428571428571,6.433136337233983,209.75016615818708,"(24.0, 37.5]",Q2
36071,2020-06-02,381951,36,11,10460,842,51186,24.0,846.0,6.283528515437844,221.494380169184,"(24.0, 37.5]",Q2
36071,2020-06-03,381951,36,11,10471,941,52127,20.857142857142858,835.7142857142857,5.460685495559079,218.8014393768535,"(24.0, 37.5]",Q2
36071,2020-06-04,381951,36,13,10484,978,53105,17.571428571428573,851.4285714285714,4.600440520231279,222.91565447624734,"(24.0, 37.5]",Q2
36071,2020-06-05,381951,36,24,10508,1157,54262,17.0,905.8571428571429,4.450832698435139,237.1657995023296,"(24.0, 37.5]",Q2
36071,2020-06-06,381951,36,6,10514,847,55109,15.428571428571429,929.2857142857143,4.039411188495757,243.2997201959713,"(24.0, 37.5]",Q2
36071,2020-06-07,381951,36,9,10523,827,55936,14.428571428571429,945.5714285714286,3.7775975003525137,247.56354311716126,"(24.0, 37.5]",Q2
36073,2020-03-02,40612,50,0,0,0,0,0.0,0.0,0.0,0.0,"(37.5, 52.0]",Q3
36073,2020-03-03,40612,50,0,0,0,0,0.0,0.0,0.0,0.0,"(37.5, 52.0]",Q3
36073,2020-03-04,40612,50,0,0,0,0,0.0,0.0,0.0,0.0,"(37.5, 52.0]",Q3
36073,2020-03-05,40612,50,0,0,0,0,0.0,0.0,0.0,0.0,"(37.5, 52.0]",Q3
36073,2020-03-06,40612,50,0,0,0,0,0.0,0.0,0.0,0.0,"(37.5, 52.0]",Q3
36073,2020-03-07,40612,50,0,0,0,0,0.0,0.0,0.0,0.0,"(37.5, 52.0]",Q3
36073,2020-03-08,40612,50,0,0,0,0,0.0,0.0,0.0,0.0,"(37.5, 52.0]",Q3
36073,2020-03-09,40612,50,0,0,0,0,0.0,0.0,0.0,0.0,"(37.5, 52.0]",Q3
36073,2020-03-10,40612,50,0,0,0,0,0.0,0.0,0.0,0.0,"(37.5, 52.0]",Q3
36073,2020-03-11,40612,50,0,0,0,0,0.0,0.0,0.0,0.0,"(37.5, 52.0]",Q3
36073,2020-03-12,40612,50,0,0,0,0,0.0,0.0,0.0,0.0,"(37.5, 52.0]",Q3
36073,2020-03-13,40612,50,0,0,1,1,0.0,0.14285714285714285,0.0,0.35176091514119684,"(37.5, 52.0]",Q3
36073,2020-03-14,40612,50,0,0,0,1,0.0,0.14285714285714285,0.0,0.35176091514119684,"(37.5, 52.0]",Q3
36073,2020-03-15,40612,50,0,0,0,1,0.0,0.14285714285714285,0.0,0.35176091514119684,"(37.5, 52.0]",Q3
36073,2020-03-16,40612,50,0,0,5,6,0.0,0.8571428571428571,0.0,2.110565490847181,"(37.5, 52.0]",Q3
36073,2020-03-17,40612,50,0,0,5,11,0.0,1.5714285714285714,0.0,3.8693700665531647,"(37.5, 52.0]",Q3
36073,2020-03-18,40612,50,0,0,3,14,0.0,2.0,0.0,4.924652811976756,"(37.5, 52.0]",Q3
36073,2020-03-19,40612,50,0,0,6,20,0.0,2.857142857142857,0.0,7.035218302823937,"(37.5, 52.0]",Q3
36073,2020-03-20,40612,50,0,0,5,25,0.0,3.4285714285714284,0.0,8.442261963388724,"(37.5, 52.0]",Q3
36073,2020-03-21,40612,50,0,0,7,32,0.0,4.428571428571429,0.0,10.904588369377104,"(37.5, 52.0]",Q3
36073,2020-03-22,40612,50,0,0,4,36,0.0,5.0,0.0,12.31163202994189,"(37.5, 52.0]",Q3
36073,2020-03-23,40612,50,2,2,9,45,0.2857142857142857,5.571428571428571,0.7035218302823937,13.718675690506675,"(37.5, 52.0]",Q3
36073,2020-03-24,40612,50,0,2,7,52,0.2857142857142857,5.857142857142857,0.7035218302823937,14.42219752078907,"(37.5, 52.0]",Q3
36073,2020-03-25,40612,50,0,2,11,63,0.2857142857142857,7.0,0.7035218302823937,17.236284841918646,"(37.5, 52.0]",Q3
36073,2020-03-26,40612,50,1,3,11,74,0.42857142857142855,7.714285714285714,1.0552827454235905,18.99508941762463,"(37.5, 52.0]",Q3
36073,2020-03-27,40612,50,0,3,8,82,0.42857142857142855,8.142857142857142,1.0552827454235905,20.05037216304822,"(37.5, 52.0]",Q3
36073,2020-03-28,40612,50,0,3,3,85,0.42857142857142855,7.571428571428571,1.0552827454235905,18.64332850248343,"(37.5, 52.0]",Q3
36073,2020-03-29,40612,50,1,4,11,96,0.5714285714285714,8.571428571428571,1.4070436605647874,21.10565490847181,"(37.5, 52.0]",Q3
36073,2020-03-30,40612,50,2,6,14,110,0.5714285714285714,9.285714285714286,1.4070436605647874,22.864459484177797,"(37.5, 52.0]",Q3
36073,2020-03-31,40612,50,0,6,6,116,0.5714285714285714,9.142857142857142,1.4070436605647874,22.512698569036598,"(37.5, 52.0]",Q3
36073,2020-04-01,40612,50,0,6,11,127,0.5714285714285714,9.142857142857142,1.4070436605647874,22.512698569036598,"(37.5, 52.0]",Q3
36073,2020-04-02,40612,50,3,9,13,140,0.8571428571428571,9.428571428571429,2.110565490847181,23.216220399318992,"(37.5, 52.0]",Q3
36073,2020-04-03,40612,50,1,10,11,151,1.0,9.857142857142858,2.462326405988378,24.271503144742585,"(37.5, 52.0]",Q3
36073,2020-04-04,40612,50,1,11,9,160,1.1428571428571428,10.714285714285714,2.8140873211295747,26.382068635589764,"(37.5, 52.0]",Q3
36073,2020-04-05,40612,50,2,13,16,176,1.2857142857142858,11.428571428571429,3.165848236270772,28.140873211295748,"(37.5, 52.0]",Q3
36073,2020-04-06,40612,50,2,15,17,193,1.2857142857142858,11.857142857142858,3.165848236270772,29.19615595671934,"(37.5, 52.0]",Q3
36073,2020-04-07,40612,50,1,16,14,207,1.4285714285714286,13.0,3.5176091514119685,32.01024327784891,"(37.5, 52.0]",Q3
36073,2020-04-08,40612,50,6,22,27,234,2.2857142857142856,15.285714285714286,5.628174642259149,37.63841792010806,"(37.5, 52.0]",Q3
36073,2020-04-09,40612,50,2,24,14,248,2.142857142857143,15.428571428571429,5.276413727117952,37.99017883524926,"(37.5, 52.0]",Q3
36073,2020-04-10,40612,50,0,24,3,251,2.0,14.285714285714286,4.924652811976756,35.17609151411968,"(37.5, 52.0]",Q3
36073,2020-04-11,40612,50,1,25,7,258,2.0,14.0,4.924652811976756,34.47256968383729,"(37.5, 52.0]",Q3
36073,2020-04-12,40612,50,1,26,6,264,1.8571428571428572,12.571428571428571,4.572891896835559,30.954960532425318,"(37.5, 52.0]",Q3
36073,2020-04-13,40612,50,5,31,18,282,2.2857142857142856,12.714285714285714,5.628174642259149,31.306721447566513,"(37.5, 52.0]",Q3
36073,2020-04-14,40612,50,2,33,8,290,2.4285714285714284,11.857142857142858,5.979935557400346,29.19615595671934,"(37.5, 52.0]",Q3
36073,2020-04-15,40612,50,1,34,5,295,1.7142857142857142,8.714285714285714,4.221130981694362,21.457415823613005,"(37.5, 52.0]",Q3
36073,2020-04-16,40612,50,0,34,4,299,1.4285714285714286,7.285714285714286,3.5176091514119685,17.939806672201037,"(37.5, 52.0]",Q3
36073,2020-04-17,40612,50,7,41,14,313,2.4285714285714284,8.857142857142858,5.979935557400346,21.809176738754207,"(37.5, 52.0]",Q3
36073,2020-04-18,40612,50,5,46,35,348,3.0,12.857142857142858,7.386979217965134,31.658482362707716,"(37.5, 52.0]",Q3
36073,2020-04-19,40612,50,0,46,3,351,2.857142857142857,12.428571428571429,7.035218302823937,30.603199617284126,"(37.5, 52.0]",Q3
36073,2020-04-20,40612,50,7,53,33,384,3.142857142857143,14.571428571428571,7.7387401331063295,35.879613344402074,"(37.5, 52.0]",Q3
36073,2020-04-21,40612,50,3,56,11,395,3.2857142857142856,15.0,8.090501048247527,36.93489608982566,"(37.5, 52.0]",Q3
36073,2020-04-22,40612,50,3,59,11,406,3.5714285714285716,15.857142857142858,8.79402287852992,39.04546158067285,"(37.5, 52.0]",Q3
36073,2020-04-23,40612,50,1,60,13,419,3.7142857142857144,17.142857142857142,9.145783793671118,42.21130981694362,"(37.5, 52.0]",Q3
36073,2020-04-24,40612,50,15,75,98,517,4.857142857142857,29.142857142857142,11.959871114800691,71.75922668880415,"(37.5, 52.0]",Q3
36073,2020-04-25,40612,50,5,80,28,545,4.857142857142857,28.142857142857142,11.959871114800691,69.29690028281577,"(37.5, 52.0]",Q3
36073,2020-04-26,40612,50,0,80,14,559,4.857142857142857,29.714285714285715,11.959871114800691,73.16627034936894,"(37.5, 52.0]",Q3
36073,2020-04-27,40612,50,0,80,8,567,3.857142857142857,26.142857142857142,9.497544708812315,64.37224747083903,"(37.5, 52.0]",Q3
36073,2020-04-28,40612,50,5,85,26,593,4.142857142857143,28.285714285714285,10.20106653909471,69.64866119795697,"(37.5, 52.0]",Q3
36073,2020-04-29,40612,50,4,89,35,628,4.285714285714286,31.714285714285715,10.552827454235905,78.0909231613457,"(37.5, 52.0]",Q3
36073,2020-04-30,40612,50,3,92,23,651,4.571428571428571,33.142857142857146,11.256349284518299,81.60853231275767,"(37.5, 52.0]",Q3
36073,2020-05-01,40612,50,1,93,29,680,2.5714285714285716,23.285714285714285,6.331696472541544,57.33702916801508,"(37.5, 52.0]",Q3
36073,2020-05-02,40612,50,4,97,22,702,2.4285714285714284,22.428571428571427,5.979935557400346,55.2264636771679,"(37.5, 52.0]",Q3
36073,2020-05-03,40612,50,0,97,21,723,2.4285714285714284,23.428571428571427,5.979935557400346,57.68879008315628,"(37.5, 52.0]",Q3
36073,2020-05-04,40612,50,2,99,15,738,2.7142857142857144,24.428571428571427,6.68345738768274,60.151116489144655,"(37.5, 52.0]",Q3
36073,2020-05-05,40612,50,4,103,36,774,2.5714285714285716,25.857142857142858,6.331696472541544,63.66872564055663,"(37.5, 52.0]",Q3
36073,2020-05-06,40612,50,5,108,33,807,2.7142857142857144,25.571428571428573,6.68345738768274,62.96520381027424,"(37.5, 52.0]",Q3
36073,2020-05-07,40612,50,13,121,62,869,4.142857142857143,31.142857142857142,10.20106653909471,76.6838795007809,"(37.5, 52.0]",Q3
36073,2020-05-08,40612,50,1,122,29,898,4.142857142857143,31.142857142857142,10.20106653909471,76.6838795007809,"(37.5, 52.0]",Q3
36073,2020-05-09,40612,50,4,126,41,939,4.142857142857143,33.857142857142854,10.20106653909471,83.36733688846364,"(37.5, 52.0]",Q3
36073,2020-05-10,40612,50,4,130,40,979,4.714285714285714,36.57142857142857,11.608110199659496,90.05079427614639,"(37.5, 52.0]",Q3
36073,2020-05-11,40612,50,3,133,31,1010,4.857142857142857,38.857142857142854,11.959871114800691,95.67896891840553,"(37.5, 52.0]",Q3
36073,2020-05-12,40612,50,9,142,61,1071,5.571428571428571,42.42857142857143,13.718675690506675,104.47299179693547,"(37.5, 52.0]",Q3
36073,2020-05-13,40612,50,3,145,57,1128,5.285714285714286,45.857142857142854,13.015153860224284,112.91525376032416,"(37.5, 52.0]",Q3
36073,2020-05-14,40612,50,2,147,38,1166,3.7142857142857144,42.42857142857143,9.145783793671118,104.47299179693547,"(37.5, 52.0]",Q3
36073,2020-05-15,40612,50,16,163,102,1268,5.857142857142857,52.857142857142854,14.42219752078907,130.15153860224282,"(37.5, 52.0]",Q3
36073,2020-05-16,40612,50,4,167,59,1327,5.857142857142857,55.42857142857143,14.42219752078907,136.48323507478437,"(37.5, 52.0]",Q3
36073,2020-05-17,40612,50,0,167,42,1369,5.285714285714286,55.714285714285715,13.015153860224284,137.18675690506677,"(37.5, 52.0]",Q3
36073,2020-05-18,40612,50,1,168,48,1417,5.0,58.142857142857146,12.31163202994189,143.16669246246713,"(37.5, 52.0]",Q3
36073,2020-05-19,40612,50,3,171,60,1477,4.142857142857143,58.0,10.20106653909471,142.81493154732593,"(37.5, 52.0]",Q3
36073,2020-05-20,40612,50,3,174,98,1575,4.142857142857143,63.857142857142854,10.20106653909471,157.237129068115,"(37.5, 52.0]",Q3
36073,2020-05-21,40612,50,1,175,50,1625,4.0,65.57142857142857,9.849305623953512,161.45826004980933,"(37.5, 52.0]",Q3
36073,2020-05-22,40612,50,21,196,85,1710,4.714285714285714,63.142857142857146,11.608110199659496,155.478324492409,"(37.5, 52.0]",Q3
36073,2020-05-23,40612,50,6,202,129,1839,5.0,73.14285714285714,12.31163202994189,180.10158855229278,"(37.5, 52.0]",Q3
36073,2020-05-24,40612,50,3,205,63,1902,5.428571428571429,76.14285714285714,13.36691477536548,187.4885677702579,"(37.5, 52.0]",Q3
36073,2020-05-25,40612,50,3,208,49,1951,5.714285714285714,76.28571428571429,14.070436605647874,187.8403286853991,"(37.5, 52.0]",Q3
36073,2020-05-26,40612,50,2,210,44,1995,5.571428571428571,74.0,13.718675690506675,182.21215404313998,"(37.5, 52.0]",Q3
36073,2020-05-27,40612,50,2,212,117,2112,5.428571428571429,76.71428571428571,13.36691477536548,188.89561143082267,"(37.5, 52.0]",Q3
36073,2020-05-28,40612,50,4,216,112,2224,5.857142857142857,85.57142857142857,14.42219752078907,210.7047881695769,"(37.5, 52.0]",Q3
36073,2020-05-29,40612,50,12,228,83,2307,4.571428571428571,85.28571428571429,11.256349284518299,210.00126633929452,"(37.5, 52.0]",Q3
36073,2020-05-30,40612,50,1,229,101,2408,3.857142857142857,81.28571428571429,9.497544708812315,200.15196071534103,"(37.5, 52.0]",Q3
36073,2020-05-31,40612,50,7,236,105,2513,4.428571428571429,87.28571428571429,10.904588369377104,214.9259191512713,"(37.5, 52.0]",Q3
36073,2020-06-01,40612,50,5,241,89,2602,4.714285714285714,93.0,11.608110199659496,228.99635575691912,"(37.5, 52.0]",Q3
36073,2020-06-02,40612,50,5,246,157,2759,5.142857142857143,109.14285714285714,12.663392945083087,268.74533916787436,"(37.5, 52.0]",Q3
36073,2020-06-03,40612,50,1,247,81,2840,5.0,104.0,12.31163202994189,256.08194622279126,"(37.5, 52.0]",Q3
36073,2020-06-04,40612,50,0,247,102,2942,4.428571428571429,102.57142857142857,10.904588369377104,252.56433707137933,"(37.5, 52.0]",Q3
36073,2020-06-05,40612,50,7,254,183,3125,3.7142857142857144,116.85714285714286,9.145783793671118,287.74042858549905,"(37.5, 52.0]",Q3
36073,2020-06-06,40612,50,1,255,115,3240,3.7142857142857144,118.85714285714286,9.145783793671118,292.6650813974758,"(37.5, 52.0]",Q3
36073,2020-06-07,40612,50,1,256,69,3309,2.857142857142857,113.71428571428571,7.035218302823937,280.00168845239267,"(37.5, 52.0]",Q3
36075,2020-03-02,117898,62,0,0,0,0,0.0,0.0,0.0,0.0,"(52.0, 100.0]",Q4
36075,2020-03-03,117898,62,0,0,0,0,0.0,0.0,0.0,0.0,"(52.0, 100.0]",Q4
36075,2020-03-04,117898,62,0,0,0,0,0.0,0.0,0.0,0.0,"(52.0, 100.0]",Q4
36075,2020-03-05,117898,62,0,0,0,0,0.0,0.0,0.0,0.0,"(52.0, 100.0]",Q4
36075,2020-03-06,117898,62,0,0,0,0,0.0,0.0,0.0,0.0,"(52.0, 100.0]",Q4
36075,2020-03-07,117898,62,0,0,0,0,0.0,0.0,0.0,0.0,"(52.0, 100.0]",Q4
36075,2020-03-08,117898,62,0,0,0,0,0.0,0.0,0.0,0.0,"(52.0, 100.0]",Q4
36075,2020-03-09,117898,62,0,0,0,0,0.0,0.0,0.0,0.0,"(52.0, 100.0]",Q4
36075,2020-03-10,117898,62,0,0,1,1,0.0,0.14285714285714285,0.0,0.12117011557205623,"(52.0, 100.0]",Q4
36075,2020-03-11,117898,62,0,0,0,1,0.0,0.14285714285714285,0.0,0.12117011557205623,"(52.0, 100.0]",Q4
36075,2020-03-12,117898,62,0,0,0,1,0.0,0.14285714285714285,0.0,0.12117011557205623,"(52.0, 100.0]",Q4
36075,2020-03-13,117898,62,0,0,2,3,0.0,0.42857142857142855,0.0,0.36351034671616866,"(52.0, 100.0]",Q4
36075,2020-03-14,117898,62,0,0,2,5,0.0,0.7142857142857143,0.0,0.6058505778602812,"(52.0, 100.0]",Q4
36075,2020-03-15,117898,62,0,0,0,5,0.0,0.7142857142857143,0.0,0.6058505778602812,"(52.0, 100.0]",Q4
36075,2020-03-16,117898,62,0,0,4,9,0.0,1.2857142857142858,0.0,1.0905310401485062,"(52.0, 100.0]",Q4
36075,2020-03-17,117898,62,0,0,3,12,0.0,1.5714285714285714,0.0,1.3328712712926185,"(52.0, 100.0]",Q4
36075,2020-03-18,117898,62,0,0,8,20,0.0,2.7142857142857144,0.0,2.3022321958690686,"(52.0, 100.0]",Q4
36075,2020-03-19,117898,62,0,0,3,23,0.0,3.142857142857143,0.0,2.665742542585237,"(52.0, 100.0]",Q4
36075,2020-03-20,117898,62,0,0,11,34,0.0,4.428571428571429,0.0,3.7562735827337432,"(52.0, 100.0]",Q4
36075,2020-03-21,117898,62,0,0,19,53,0.0,6.857142857142857,0.0,5.816165547458699,"(52.0, 100.0]",Q4
36075,2020-03-22,117898,62,1,1,23,76,0.14285714285714285,10.142857142857142,0.12117011557205623,8.603078205615992,"(52.0, 100.0]",Q4
36075,2020-03-23,117898,62,1,2,28,104,0.2857142857142857,13.571428571428571,0.24234023114411246,11.511160979345341,"(52.0, 100.0]",Q4
36075,2020-03-24,117898,62,0,2,13,117,0.2857142857142857,15.0,0.24234023114411246,12.722862135065906,"(52.0, 100.0]",Q4
36075,2020-03-25,117898,62,2,4,25,142,0.5714285714285714,17.428571428571427,0.4846804622882249,14.782754099790859,"(52.0, 100.0]",Q4
36075,2020-03-26,117898,62,0,4,18,160,0.5714285714285714,19.571428571428573,0.4846804622882249,16.600305833371706,"(52.0, 100.0]",Q4
36075,2020-03-27,117898,62,3,7,38,198,1.0,23.428571428571427,0.8481908090043937,19.87189895381722,"(52.0, 100.0]",Q4
36075,2020-03-28,117898,62,1,8,35,233,1.1428571428571428,25.714285714285715,0.9693609245764498,21.81062080297012,"(52.0, 100.0]",Q4
36075,2020-03-29,117898,62,6,14,53,286,1.8571428571428572,30.0,1.575211502436731,25.445724270131812,"(52.0, 100.0]",Q4
36075,2020-03-30,117898,62,1,15,30,316,1.8571428571428572,30.285714285714285,1.575211502436731,25.68806450127592,"(52.0, 100.0]",Q4
36075,2020-03-31,117898,62,2,17,27,343,2.142857142857143,32.285714285714285,1.8175517335808433,27.384446119284707,"(52.0, 100.0]",Q4
36075,2020-04-01,117898,62,5,22,80,423,2.5714285714285716,40.142857142857146,2.1810620802970124,34.048802475747806,"(52.0, 100.0]",Q4
36075,2020-04-02,117898,62,4,26,82,505,3.142857142857143,49.285714285714285,2.665742542585237,41.8036898723594,"(52.0, 100.0]",Q4
36075,2020-04-03,117898,62,0,26,31,536,2.7142857142857144,48.285714285714285,2.3022321958690686,40.955499063355006,"(52.0, 100.0]",Q4
36075,2020-04-04,117898,62,2,28,26,562,2.857142857142857,47.0,2.4234023114411247,39.8649680232065,"(52.0, 100.0]",Q4
36075,2020-04-05,117898,62,1,29,39,601,2.142857142857143,45.0,1.8175517335808433,38.168586405197715,"(52.0, 100.0]",Q4
36075,2020-04-06,117898,62,2,31,70,671,2.2857142857142856,50.714285714285715,1.9387218491528997,43.01539102807997,"(52.0, 100.0]",Q4
36075,2020-04-07,117898,62,2,33,27,698,2.2857142857142856,50.714285714285715,1.9387218491528997,43.01539102807997,"(52.0, 100.0]",Q4
36075,2020-04-08,117898,62,3,36,61,759,2.0,48.0,1.6963816180087874,40.713158832210894,"(52.0, 100.0]",Q4
36075,2020-04-09,117898,62,0,36,32,791,1.4285714285714286,40.857142857142854,1.2117011557205624,34.65465305360808,"(52.0, 100.0]",Q4
36075,2020-04-10,117898,62,1,37,12,803,1.5714285714285714,38.142857142857146,1.3328712712926185,32.35242085773902,"(52.0, 100.0]",Q4
36075,2020-04-11,117898,62,1,38,15,818,1.4285714285714286,36.57142857142857,1.2117011557205624,31.019549586446395,"(52.0, 100.0]",Q4
36075,2020-04-12,117898,62,0,38,10,828,1.2857142857142858,32.42857142857143,1.0905310401485062,27.505616234856767,"(52.0, 100.0]",Q4
36075,2020-04-13,117898,62,3,41,74,902,1.4285714285714286,33.0,1.2117011557205624,27.99029669714499,"(52.0, 100.0]",Q4
36075,2020-04-14,117898,62,1,42,17,919,1.2857142857142858,31.571428571428573,1.0905310401485062,26.77859554142443,"(52.0, 100.0]",Q4
36075,2020-04-15,117898,62,2,44,18,937,1.1428571428571428,25.428571428571427,0.9693609245764498,21.56828057182601,"(52.0, 100.0]",Q4
36075,2020-04-16,117898,62,1,45,28,965,1.2857142857142858,24.857142857142858,1.0905310401485062,21.083600109537784,"(52.0, 100.0]",Q4
36075,2020-04-17,117898,62,0,45,14,979,1.1428571428571428,25.142857142857142,0.9693609245764498,21.325940340681896,"(52.0, 100.0]",Q4
36075,2020-04-18,117898,62,2,47,18,997,1.2857142857142858,25.571428571428573,1.0905310401485062,21.689450687398068,"(52.0, 100.0]",Q4
36075,2020-04-19,117898,62,1,48,18,1015,1.4285714285714286,26.714285714285715,1.2117011557205624,22.658811611974517,"(52.0, 100.0]",Q4
36075,2020-04-20,117898,62,1,49,12,1027,1.1428571428571428,17.857142857142858,0.9693609245764498,15.14626444650703,"(52.0, 100.0]",Q4
36075,2020-04-21,117898,62,0,49,4,1031,1.0,16.0,0.8481908090043937,13.5710529440703,"(52.0, 100.0]",Q4
36075,2020-04-22,117898,62,0,49,21,1052,0.7142857142857143,16.428571428571427,0.6058505778602812,13.934563290786466,"(52.0, 100.0]",Q4
36075,2020-04-23,117898,62,2,51,18,1070,0.8571428571428571,15.0,0.7270206934323373,12.722862135065906,"(52.0, 100.0]",Q4
36075,2020-04-24,117898,62,6,57,298,1368,1.7142857142857142,55.57142857142857,1.4540413868646747,47.13517495752987,"(52.0, 100.0]",Q4
36075,2020-04-25,117898,62,4,61,67,1435,2.0,62.57142857142857,1.6963816180087874,53.07251062056063,"(52.0, 100.0]",Q4
36075,2020-04-26,117898,62,0,61,33,1468,1.8571428571428572,64.71428571428571,1.575211502436731,54.89006235414146,"(52.0, 100.0]",Q4
36075,2020-04-27,117898,62,2,63,40,1508,2.0,68.71428571428571,1.6963816180087874,58.28282559015905,"(52.0, 100.0]",Q4
36075,2020-04-28,117898,62,0,63,39,1547,2.0,73.71428571428571,1.6963816180087874,62.52377963518101,"(52.0, 100.0]",Q4
36075,2020-04-29,117898,62,0,63,45,1592,2.0,77.14285714285714,1.6963816180087874,65.43186240891036,"(52.0, 100.0]",Q4
36075,2020-04-30,117898,62,1,64,36,1628,1.8571428571428572,79.71428571428571,1.575211502436731,67.61292448920737,"(52.0, 100.0]",Q4
36075,2020-05-01,117898,62,2,66,30,1658,1.2857142857142858,41.42857142857143,1.0905310401485062,35.13933351589631,"(52.0, 100.0]",Q4
36075,2020-05-02,117898,62,0,66,37,1695,0.7142857142857143,37.142857142857146,0.6058505778602812,31.504230048734623,"(52.0, 100.0]",Q4
36075,2020-05-03,117898,62,1,67,44,1739,0.8571428571428571,38.714285714285715,0.7270206934323373,32.837101320027244,"(52.0, 100.0]",Q4
36075,2020-05-04,117898,62,1,68,40,1779,0.7142857142857143,38.714285714285715,0.6058505778602812,32.837101320027244,"(52.0, 100.0]",Q4
36075,2020-05-05,117898,62,2,70,41,1820,1.0,39.0,0.8481908090043937,33.07944155117135,"(52.0, 100.0]",Q4
36075,2020-05-06,117898,62,0,70,48,1868,1.0,39.42857142857143,0.8481908090043937,33.44295189788752,"(52.0, 100.0]",Q4
36075,2020-05-07,117898,62,2,72,54,1922,1.1428571428571428,42.0,0.9693609245764498,35.624013978184536,"(52.0, 100.0]",Q4
36075,2020-05-08,117898,62,3,75,52,1974,1.2857142857142858,45.142857142857146,1.0905310401485062,38.28975652076978,"(52.0, 100.0]",Q4
36075,2020-05-09,117898,62,0,75,59,2033,1.2857142857142858,48.285714285714285,1.0905310401485062,40.955499063355006,"(52.0, 100.0]",Q4
36075,2020-05-10,117898,62,0,75,49,2082,1.1428571428571428,49.0,0.9693609245764498,41.56134964121529,"(52.0, 100.0]",Q4
36075,2020-05-11,117898,62,1,76,53,2135,1.1428571428571428,50.857142857142854,0.9693609245764498,43.13656114365202,"(52.0, 100.0]",Q4
36075,2020-05-12,117898,62,0,76,59,2194,0.8571428571428571,53.42857142857143,0.7270206934323373,45.317623223949035,"(52.0, 100.0]",Q4
36075,2020-05-13,117898,62,2,78,64,2258,1.1428571428571428,55.714285714285715,0.9693609245764498,47.25634507310193,"(52.0, 100.0]",Q4
36075,2020-05-14,117898,62,2,80,110,2368,1.1428571428571428,63.714285714285715,0.9693609245764498,54.04187154513708,"(52.0, 100.0]",Q4
36075,2020-05-15,117898,62,3,83,241,2609,1.1428571428571428,90.71428571428571,0.9693609245764498,76.94302338825571,"(52.0, 100.0]",Q4
36075,2020-05-16,117898,62,1,84,81,2690,1.2857142857142858,93.85714285714286,1.0905310401485062,79.60876593084095,"(52.0, 100.0]",Q4
36075,2020-05-17,117898,62,0,84,197,2887,1.2857142857142858,115.0,1.0905310401485062,97.54194303550527,"(52.0, 100.0]",Q4
36075,2020-05-18,117898,62,5,89,95,2982,1.8571428571428572,121.0,1.575211502436731,102.63108788953163,"(52.0, 100.0]",Q4
36075,2020-05-19,117898,62,1,90,129,3111,2.0,131.0,1.6963816180087874,111.11299597957557,"(52.0, 100.0]",Q4
36075,2020-05-20,117898,62,2,92,300,3411,2.0,164.71428571428572,1.6963816180087874,139.70914325458085,"(52.0, 100.0]",Q4
36075,2020-05-21,117898,62,4,96,215,3626,2.2857142857142856,179.71428571428572,1.9387218491528997,152.43200538964675,"(52.0, 100.0]",Q4
36075,2020-05-22,117898,62,3,99,302,3928,2.2857142857142856,188.42857142857142,1.9387218491528997,159.82338243954217,"(52.0, 100.0]",Q4
36075,2020-05-23,117898,62,1,100,479,4407,2.2857142857142856,245.28571428571428,1.9387218491528997,208.04908843722058,"(52.0, 100.0]",Q4
36075,2020-05-24,117898,62,4,104,131,4538,2.857142857142857,235.85714285714286,2.4234023114411247,200.05186080946487,"(52.0, 100.0]",Q4
36075,2020-05-25,117898,62,0,104,175,4713,2.142857142857143,247.28571428571428,1.8175517335808433,209.7454700552293,"(52.0, 100.0]",Q4
36075,2020-05-26,117898,62,1,105,337,5050,2.142857142857143,277.0,1.8175517335808433,234.948854094217,"(52.0, 100.0]",Q4
36075,2020-05-27,117898,62,2,107,260,5310,2.142857142857143,271.2857142857143,1.8175517335808433,230.1020494713348,"(52.0, 100.0]",Q4
36075,2020-05-28,117898,62,1,108,252,5562,1.7142857142857142,276.57142857142856,1.4540413868646747,234.58534374750087,"(52.0, 100.0]",Q4
36075,2020-05-29,117898,62,0,108,317,5879,1.2857142857142858,278.7142857142857,1.0905310401485062,236.4028954810817,"(52.0, 100.0]",Q4
36075,2020-05-30,117898,62,1,109,443,6322,1.2857142857142858,273.57142857142856,1.0905310401485062,232.04077132048766,"(52.0, 100.0]",Q4
36075,2020-05-31,117898,62,1,110,138,6460,0.8571428571428571,274.57142857142856,0.7270206934323373,232.88896212949206,"(52.0, 100.0]",Q4
36075,2020-06-01,117898,62,0,110,308,6768,0.8571428571428571,293.57142857142856,0.7270206934323373,249.00458750057555,"(52.0, 100.0]",Q4
36075,2020-06-02,117898,62,2,112,409,7177,1.0,303.85714285714283,0.8481908090043937,257.7288358217636,"(52.0, 100.0]",Q4
36075,2020-06-03,117898,62,0,112,185,7362,0.7142857142857143,293.14285714285717,0.6058505778602812,248.64107715385938,"(52.0, 100.0]",Q4
36075,2020-06-04,117898,62,0,112,609,7971,0.5714285714285714,344.14285714285717,0.4846804622882249,291.8988084130835,"(52.0, 100.0]",Q4
36075,2020-06-05,117898,62,2,114,475,8446,0.8571428571428571,366.7142857142857,0.7270206934323373,311.04368667346836,"(52.0, 100.0]",Q4
36075,2020-06-06,117898,62,1,115,272,8718,0.8571428571428571,342.2857142857143,0.7270206934323373,290.3235969106467,"(52.0, 100.0]",Q4
36075,2020-06-07,117898,62,0,115,414,9132,0.7142857142857143,381.7142857142857,0.6058505778602812,323.76654880853425,"(52.0, 100.0]",Q4
36077,2020-03-02,59749,36,0,0,0,0,0.0,0.0,0.0,0.0,"(24.0, 37.5]",Q2
36077,2020-03-03,59749,36,0,0,0,0,0.0,0.0,0.0,0.0,"(24.0, 37.5]",Q2
36077,2020-03-04,59749,36,0,0,0,0,0.0,0.0,0.0,0.0,"(24.0, 37.5]",Q2
36077,2020-03-05,59749,36,0,0,0,0,0.0,0.0,0.0,0.0,"(24.0, 37.5]",Q2
36077,2020-03-06,59749,36,0,0,0,0,0.0,0.0,0.0,0.0,"(24.0, 37.5]",Q2
36077,2020-03-07,59749,36,0,0,1,1,0.0,1.0,0.0,1.6736681785469214,"(24.0, 37.5]",Q2
36077,2020-03-08,59749,36,0,0,1,2,0.0,0.2857142857142857,0.0,0.47819090815626314,"(24.0, 37.5]",Q2
36077,2020-03-09,59749,36,0,0,0,2,0.0,0.2857142857142857,0.0,0.47819090815626314,"(24.0, 37.5]",Q2
36077,2020-03-10,59749,36,0,0,0,2,0.0,0.2857142857142857,0.0,0.47819090815626314,"(24.0, 37.5]",Q2
36077,2020-03-11,59749,36,0,0,0,2,0.0,0.2857142857142857,0.0,0.47819090815626314,"(24.0, 37.5]",Q2
36077,2020-03-12,59749,36,0,0,0,2,0.0,0.2857142857142857,0.0,0.47819090815626314,"(24.0, 37.5]",Q2
36077,2020-03-13,59749,36,0,0,1,3,0.0,0.42857142857142855,0.0,0.7172863622343948,"(24.0, 37.5]",Q2
36077,2020-03-14,59749,36,0,0,2,5,0.0,0.5714285714285714,0.0,0.9563818163125263,"(24.0, 37.5]",Q2
36077,2020-03-15,59749,36,0,0,1,6,0.0,0.5714285714285714,0.0,0.9563818163125263,"(24.0, 37.5]",Q2
36077,2020-03-16,59749,36,0,0,0,6,0.0,0.5714285714285714,0.0,0.9563818163125263,"(24.0, 37.5]",Q2
36077,2020-03-17,59749,36,0,0,1,7,0.0,0.7142857142857143,0.0,1.1954772703906582,"(24.0, 37.5]",Q2
36077,2020-03-18,59749,36,0,0,2,9,0.0,1.0,0.0,1.6736681785469214,"(24.0, 37.5]",Q2
36077,2020-03-19,59749,36,0,0,10,19,0.0,2.4285714285714284,0.0,4.064622719328237,"(24.0, 37.5]",Q2
36077,2020-03-20,59749,36,0,0,20,39,0.0,5.142857142857143,0.0,8.607436346812738,"(24.0, 37.5]",Q2
36077,2020-03-21,59749,36,0,0,11,50,0.0,6.428571428571429,0.0,10.759295433515923,"(24.0, 37.5]",Q2
36077,2020-03-22,59749,36,1,1,10,60,0.14285714285714285,7.714285714285714,0.23909545407813157,12.911154520219107,"(24.0, 37.5]",Q2
36077,2020-03-23,59749,36,0,1,11,71,0.14285714285714285,9.285714285714286,0.23909545407813157,15.541204515078556,"(24.0, 37.5]",Q2
36077,2020-03-24,59749,36,1,2,5,76,0.2857142857142857,9.857142857142858,0.47819090815626314,16.497586331391084,"(24.0, 37.5]",Q2
36077,2020-03-25,59749,36,1,3,6,82,0.42857142857142855,10.428571428571429,0.7172863622343948,17.45396814770361,"(24.0, 37.5]",Q2
36077,2020-03-26,59749,36,2,5,12,94,0.7142857142857143,10.714285714285714,1.1954772703906582,17.93215905585987,"(24.0, 37.5]",Q2
36077,2020-03-27,59749,36,2,7,19,113,1.0,10.571428571428571,1.6736681785469214,17.693063601781738,"(24.0, 37.5]",Q2
36077,2020-03-28,59749,36,3,10,21,134,1.4285714285714286,12.0,2.3909545407813164,20.084018142563053,"(24.0, 37.5]",Q2
36077,2020-03-29,59749,36,7,17,16,150,2.2857142857142856,12.857142857142858,3.825527265250105,21.518590867031847,"(24.0, 37.5]",Q2
36077,2020-03-30,59749,36,1,18,8,158,2.4285714285714284,12.428571428571429,4.064622719328237,20.80130450479745,"(24.0, 37.5]",Q2
36077,2020-03-31,59749,36,1,19,19,177,2.4285714285714284,14.428571428571429,4.064622719328237,24.148640861891295,"(24.0, 37.5]",Q2
36077,2020-04-01,59749,36,2,21,17,194,2.5714285714285716,16.0,4.303718173406369,26.778690856750742,"(24.0, 37.5]",Q2
36077,2020-04-02,59749,36,0,21,12,206,2.2857142857142856,16.0,3.825527265250105,26.778690856750742,"(24.0, 37.5]",Q2
36077,2020-04-03,59749,36,5,26,53,259,2.7142857142857144,20.857142857142858,4.5428136274845015,34.90793629540722,"(24.0, 37.5]",Q2
36077,2020-04-04,59749,36,3,29,25,284,2.7142857142857144,21.428571428571427,4.5428136274845015,35.86431811171974,"(24.0, 37.5]",Q2
36077,2020-04-05,59749,36,5,34,41,325,2.4285714285714284,25.0,4.064622719328237,41.84170446367303,"(24.0, 37.5]",Q2
36077,2020-04-06,59749,36,0,34,43,368,2.2857142857142856,30.0,3.825527265250105,50.21004535640764,"(24.0, 37.5]",Q2
36077,2020-04-07,59749,36,4,38,31,399,2.7142857142857144,31.714285714285715,4.5428136274845015,53.07919080534521,"(24.0, 37.5]",Q2
36077,2020-04-08,59749,36,1,39,42,441,2.5714285714285716,35.285714285714285,4.303718173406369,59.05657715729851,"(24.0, 37.5]",Q2
36077,2020-04-09,59749,36,2,41,40,481,2.857142857142857,39.285714285714285,4.781909081562633,65.7512498714862,"(24.0, 37.5]",Q2
36077,2020-04-10,59749,36,2,43,34,515,2.4285714285714284,36.57142857142857,4.064622719328237,61.20843624400168,"(24.0, 37.5]",Q2
36077,2020-04-11,59749,36,0,43,15,530,2.0,35.142857142857146,3.347336357093843,58.81748170322038,"(24.0, 37.5]",Q2
36077,2020-04-12,59749,36,0,43,35,565,1.2857142857142858,34.285714285714285,2.1518590867031846,57.38290897875159,"(24.0, 37.5]",Q2
36077,2020-04-13,59749,36,1,44,90,655,1.4285714285714286,41.0,2.3909545407813164,68.62039532042377,"(24.0, 37.5]",Q2
36077,2020-04-14,59749,36,0,44,14,669,0.8571428571428571,38.57142857142857,1.4345727244687896,64.55577260109553,"(24.0, 37.5]",Q2
36077,2020-04-15,59749,36,0,44,15,684,0.7142857142857143,34.714285714285715,1.1954772703906582,58.10019534098598,"(24.0, 37.5]",Q2
36077,2020-04-16,59749,36,0,44,9,693,0.42857142857142855,30.285714285714285,0.7172863622343948,50.688236264563905,"(24.0, 37.5]",Q2
36077,2020-04-17,59749,36,3,47,18,711,0.5714285714285714,28.0,0.9563818163125263,46.862708999313796,"(24.0, 37.5]",Q2
36077,2020-04-18,59749,36,1,48,18,729,0.7142857142857143,28.428571428571427,1.1954772703906582,47.579995361548185,"(24.0, 37.5]",Q2
36077,2020-04-19,59749,36,1,49,10,739,0.8571428571428571,24.857142857142858,1.4345727244687896,41.6026090095949,"(24.0, 37.5]",Q2
36077,2020-04-20,59749,36,0,49,10,749,0.7142857142857143,13.428571428571429,1.1954772703906582,22.474972683344372,"(24.0, 37.5]",Q2
36077,2020-04-21,59749,36,0,49,15,764,0.7142857142857143,13.571428571428571,1.1954772703906582,22.7140681374225,"(24.0, 37.5]",Q2
36077,2020-04-22,59749,36,1,50,22,786,0.8571428571428571,14.571428571428571,1.4345727244687896,24.387736315969423,"(24.0, 37.5]",Q2
36077,2020-04-23,59749,36,0,50,18,804,0.8571428571428571,15.857142857142858,1.4345727244687896,26.539595402672607,"(24.0, 37.5]",Q2
36077,2020-04-24,59749,36,10,60,249,1053,1.8571428571428572,48.857142857142854,3.1082409030157105,81.770645294721,"(24.0, 37.5]",Q2
36077,2020-04-25,59749,36,0,60,43,1096,1.7142857142857142,52.42857142857143,2.869145448937579,87.7480316466743,"(24.0, 37.5]",Q2
36077,2020-04-26,59749,36,2,62,38,1134,1.8571428571428572,56.42857142857143,3.1082409030157105,94.442704360862,"(24.0, 37.5]",Q2
36077,2020-04-27,59749,36,3,65,33,1167,2.2857142857142856,59.714285714285715,3.825527265250105,99.94189980465902,"(24.0, 37.5]",Q2
36077,2020-04-28,59749,36,1,66,34,1201,2.4285714285714284,62.42857142857143,4.064622719328237,104.48471343214352,"(24.0, 37.5]",Q2
36077,2020-04-29,59749,36,1,67,45,1246,2.4285714285714284,65.71428571428571,4.064622719328237,109.98390887594053,"(24.0, 37.5]",Q2
36077,2020-04-30,59749,36,0,67,40,1286,2.4285714285714284,68.85714285714286,4.064622719328237,115.24400886565944,"(24.0, 37.5]",Q2
36077,2020-05-01,59749,36,0,67,88,1374,1.0,45.857142857142854,1.6736681785469214,76.74964075908025,"(24.0, 37.5]",Q2
36077,2020-05-02,59749,36,0,67,42,1416,1.0,45.714285714285715,1.6736681785469214,76.51054530500213,"(24.0, 37.5]",Q2
36077,2020-05-03,59749,36,0,67,36,1452,0.7142857142857143,45.42857142857143,1.1954772703906582,76.03235439684585,"(24.0, 37.5]",Q2
36077,2020-05-04,59749,36,0,67,87,1539,0.2857142857142857,53.142857142857146,0.47819090815626314,88.94350891706496,"(24.0, 37.5]",Q2
36077,2020-05-05,59749,36,0,67,70,1609,0.14285714285714285,58.285714285714285,0.23909545407813157,97.5509452638777,"(24.0, 37.5]",Q2
36077,2020-05-06,59749,36,0,67,43,1652,0.0,58.0,0.0,97.07275435572143,"(24.0, 37.5]",Q2
36077,2020-05-07,59749,36,0,67,44,1696,0.0,58.57142857142857,0.0,98.02913617203396,"(24.0, 37.5]",Q2
36077,2020-05-08,59749,36,0,67,39,1735,0.0,51.57142857142857,0.0,86.3134589222055,"(24.0, 37.5]",Q2
36077,2020-05-09,59749,36,0,67,46,1781,0.0,52.142857142857146,0.0,87.26984073851804,"(24.0, 37.5]",Q2
36077,2020-05-10,59749,36,0,67,40,1821,0.0,52.714285714285715,0.0,88.22622255483057,"(24.0, 37.5]",Q2
36077,2020-05-11,59749,36,0,67,62,1883,0.0,49.142857142857146,0.0,82.24883620287727,"(24.0, 37.5]",Q2
36077,2020-05-12,59749,36,0,67,82,1965,0.0,50.857142857142854,0.0,85.11798165181486,"(24.0, 37.5]",Q2
36077,2020-05-13,59749,36,0,67,45,2010,0.0,51.142857142857146,0.0,85.59617255997112,"(24.0, 37.5]",Q2
36077,2020-05-14,59749,36,0,67,27,2037,0.0,48.714285714285715,0.0,81.53154984064288,"(24.0, 37.5]",Q2
36077,2020-05-15,59749,36,0,67,181,2218,0.0,69.0,0.0,115.48310431973756,"(24.0, 37.5]",Q2
36077,2020-05-16,59749,36,0,67,50,2268,0.0,69.57142857142857,0.0,116.43948613605009,"(24.0, 37.5]",Q2
36077,2020-05-17,59749,36,0,67,79,2347,0.0,75.14285714285714,0.0,125.76420884509723,"(24.0, 37.5]",Q2
36077,2020-05-18,59749,36,0,67,129,2476,0.0,84.71428571428571,0.0,141.78360426833206,"(24.0, 37.5]",Q2
36077,2020-05-19,59749,36,0,67,124,2600,0.0,90.71428571428571,0.0,151.82561333961357,"(24.0, 37.5]",Q2
36077,2020-05-20,59749,36,0,67,65,2665,0.0,93.57142857142857,0.0,156.6075224211762,"(24.0, 37.5]",Q2
36077,2020-05-21,59749,36,0,67,102,2767,0.0,104.28571428571429,0.0,174.53968147703608,"(24.0, 37.5]",Q2
36077,2020-05-22,59749,36,1,68,90,2857,0.14285714285714285,91.28571428571429,0.23909545407813157,152.78199515592613,"(24.0, 37.5]",Q2
36077,2020-05-23,59749,36,1,69,51,2908,0.2857142857142857,91.42857142857143,0.47819090815626314,153.02109061000425,"(24.0, 37.5]",Q2
36077,2020-05-24,59749,36,0,69,38,2946,0.2857142857142857,85.57142857142857,0.47819090815626314,143.21817699280084,"(24.0, 37.5]",Q2
36077,2020-05-25,59749,36,0,69,17,2963,0.2857142857142857,69.57142857142857,0.47819090815626314,116.43948613605009,"(24.0, 37.5]",Q2
36077,2020-05-26,59749,36,0,69,243,3206,0.2857142857142857,86.57142857142857,0.47819090815626314,144.89184517134777,"(24.0, 37.5]",Q2
36077,2020-05-27,59749,36,1,70,191,3397,0.42857142857142855,104.57142857142857,0.7172863622343948,175.01787238519233,"(24.0, 37.5]",Q2
36077,2020-05-28,59749,36,1,71,128,3525,0.5714285714285714,108.28571428571429,0.9563818163125263,181.23435419122376,"(24.0, 37.5]",Q2
36077,2020-05-29,59749,36,0,71,127,3652,0.42857142857142855,113.57142857142857,0.7172863622343948,190.08088599211464,"(24.0, 37.5]",Q2
36077,2020-05-30,59749,36,1,72,184,3836,0.42857142857142855,132.57142857142858,0.7172863622343948,221.88058138450614,"(24.0, 37.5]",Q2
36077,2020-05-31,59749,36,0,72,93,3929,0.42857142857142855,140.42857142857142,0.7172863622343948,235.03083135880337,"(24.0, 37.5]",Q2
36077,2020-06-01,59749,36,1,73,189,4118,0.5714285714285714,165.0,0.9563818163125263,276.15524946024203,"(24.0, 37.5]",Q2
36077,2020-06-02,59749,36,0,73,183,4301,0.5714285714285714,156.42857142857142,0.9563818163125263,261.80952221555407,"(24.0, 37.5]",Q2
36077,2020-06-03,59749,36,0,73,112,4413,0.42857142857142855,145.14285714285714,0.7172863622343948,242.92098134338173,"(24.0, 37.5]",Q2
36077,2020-06-04,59749,36,0,73,132,4545,0.2857142857142857,145.71428571428572,0.47819090815626314,243.87736315969428,"(24.0, 37.5]",Q2
36077,2020-06-05,59749,36,1,74,265,4810,0.42857142857142855,165.42857142857142,0.7172863622343948,276.8725358224764,"(24.0, 37.5]",Q2
36077,2020-06-06,59749,36,0,74,163,4973,0.2857142857142857,162.42857142857142,0.47819090815626314,271.8515312868356,"(24.0, 37.5]",Q2
36077,2020-06-07,59749,36,1,75,144,5117,0.42857142857142855,169.71428571428572,0.7172863622343948,284.04539944482036,"(24.0, 37.5]",Q2
36079,2020-03-02,98892,4,0,0,0,0,0.0,0.0,0.0,0.0,"(3.999, 24.0]",Q1
36079,2020-03-03,98892,4,0,0,0,0,0.0,0.0,0.0,0.0,"(3.999, 24.0]",Q1
36079,2020-03-04,98892,4,0,0,0,0,0.0,0.0,0.0,0.0,"(3.999, 24.0]",Q1
36079,2020-03-05,98892,4,0,0,1,1,0.0,1.0,0.0,1.0112041418921651,"(3.999, 24.0]",Q1
36079,2020-03-06,98892,4,0,0,0,1,0.0,0.0,0.0,0.0,"(3.999, 24.0]",Q1
36079,2020-03-07,98892,4,0,0,1,2,0.0,1.0,0.0,1.0112041418921651,"(3.999, 24.0]",Q1
36079,2020-03-08,98892,4,0,0,0,2,0.0,0.2857142857142857,0.0,0.2889154691120472,"(3.999, 24.0]",Q1
36079,2020-03-09,98892,4,0,0,1,3,0.0,0.42857142857142855,0.0,0.43337320366807075,"(3.999, 24.0]",Q1
36079,2020-03-10,98892,4,0,0,0,3,0.0,0.42857142857142855,0.0,0.43337320366807075,"(3.999, 24.0]",Q1
36079,2020-03-11,98892,4,0,0,7,10,0.0,1.4285714285714286,0.0,1.444577345560236,"(3.999, 24.0]",Q1
36079,2020-03-12,98892,4,0,0,1,11,0.0,1.4285714285714286,0.0,1.444577345560236,"(3.999, 24.0]",Q1
36079,2020-03-13,98892,4,0,0,14,25,0.0,3.4285714285714284,0.0,3.466985629344566,"(3.999, 24.0]",Q1
36079,2020-03-14,98892,4,0,0,3,28,0.0,3.7142857142857144,0.0,3.7559010984566137,"(3.999, 24.0]",Q1
36079,2020-03-15,98892,4,2,2,10,38,0.2857142857142857,5.142857142857143,0.2889154691120472,5.20047844401685,"(3.999, 24.0]",Q1
36079,2020-03-16,98892,4,0,2,5,43,0.2857142857142857,5.714285714285714,0.2889154691120472,5.778309382240944,"(3.999, 24.0]",Q1
36079,2020-03-17,98892,4,0,2,7,50,0.2857142857142857,6.714285714285714,0.2889154691120472,6.789513524133109,"(3.999, 24.0]",Q1
36079,2020-03-18,98892,4,3,5,32,82,0.7142857142857143,10.285714285714286,0.722288672780118,10.4009568880337,"(3.999, 24.0]",Q1
36079,2020-03-19,98892,4,2,7,35,117,1.0,15.142857142857142,1.0112041418921651,15.312519862938501,"(3.999, 24.0]",Q1
36079,2020-03-20,98892,4,15,22,79,196,3.142857142857143,24.428571428571427,3.178070160232519,24.702272609080033,"(3.999, 24.0]",Q1
36079,2020-03-21,98892,4,15,37,75,271,5.285714285714286,34.714285714285715,5.3449361785728735,35.10322949711374,"(3.999, 24.0]",Q1
36079,2020-03-22,98892,4,8,45,47,318,6.142857142857143,40.0,6.211682585909015,40.4481656756866,"(3.999, 24.0]",Q1
36079,2020-03-23,98892,4,22,67,70,388,9.285714285714286,49.285714285714285,9.389752746141536,49.83791842182814,"(3.999, 24.0]",Q1
36079,2020-03-24,98892,4,16,83,51,439,11.571428571428571,55.57142857142857,11.701076499037912,56.19405874229317,"(3.999, 24.0]",Q1
36079,2020-03-25,98892,4,11,94,75,514,12.714285714285714,61.714285714285715,12.856738375486097,62.40574132820219,"(3.999, 24.0]",Q1
36079,2020-03-26,98892,4,17,111,47,561,14.857142857142858,63.42857142857143,15.023604393826455,64.13923414287449,"(3.999, 24.0]",Q1
36079,2020-03-27,98892,4,20,131,84,645,15.571428571428571,64.14285714285714,15.745893066606572,64.8615228156546,"(3.999, 24.0]",Q1
36079,2020-03-28,98892,4,13,144,41,686,15.285714285714286,59.285714285714285,15.456977597494525,59.94995984074979,"(3.999, 24.0]",Q1
36079,2020-03-29,98892,4,23,167,63,749,17.428571428571427,61.57142857142857,17.62384361583488,62.26128359364617,"(3.999, 24.0]",Q1
36079,2020-03-30,98892,4,19,186,71,820,17.0,61.714285714285715,17.190470412166807,62.40574132820219,"(3.999, 24.0]",Q1
36079,2020-03-31,98892,4,21,207,57,877,17.714285714285715,62.57142857142857,17.912759084946927,63.272487735538334,"(3.999, 24.0]",Q1
36079,2020-04-01,98892,4,9,216,46,923,17.428571428571427,58.42857142857143,17.62384361583488,59.08321343341365,"(3.999, 24.0]",Q1
36079,2020-04-02,98892,4,36,252,90,1013,20.142857142857142,64.57142857142857,20.368540572399326,65.29489601932266,"(3.999, 24.0]",Q1
36079,2020-04-03,98892,4,31,283,96,1109,21.714285714285715,66.28571428571429,21.957575652515587,67.02838883399495,"(3.999, 24.0]",Q1
36079,2020-04-04,98892,4,31,314,78,1187,24.285714285714285,71.57142857142857,24.557814874524013,72.37332501256783,"(3.999, 24.0]",Q1
36079,2020-04-05,98892,4,31,345,122,1309,25.428571428571427,80.0,25.713476750972195,80.8963313513732,"(3.999, 24.0]",Q1
36079,2020-04-06,98892,4,21,366,72,1381,25.714285714285715,80.14285714285714,26.00239222008425,81.04078908592923,"(3.999, 24.0]",Q1
36079,2020-04-07,98892,4,37,403,115,1496,28.0,88.42857142857143,28.313715972980624,89.41933769017861,"(3.999, 24.0]",Q1
36079,2020-04-08,98892,4,35,438,158,1654,31.714285714285715,104.42857142857143,32.06961707143724,105.59860396045326,"(3.999, 24.0]",Q1
36079,2020-04-09,98892,4,49,487,169,1823,33.57142857142857,115.71428571428571,33.947567620665545,117.0107649903791,"(3.999, 24.0]",Q1
36079,2020-04-10,98892,4,7,494,18,1841,30.142857142857142,104.57142857142857,30.480581991320975,105.74306169500926,"(3.999, 24.0]",Q1
36079,2020-04-11,98892,4,3,497,12,1853,26.142857142857142,95.14285714285714,26.435765423752315,96.20885121431171,"(3.999, 24.0]",Q1
36079,2020-04-12,98892,4,5,502,8,1861,22.428571428571427,78.85714285714286,22.679864325295704,79.74066947492503,"(3.999, 24.0]",Q1
36079,2020-04-13,98892,4,56,558,217,2078,27.428571428571427,99.57142857142857,27.735885034756528,100.68704098554844,"(3.999, 24.0]",Q1
36079,2020-04-14,98892,4,13,571,43,2121,24.0,89.28571428571429,24.268899405411965,90.28608409751476,"(3.999, 24.0]",Q1
36079,2020-04-15,98892,4,2,573,6,2127,19.285714285714285,67.57142857142857,19.501794165063185,68.32850844499916,"(3.999, 24.0]",Q1
36079,2020-04-16,98892,4,5,578,11,2138,13.0,45.0,13.145653844598147,45.504186385147435,"(3.999, 24.0]",Q1
36079,2020-04-17,98892,4,4,582,13,2151,12.571428571428571,44.285714285714285,12.712280640930077,44.78189771236732,"(3.999, 24.0]",Q1
36079,2020-04-18,98892,4,10,592,37,2188,13.571428571428571,47.857142857142854,13.723484782822242,48.3933410762679,"(3.999, 24.0]",Q1
36079,2020-04-19,98892,4,7,599,21,2209,13.857142857142858,49.714285714285715,14.01240025193429,50.27129162549621,"(3.999, 24.0]",Q1
36079,2020-04-20,98892,4,6,605,30,2239,6.714285714285714,23.0,6.789513524133109,23.2576952635198,"(3.999, 24.0]",Q1
36079,2020-04-21,98892,4,6,611,31,2270,5.714285714285714,21.285714285714285,5.778309382240944,21.524202448847515,"(3.999, 24.0]",Q1
36079,2020-04-22,98892,4,4,615,19,2289,6.0,23.142857142857142,6.067224851352991,23.402152998075824,"(3.999, 24.0]",Q1
36079,2020-04-23,98892,4,4,619,25,2314,5.857142857142857,25.142857142857142,5.922767116796967,25.424561281860154,"(3.999, 24.0]",Q1
36079,2020-04-24,98892,4,266,885,1134,3448,43.285714285714285,185.28571428571428,43.770693570475146,187.3616817191626,"(3.999, 24.0]",Q1
36079,2020-04-25,98892,4,19,904,112,3560,44.57142857142857,196.0,45.07081318147936,198.19601181086435,"(3.999, 24.0]",Q1
36079,2020-04-26,98892,4,21,925,127,3687,46.57142857142857,211.14285714285714,47.09322146526369,213.50853167380288,"(3.999, 24.0]",Q1
36079,2020-04-27,98892,4,7,932,82,3769,46.714285714285715,218.57142857142858,47.237679199819716,221.02033387071612,"(3.999, 24.0]",Q1
36079,2020-04-28,98892,4,14,946,150,3919,47.857142857142854,235.57142857142858,48.3933410762679,238.21080428288295,"(3.999, 24.0]",Q1
36079,2020-04-29,98892,4,24,970,251,4170,50.714285714285715,268.7142857142857,51.28249576738838,271.7249986998804,"(3.999, 24.0]",Q1
36079,2020-04-30,98892,4,20,990,144,4314,53.0,285.7142857142857,53.59381952028475,288.9154691120472,"(3.999, 24.0]",Q1
36079,2020-05-01,98892,4,13,1003,115,4429,16.857142857142858,140.14285714285714,17.046012677610786,141.71303759945914,"(3.999, 24.0]",Q1
36079,2020-05-02,98892,4,10,1013,90,4519,15.571428571428571,137.0,15.745893066606572,138.53496743922662,"(3.999, 24.0]",Q1
36079,2020-05-03,98892,4,13,1026,114,4633,14.428571428571429,135.14285714285714,14.590231190158383,136.65701688999832,"(3.999, 24.0]",Q1
36079,2020-05-04,98892,4,5,1031,87,4720,14.142857142857142,135.85714285714286,14.301315721046336,137.37930556277843,"(3.999, 24.0]",Q1
36079,2020-05-05,98892,4,9,1040,96,4816,13.428571428571429,128.14285714285714,13.579027048266218,129.57858789675316,"(3.999, 24.0]",Q1
36079,2020-05-06,98892,4,26,1066,317,5133,13.714285714285714,137.57142857142858,13.867942517378264,139.11279837745073,"(3.999, 24.0]",Q1
36079,2020-05-07,98892,4,8,1074,121,5254,12.0,134.28571428571428,12.134449702705982,135.79027048266218,"(3.999, 24.0]",Q1
36079,2020-05-08,98892,4,6,1080,161,5415,11.0,140.85714285714286,11.123245560813817,142.43532627223925,"(3.999, 24.0]",Q1
36079,2020-05-09,98892,4,9,1089,155,5570,10.857142857142858,150.14285714285714,10.978787826257793,151.8250790183808,"(3.999, 24.0]",Q1
36079,2020-05-10,98892,4,9,1098,122,5692,10.285714285714286,151.28571428571428,10.4009568880337,152.98074089482898,"(3.999, 24.0]",Q1
36079,2020-05-11,98892,4,0,1098,42,5734,9.571428571428571,144.85714285714286,9.67866821525358,146.48014283980794,"(3.999, 24.0]",Q1
36079,2020-05-12,98892,4,10,1108,138,5872,9.714285714285714,150.85714285714286,9.823125949809604,152.54736769116093,"(3.999, 24.0]",Q1
36079,2020-05-13,98892,4,7,1115,151,6023,7.0,127.14285714285714,7.078428993245156,128.567383754861,"(3.999, 24.0]",Q1
36079,2020-05-14,98892,4,6,1121,149,6172,6.714285714285714,131.14285714285714,6.789513524133109,132.61220032242966,"(3.999, 24.0]",Q1
36079,2020-05-15,98892,4,6,1127,153,6325,6.714285714285714,130.0,6.789513524133109,131.45653844598147,"(3.999, 24.0]",Q1
36079,2020-05-16,98892,4,9,1136,131,6456,6.714285714285714,126.57142857142857,6.789513524133109,127.9895528166369,"(3.999, 24.0]",Q1
36079,2020-05-17,98892,4,5,1141,116,6572,6.142857142857143,125.71428571428571,6.211682585909015,127.12280640930076,"(3.999, 24.0]",Q1
36079,2020-05-18,98892,4,18,1159,125,6697,8.714285714285714,137.57142857142858,8.81192180791744,139.11279837745073,"(3.999, 24.0]",Q1
36079,2020-05-19,98892,4,9,1168,155,6852,8.571428571428571,140.0,8.667464073361415,141.56857986490314,"(3.999, 24.0]",Q1
36079,2020-05-20,98892,4,7,1175,165,7017,8.571428571428571,142.0,8.667464073361415,143.59098814868744,"(3.999, 24.0]",Q1
36079,2020-05-21,98892,4,12,1187,156,7173,9.428571428571429,143.0,9.534210480697558,144.60219229057964,"(3.999, 24.0]",Q1
36079,2020-05-22,98892,4,13,1200,236,7409,10.428571428571429,154.85714285714286,10.545414622589723,156.5921842587296,"(3.999, 24.0]",Q1
36079,2020-05-23,98892,4,8,1208,161,7570,10.285714285714286,159.14285714285714,10.4009568880337,160.9259162954103,"(3.999, 24.0]",Q1
36079,2020-05-24,98892,4,6,1214,185,7755,10.428571428571429,169.0,10.545414622589723,170.89349997977592,"(3.999, 24.0]",Q1
36079,2020-05-25,98892,4,8,1222,184,7939,9.0,177.42857142857142,9.100837277029486,179.4165063185813,"(3.999, 24.0]",Q1
36079,2020-05-26,98892,4,5,1227,125,8064,8.428571428571429,173.14285714285714,8.523006338805393,175.08277428190058,"(3.999, 24.0]",Q1
36079,2020-05-27,98892,4,9,1236,425,8489,8.714285714285714,210.28571428571428,8.81192180791744,212.64178526646674,"(3.999, 24.0]",Q1
36079,2020-05-28,98892,4,5,1241,194,8683,7.714285714285714,215.71428571428572,7.800717666025274,218.13117917959565,"(3.999, 24.0]",Q1
36079,2020-05-29,98892,4,7,1248,312,8995,6.857142857142857,226.57142857142858,6.933971258689132,229.10996700585343,"(3.999, 24.0]",Q1
36079,2020-05-30,98892,4,4,1252,264,9259,6.285714285714286,241.28571428571428,6.356140320465038,243.98911366512385,"(3.999, 24.0]",Q1
36079,2020-05-31,98892,4,5,1257,247,9506,6.142857142857143,250.14285714285714,6.211682585909015,252.94549320759734,"(3.999, 24.0]",Q1
36079,2020-06-01,98892,4,5,1262,248,9754,5.714285714285714,259.2857142857143,5.778309382240944,262.1907882191828,"(3.999, 24.0]",Q1
36079,2020-06-02,98892,4,2,1264,286,10040,5.285714285714286,282.2857142857143,5.3449361785728735,285.4484834827026,"(3.999, 24.0]",Q1
36079,2020-06-03,98892,4,4,1268,311,10351,4.571428571428571,266.0,4.622647505792755,268.9803017433159,"(3.999, 24.0]",Q1
36079,2020-06-04,98892,4,2,1270,313,10664,4.142857142857143,283.0,4.1892743021246845,286.1707721554827,"(3.999, 24.0]",Q1
36079,2020-06-05,98892,4,4,1274,306,10970,3.7142857142857144,282.14285714285717,3.7559010984566137,285.30402574814667,"(3.999, 24.0]",Q1
36079,2020-06-06,98892,4,3,1277,203,11173,3.5714285714285716,273.42857142857144,3.61144336390059,276.4921039402292,"(3.999, 24.0]",Q1
36079,2020-06-07,98892,4,2,1279,252,11425,3.142857142857143,274.14285714285717,3.178070160232519,277.2143926130093,"(3.999, 24.0]",Q1
36081,2020-03-02,2278906,83,0,0,0,0,0.0,0.0,0.0,0.0,"(52.0, 100.0]",Q4
36081,2020-03-03,2278906,83,0,0,2,2,0.0,2.0,0.0,0.08776140832487167,"(52.0, 100.0]",Q4
36081,2020-03-04,2278906,83,0,0,0,2,0.0,0.0,0.0,0.0,"(52.0, 100.0]",Q4
36081,2020-03-05,2278906,83,1,1,6,8,1.0,6.0,0.043880704162435835,0.263284224974615,"(52.0, 100.0]",Q4
36081,2020-03-06,2278906,83,1,2,10,18,1.0,10.0,0.043880704162435835,0.43880704162435835,"(52.0, 100.0]",Q4
36081,2020-03-07,2278906,83,0,2,14,32,0.0,14.0,0.0,0.6143298582741017,"(52.0, 100.0]",Q4
36081,2020-03-08,2278906,83,1,3,13,45,0.42857142857142855,6.428571428571429,0.018806016069615357,0.28209024104423036,"(52.0, 100.0]",Q4
36081,2020-03-09,2278906,83,0,3,15,60,0.42857142857142855,8.571428571428571,0.018806016069615357,0.3761203213923071,"(52.0, 100.0]",Q4
36081,2020-03-10,2278906,83,4,7,18,78,1.0,10.857142857142858,0.043880704162435835,0.4764190737635891,"(52.0, 100.0]",Q4
36081,2020-03-11,2278906,83,5,12,44,122,1.7142857142857142,17.142857142857142,0.07522406427846143,0.7522406427846142,"(52.0, 100.0]",Q4
36081,2020-03-12,2278906,83,15,27,74,196,3.7142857142857144,26.857142857142858,0.1629854726033331,1.1785103403625625,"(52.0, 100.0]",Q4
36081,2020-03-13,2278906,83,30,57,154,350,7.857142857142857,47.42857142857143,0.34477696127628155,2.0811991117041,"(52.0, 100.0]",Q4
36081,2020-03-14,2278906,83,18,75,110,460,10.428571428571429,61.142857142857146,0.45761305769397376,2.682991625931791,"(52.0, 100.0]",Q4
36081,2020-03-15,2278906,83,49,124,198,658,17.285714285714285,87.57142857142857,0.7585093148078194,3.8426959502247375,"(52.0, 100.0]",Q4
36081,2020-03-16,2278906,83,38,162,136,794,22.714285714285715,104.85714285714286,0.996718851689614,4.601205265032558,"(52.0, 100.0]",Q4
36081,2020-03-17,2278906,83,123,285,371,1165,39.714285714285715,155.28571428571428,1.7426908224510231,6.814046489223965,"(52.0, 100.0]",Q4
36081,2020-03-18,2278906,83,336,621,768,1933,87.0,258.7142857142857,3.8176212621319174,11.352565034024472,"(52.0, 100.0]",Q4
36081,2020-03-19,2278906,83,519,1140,1179,3112,159.0,416.57142857142856,6.977031961827297,18.279447619666126,"(52.0, 100.0]",Q4
36081,2020-03-20,2278906,83,491,1631,1218,4330,224.85714285714286,568.5714285714286,9.866889764524858,24.949314652356374,"(52.0, 100.0]",Q4
36081,2020-03-21,2278906,83,843,2474,1927,6257,342.7142857142857,828.1428571428571,15.038544183669083,36.33949171852007,"(52.0, 100.0]",Q4
36081,2020-03-22,2278906,83,1152,3626,2048,8305,500.2857142857143,1092.4285714285713,21.952889425264328,47.936534961449546,"(52.0, 100.0]",Q4
36081,2020-03-23,2278906,83,839,4465,1518,9823,614.7142857142857,1289.857142857143,26.974095715851625,56.59983969751902,"(52.0, 100.0]",Q4
36081,2020-03-24,2278906,83,1010,5475,1736,11559,741.4285714285714,1484.857142857143,32.53440780043457,65.15657700919401,"(52.0, 100.0]",Q4
36081,2020-03-25,2278906,83,1238,6713,2110,13669,870.2857142857143,1676.5714285714287,38.18874996536559,73.56913486433528,"(52.0, 100.0]",Q4
36081,2020-03-26,2278906,83,1324,8037,2115,15784,985.2857142857143,1810.2857142857142,43.23503094404571,79.43661187805527,"(52.0, 100.0]",Q4
36081,2020-03-27,2278906,83,1238,9275,2055,17839,1092.0,1929.857142857143,47.917728945379935,84.68349036147795,"(52.0, 100.0]",Q4
36081,2020-03-28,2278906,83,1136,10411,1845,19684,1133.857142857143,1918.142857142857,49.75444984817903,84.16945925557513,"(52.0, 100.0]",Q4
36081,2020-03-29,2278906,83,1258,11669,1915,21599,1149.0,1899.142857142857,50.418929082638776,83.33572587648887,"(52.0, 100.0]",Q4
36081,2020-03-30,2278906,83,2022,13691,3325,24924,1318.0,2157.285714285714,57.834768086090435,94.6632162224205,"(52.0, 100.0]",Q4
36081,2020-03-31,2278906,83,1211,14902,1871,26795,1346.7142857142858,2176.5714285714284,59.09477116275466,95.50948694555319,"(52.0, 100.0]",Q4
36081,2020-04-01,2278906,83,1366,16268,2157,28952,1365.0,2183.285714285714,59.89716118172491,95.80411453064384,"(52.0, 100.0]",Q4
36081,2020-04-02,2278906,83,1899,18167,3048,32000,1447.142857142857,2316.5714285714284,63.50164759506786,101.6527855282942,"(52.0, 100.0]",Q4
36081,2020-04-03,2278906,83,1947,20114,3407,35407,1548.4285714285713,2509.714285714286,67.94613605952028,110.12803010366754,"(52.0, 100.0]",Q4
36081,2020-04-04,2278906,83,1322,21436,2255,37662,1575.0,2568.285714285714,69.11210905583644,112.69818563318164,"(52.0, 100.0]",Q4
36081,2020-04-05,2278906,83,1697,23133,2730,40392,1637.7142857142858,2684.714285714286,71.8640560740235,117.80715333209382,"(52.0, 100.0]",Q4
36081,2020-04-06,2278906,83,1707,24840,2864,43256,1592.7142857142858,2618.8571428571427,69.88942438671387,114.91729552939624,"(52.0, 100.0]",Q4
36081,2020-04-07,2278906,83,1408,26248,2884,46140,1620.857142857143,2763.5714285714284,71.12435277528529,121.26746028890304,"(52.0, 100.0]",Q4
36081,2020-04-08,2278906,83,1504,27752,2831,48971,1640.5714285714287,2859.8571428571427,71.9894295144876,125.49254523254328,"(52.0, 100.0]",Q4
36081,2020-04-09,2278906,83,1551,29303,2941,51912,1590.857142857143,2844.5714285714284,69.8079316504122,124.82179732606032,"(52.0, 100.0]",Q4
36081,2020-04-10,2278906,83,1988,31291,3803,55715,1596.7142857142858,2901.1428571428573,70.06494720336363,127.30419144724956,"(52.0, 100.0]",Q4
36081,2020-04-11,2278906,83,1544,32835,3219,58934,1628.4285714285713,3038.8571428571427,71.45659239251515,133.3471912776193,"(52.0, 100.0]",Q4
36081,2020-04-12,2278906,83,1150,33985,2481,61415,1550.2857142857142,3003.285714285714,68.02762879582195,131.78629194384123,"(52.0, 100.0]",Q4
36081,2020-04-13,2278906,83,1068,35053,2430,63845,1459.0,2941.285714285714,64.02194737299389,129.0656882857702,"(52.0, 100.0]",Q4
36081,2020-04-14,2278906,83,1712,36765,3674,67519,1502.4285714285713,3054.1428571428573,65.92762366804824,134.01793918410223,"(52.0, 100.0]",Q4
36081,2020-04-15,2278906,83,1153,37918,3144,70663,1452.2857142857142,3098.8571428571427,63.72731978790324,135.98003352736544,"(52.0, 100.0]",Q4
36081,2020-04-16,2278906,83,1173,39091,3056,73719,1398.2857142857142,3115.285714285714,61.35776176313171,136.70093081003404,"(52.0, 100.0]",Q4
36081,2020-04-17,2278906,83,1125,40216,3347,77066,1275.0,3050.1428571428573,55.9478978071057,133.8424163674525,"(52.0, 100.0]",Q4
36081,2020-04-18,2278906,83,1021,41237,3338,80404,1200.2857142857142,3067.1428571428573,52.669382338969406,134.58838833821392,"(52.0, 100.0]",Q4
36081,2020-04-19,2278906,83,786,42023,2428,82832,1148.2857142857142,3059.5714285714284,50.38758572252274,134.25614872098404,"(52.0, 100.0]",Q4
36081,2020-04-20,2278906,83,799,42822,2498,85330,1109.857142857143,3069.285714285714,48.701312948280574,134.68241841856198,"(52.0, 100.0]",Q4
36081,2020-04-21,2278906,83,891,43713,3058,88388,992.5714285714286,2981.285714285714,43.55473321722917,130.82091645226762,"(52.0, 100.0]",Q4
36081,2020-04-22,2278906,83,1191,44904,4142,92530,998.0,3123.8571428571427,43.79294275411097,137.07705113142634,"(52.0, 100.0]",Q4
36081,2020-04-23,2278906,83,1483,46387,5468,97998,1042.2857142857142,3468.4285714285716,45.73623108130455,152.19708805139712,"(52.0, 100.0]",Q4
36081,2020-04-24,2278906,83,1474,47861,5296,103294,1092.142857142857,3746.8571428571427,47.92399761740314,164.41472982462386,"(52.0, 100.0]",Q4
36081,2020-04-25,2278906,83,884,48745,3676,106970,1072.5714285714287,3795.1428571428573,47.06518955022404,166.5335409684672,"(52.0, 100.0]",Q4
36081,2020-04-26,2278906,83,654,49399,2829,109799,1053.7142857142858,3852.4285714285716,46.23772484316096,169.04727844977245,"(52.0, 100.0]",Q4
36081,2020-04-27,2278906,83,530,49929,2628,112427,1015.2857142857143,3871.0,44.551452068918785,169.86220581278914,"(52.0, 100.0]",Q4
36081,2020-04-28,2278906,83,812,50741,4061,116488,1004.0,4014.285714285714,44.05622697908558,176.14968385206384,"(52.0, 100.0]",Q4
36081,2020-04-29,2278906,83,890,51631,4201,120689,961.0,4022.714285714286,42.169356700100835,176.51953550143296,"(52.0, 100.0]",Q4
36081,2020-04-30,2278906,83,643,52274,3689,124378,841.0,3768.5714285714284,36.90367220060854,165.36756797215105,"(52.0, 100.0]",Q4
36081,2020-05-01,2278906,83,765,53039,4517,128895,739.7142857142857,3657.285714285714,32.459183736156106,160.48427246607426,"(52.0, 100.0]",Q4
36081,2020-05-02,2278906,83,601,53640,3755,132650,699.2857142857143,3668.5714285714284,30.68514955358906,160.97949755590747,"(52.0, 100.0]",Q4
36081,2020-05-03,2278906,83,450,54090,2696,135346,670.1428571428571,3649.5714285714284,29.406340460855212,160.1457641768212,"(52.0, 100.0]",Q4
36081,2020-05-04,2278906,83,358,54448,2633,137979,645.5714285714286,3650.285714285714,28.32812887286393,160.1771075369372,"(52.0, 100.0]",Q4
36081,2020-05-05,2278906,83,432,54880,3591,141570,591.2857142857143,3583.1428571428573,25.946033504045992,157.2308316860308,"(52.0, 100.0]",Q4
36081,2020-05-06,2278906,83,570,55450,4505,146075,545.5714285714286,3626.5714285714284,23.940058456620353,159.13650798108515,"(52.0, 100.0]",Q4
36081,2020-05-07,2278906,83,494,55944,3992,150067,524.2857142857143,3669.8571428571427,23.00602632516279,161.0359156041163,"(52.0, 100.0]",Q4
36081,2020-05-08,2278906,83,549,56493,4596,154663,493.42857142857144,3681.1428571428573,21.651993168150483,161.53114069394954,"(52.0, 100.0]",Q4
36081,2020-05-09,2278906,83,369,56862,3416,158079,460.2857142857143,3632.714285714286,20.197661258766892,159.40606087808297,"(52.0, 100.0]",Q4
36081,2020-05-10,2278906,83,318,57180,2937,161016,441.42857142857144,3667.1428571428573,19.370196551703817,160.91681083567542,"(52.0, 100.0]",Q4
36081,2020-05-11,2278906,83,211,57391,2552,163568,420.42857142857144,3655.5714285714284,18.448701764292668,160.4090484017958,"(52.0, 100.0]",Q4
36081,2020-05-12,2278906,83,357,57748,3829,167397,409.7142857142857,3689.5714285714284,17.97855136255228,161.90099234331862,"(52.0, 100.0]",Q4
36081,2020-05-13,2278906,83,336,58084,4439,171836,376.2857142857143,3680.1428571428573,16.511682109122283,161.48725998978708,"(52.0, 100.0]",Q4
36081,2020-05-14,2278906,83,432,58516,4879,176715,367.42857142857144,3806.8571428571427,16.12302444368357,167.04757207437,"(52.0, 100.0]",Q4
36081,2020-05-15,2278906,83,325,58841,4644,181359,335.42857142857144,3813.714285714286,14.71884191048562,167.34846833148387,"(52.0, 100.0]",Q4
36081,2020-05-16,2278906,83,291,59132,4209,185568,324.2857142857143,3927.0,14.229885492675622,172.31952524588553,"(52.0, 100.0]",Q4
36081,2020-05-17,2278906,83,192,59324,3226,188794,306.2857142857143,3968.285714285714,13.440032817751776,174.1311714605918,"(52.0, 100.0]",Q4
36081,2020-05-18,2278906,83,184,59508,3363,192157,302.42857142857144,4084.1428571428573,13.270778673125239,179.21506447141118,"(52.0, 100.0]",Q4
36081,2020-05-19,2278906,83,244,59752,4581,196738,286.2857142857143,4191.571428571428,12.562418734503058,183.92910583286138,"(52.0, 100.0]",Q4
36081,2020-05-20,2278906,83,273,60025,5151,201889,277.2857142857143,4293.285714285715,12.167492397041135,188.39240031338346,"(52.0, 100.0]",Q4
36081,2020-05-21,2278906,83,211,60236,5181,207070,245.71428571428572,4336.428571428572,10.782115879912807,190.28553926439142,"(52.0, 100.0]",Q4
36081,2020-05-22,2278906,83,186,60422,5388,212458,225.85714285714286,4442.714285714285,9.910770468687295,194.949431249656,"(52.0, 100.0]",Q4
36081,2020-05-23,2278906,83,214,60636,5270,217728,214.85714285714286,4594.285714285715,9.4280827229005,201.60049226627666,"(52.0, 100.0]",Q4
36081,2020-05-24,2278906,83,192,60828,4448,222176,214.85714285714286,4768.857142857143,9.4280827229005,209.2608094786333,"(52.0, 100.0]",Q4
36081,2020-05-25,2278906,83,132,60960,3789,225965,207.42857142857142,4829.714285714285,9.102111777693834,211.93126376051865,"(52.0, 100.0]",Q4
36081,2020-05-26,2278906,83,165,61125,4201,230166,196.14285714285714,4775.428571428572,8.606886687860628,209.54916839170073,"(52.0, 100.0]",Q4
36081,2020-05-27,2278906,83,275,61400,9126,239292,196.42857142857142,5343.285714285715,8.61942403190704,234.46713968394113,"(52.0, 100.0]",Q4
36081,2020-05-28,2278906,83,244,61644,8480,247772,201.14285714285714,5814.571428571428,8.826290208672807,255.14748868849478,"(52.0, 100.0]",Q4
36081,2020-05-29,2278906,83,183,61827,7088,254860,200.71428571428572,6057.428571428572,8.807484192603193,265.80423112794347,"(52.0, 100.0]",Q4
36081,2020-05-30,2278906,83,148,61975,6226,261086,191.28571428571428,6194.0,8.393751839071655,271.7970815821276,"(52.0, 100.0]",Q4
36081,2020-05-31,2278906,83,119,62094,5906,266992,180.85714285714286,6402.285714285715,7.9361387813776805,280.93680539196066,"(52.0, 100.0]",Q4
36081,2020-06-01,2278906,83,199,62293,7231,274223,190.42857142857142,6894.0,8.356139806932424,302.51357449583264,"(52.0, 100.0]",Q4
36081,2020-06-02,2278906,83,132,62425,6319,280542,185.71428571428572,7196.571428571428,8.149273630166656,315.7906218409811,"(52.0, 100.0]",Q4
36081,2020-06-03,2278906,83,117,62542,6451,286993,163.14285714285714,6814.428571428572,7.158823450500246,299.0219241789074,"(52.0, 100.0]",Q4
36081,2020-06-04,2278906,83,150,62692,6695,293688,149.71428571428572,6559.428571428572,6.569568280318966,287.8323446174863,"(52.0, 100.0]",Q4
36081,2020-06-05,2278906,83,158,62850,7672,301360,146.14285714285714,6642.857142857143,6.412851479738837,291.49324907903804,"(52.0, 100.0]",Q4
36081,2020-06-06,2278906,83,113,62963,6497,307857,141.14285714285714,6681.571428571428,6.193447958926658,293.1920591973266,"(52.0, 100.0]",Q4
36081,2020-06-07,2278906,83,134,63097,6514,314371,143.28571428571428,6768.428571428572,6.287478039274734,297.0034117874353,"(52.0, 100.0]",Q4
36083,2020-03-02,159442,37,0,0,0,0,0.0,0.0,0.0,0.0,"(24.0, 37.5]",Q2
36083,2020-03-03,159442,37,0,0,0,0,0.0,0.0,0.0,0.0,"(24.0, 37.5]",Q2
36083,2020-03-04,159442,37,0,0,2,2,0.0,2.0,0.0,1.254374631527452,"(24.0, 37.5]",Q2
36083,2020-03-05,159442,37,0,0,0,2,0.0,0.0,0.0,0.0,"(24.0, 37.5]",Q2
36083,2020-03-06,159442,37,0,0,0,2,0.0,0.0,0.0,0.0,"(24.0, 37.5]",Q2
36083,2020-03-07,159442,37,0,0,2,4,0.0,2.0,0.0,1.254374631527452,"(24.0, 37.5]",Q2
36083,2020-03-08,159442,37,0,0,0,4,0.0,0.5714285714285714,0.0,0.35839275186498626,"(24.0, 37.5]",Q2
36083,2020-03-09,159442,37,0,0,1,5,0.0,0.7142857142857143,0.0,0.4479909398312329,"(24.0, 37.5]",Q2
36083,2020-03-10,159442,37,0,0,1,6,0.0,0.8571428571428571,0.0,0.5375891277974794,"(24.0, 37.5]",Q2
36083,2020-03-11,159442,37,0,0,1,7,0.0,0.7142857142857143,0.0,0.4479909398312329,"(24.0, 37.5]",Q2
36083,2020-03-12,159442,37,0,0,2,9,0.0,1.0,0.0,0.627187315763726,"(24.0, 37.5]",Q2
36083,2020-03-13,159442,37,0,0,11,20,0.0,2.5714285714285716,0.0,1.6127673833924385,"(24.0, 37.5]",Q2
36083,2020-03-14,159442,37,0,0,40,60,0.0,8.0,0.0,5.017498526109808,"(24.0, 37.5]",Q2
36083,2020-03-15,159442,37,0,0,50,110,0.0,15.142857142857142,0.0,9.497407924422136,"(24.0, 37.5]",Q2
36083,2020-03-16,159442,37,1,1,39,149,0.14285714285714285,20.571428571428573,0.08959818796624656,12.902139067139508,"(24.0, 37.5]",Q2
36083,2020-03-17,159442,37,3,4,70,219,0.5714285714285714,30.428571428571427,0.35839275186498626,19.084414036810518,"(24.0, 37.5]",Q2
36083,2020-03-18,159442,37,2,6,136,355,0.8571428571428571,49.714285714285715,0.5375891277974794,31.18016941225381,"(24.0, 37.5]",Q2
36083,2020-03-19,159442,37,2,8,156,511,1.1428571428571428,71.71428571428571,0.7167855037299725,44.97829035905578,"(24.0, 37.5]",Q2
36083,2020-03-20,159442,37,12,20,166,677,2.857142857142857,93.85714285714286,1.7919637593249316,58.866009493823995,"(24.0, 37.5]",Q2
36083,2020-03-21,159442,37,6,26,173,850,3.7142857142857144,112.85714285714286,2.329552887122411,70.7825684933348,"(24.0, 37.5]",Q2
36083,2020-03-22,159442,37,3,29,78,928,4.142857142857143,116.85714285714286,2.5983474510211506,73.29131775638969,"(24.0, 37.5]",Q2
36083,2020-03-23,159442,37,1,30,47,975,4.142857142857143,118.0,2.5983474510211506,74.00810326011967,"(24.0, 37.5]",Q2
36083,2020-03-24,159442,37,1,31,26,1001,3.857142857142857,111.71428571428571,2.4191510750886573,70.06578298960481,"(24.0, 37.5]",Q2
36083,2020-03-25,159442,37,1,32,22,1023,3.7142857142857144,95.42857142857143,2.329552887122411,59.851589561452705,"(24.0, 37.5]",Q2
36083,2020-03-26,159442,37,3,35,26,1049,3.857142857142857,76.85714285714286,2.4191510750886573,48.20382512584066,"(24.0, 37.5]",Q2
36083,2020-03-27,159442,37,3,38,37,1086,2.5714285714285716,58.42857142857143,1.6127673833924385,36.645658878194844,"(24.0, 37.5]",Q2
36083,2020-03-28,159442,37,1,39,12,1098,1.8571428571428572,35.42857142857143,1.1647764435612056,22.22035061562915,"(24.0, 37.5]",Q2
36083,2020-03-29,159442,37,1,40,25,1123,1.5714285714285714,27.857142857142858,0.9855800676287122,17.47164665341808,"(24.0, 37.5]",Q2
36083,2020-03-30,159442,37,1,41,20,1143,1.5714285714285714,24.0,0.9855800676287122,15.052495578329426,"(24.0, 37.5]",Q2
36083,2020-03-31,159442,37,2,43,19,1162,1.7142857142857142,23.0,1.0751782555949587,14.425308262565697,"(24.0, 37.5]",Q2
36083,2020-04-01,159442,37,10,53,42,1204,3.0,25.857142857142858,1.8815619472911782,16.21727202189063,"(24.0, 37.5]",Q2
36083,2020-04-02,159442,37,3,56,31,1235,3.0,26.571428571428573,1.8815619472911782,16.66526296172186,"(24.0, 37.5]",Q2
36083,2020-04-03,159442,37,2,58,18,1253,2.857142857142857,23.857142857142858,1.7919637593249316,14.962897390363176,"(24.0, 37.5]",Q2
36083,2020-04-04,159442,37,2,60,48,1301,3.0,29.0,1.8815619472911782,18.188432157148053,"(24.0, 37.5]",Q2
36083,2020-04-05,159442,37,2,62,29,1330,3.142857142857143,29.571428571428573,1.9711601352574244,18.54682490901304,"(24.0, 37.5]",Q2
36083,2020-04-06,159442,37,5,67,30,1360,3.7142857142857144,31.0,2.329552887122411,19.442806788675508,"(24.0, 37.5]",Q2
36083,2020-04-07,159442,37,8,75,53,1413,4.571428571428571,35.857142857142854,2.86714201491989,22.48914517952789,"(24.0, 37.5]",Q2
36083,2020-04-08,159442,37,4,79,52,1465,3.7142857142857144,37.285714285714285,2.329552887122411,23.385127059190356,"(24.0, 37.5]",Q2
36083,2020-04-09,159442,37,12,91,101,1566,5.0,47.285714285714285,3.1359365788186295,29.657000216827615,"(24.0, 37.5]",Q2
36083,2020-04-10,159442,37,5,96,40,1606,5.428571428571429,50.42857142857143,3.4047311427173694,31.62816035208504,"(24.0, 37.5]",Q2
36083,2020-04-11,159442,37,9,105,65,1671,6.428571428571429,52.857142857142854,4.031918458481096,33.15132954751123,"(24.0, 37.5]",Q2
36083,2020-04-12,159442,37,8,113,61,1732,7.285714285714286,57.42857142857143,4.569507586278575,36.018471562431124,"(24.0, 37.5]",Q2
36083,2020-04-13,159442,37,7,120,79,1811,7.571428571428571,64.42857142857143,4.748703962211068,40.4087827727772,"(24.0, 37.5]",Q2
36083,2020-04-14,159442,37,4,124,42,1853,7.0,62.857142857142854,4.390311210346082,39.42320270514849,"(24.0, 37.5]",Q2
36083,2020-04-15,159442,37,13,137,106,1959,8.285714285714286,70.57142857142857,5.196694902042301,44.2615048553258,"(24.0, 37.5]",Q2
36083,2020-04-16,159442,37,13,150,100,2059,8.428571428571429,70.42857142857143,5.286293090008548,44.17190666735956,"(24.0, 37.5]",Q2
36083,2020-04-17,159442,37,14,164,135,2194,9.714285714285714,84.0,6.092676781704767,52.68373452415299,"(24.0, 37.5]",Q2
36083,2020-04-18,159442,37,9,173,117,2311,9.714285714285714,91.42857142857143,6.092676781704767,57.34284029839781,"(24.0, 37.5]",Q2
36083,2020-04-19,159442,37,4,177,51,2362,9.142857142857142,90.0,5.73428402983978,56.44685841873534,"(24.0, 37.5]",Q2
36083,2020-04-20,159442,37,6,183,50,2412,9.0,85.85714285714286,5.644685841873534,53.84851096771419,"(24.0, 37.5]",Q2
36083,2020-04-21,159442,37,3,186,49,2461,8.857142857142858,86.85714285714286,5.555087653907288,54.47569828347791,"(24.0, 37.5]",Q2
36083,2020-04-22,159442,37,5,191,52,2513,7.714285714285714,79.14285714285714,4.838302150177315,49.6373961333006,"(24.0, 37.5]",Q2
36083,2020-04-23,159442,37,7,198,80,2593,6.857142857142857,76.28571428571429,4.300713022379835,47.845432373975676,"(24.0, 37.5]",Q2
36083,2020-04-24,159442,37,23,221,209,2802,8.142857142857142,86.85714285714286,5.107096714076054,54.47569828347791,"(24.0, 37.5]",Q2
36083,2020-04-25,159442,37,21,242,151,2953,9.857142857142858,91.71428571428571,6.182274969671014,57.522036674330295,"(24.0, 37.5]",Q2
36083,2020-04-26,159442,37,4,246,83,3036,9.857142857142858,96.28571428571429,6.182274969671014,60.389178689250194,"(24.0, 37.5]",Q2
36083,2020-04-27,159442,37,4,250,39,3075,9.571428571428571,94.71428571428571,6.00307859373852,59.40359862162148,"(24.0, 37.5]",Q2
36083,2020-04-28,159442,37,12,262,91,3166,10.857142857142858,100.71428571428571,6.809462285434739,63.166722516203826,"(24.0, 37.5]",Q2
36083,2020-04-29,159442,37,25,287,142,3308,13.714285714285714,113.57142857142857,8.60142604475967,71.23055943316602,"(24.0, 37.5]",Q2
36083,2020-04-30,159442,37,11,298,101,3409,14.285714285714286,116.57142857142857,8.959818796624658,73.1121213804572,"(24.0, 37.5]",Q2
36083,2020-05-01,159442,37,13,311,112,3521,12.857142857142858,102.71428571428571,8.063836916962192,64.42109714773127,"(24.0, 37.5]",Q2
36083,2020-05-02,159442,37,11,322,170,3691,11.428571428571429,105.42857142857143,7.167855037299726,66.12346271908997,"(24.0, 37.5]",Q2
36083,2020-05-03,159442,37,15,337,148,3839,13.0,114.71428571428571,8.153435104928437,71.94734493689599,"(24.0, 37.5]",Q2
36083,2020-05-04,159442,37,2,339,71,3910,12.714285714285714,119.28571428571429,7.974238728995944,74.8144869518159,"(24.0, 37.5]",Q2
36083,2020-05-05,159442,37,8,347,126,4036,12.142857142857142,124.28571428571429,7.615845977130958,77.95042353063452,"(24.0, 37.5]",Q2
36083,2020-05-06,159442,37,20,367,159,4195,11.428571428571429,126.71428571428571,7.167855037299726,79.4735927260607,"(24.0, 37.5]",Q2
36083,2020-05-07,159442,37,13,380,194,4389,11.714285714285714,140.0,7.347051413232218,87.80622420692164,"(24.0, 37.5]",Q2
36083,2020-05-08,159442,37,27,407,187,4576,13.714285714285714,150.71428571428572,8.60142604475967,94.52608830439014,"(24.0, 37.5]",Q2
36083,2020-05-09,159442,37,2,409,248,4824,12.428571428571429,161.85714285714286,7.795042353063453,101.51474696575735,"(24.0, 37.5]",Q2
36083,2020-05-10,159442,37,2,411,62,4886,10.571428571428571,149.57142857142858,6.630265909502246,93.80930280066016,"(24.0, 37.5]",Q2
36083,2020-05-11,159442,37,5,416,91,4977,11.0,152.42857142857142,6.8990604734009855,95.60126655998509,"(24.0, 37.5]",Q2
36083,2020-05-12,159442,37,4,420,429,5406,10.428571428571429,195.71428571428572,6.540667721535999,122.74951751375781,"(24.0, 37.5]",Q2
36083,2020-05-13,159442,37,3,423,278,5684,8.0,212.71428571428572,5.017498526109808,133.41170188174115,"(24.0, 37.5]",Q2
36083,2020-05-14,159442,37,5,428,204,5888,6.857142857142857,214.14285714285714,4.300713022379835,134.3076837614036,"(24.0, 37.5]",Q2
36083,2020-05-15,159442,37,10,438,225,6113,4.428571428571429,219.57142857142858,2.777543826953644,137.71241490412098,"(24.0, 37.5]",Q2
36083,2020-05-16,159442,37,1,439,113,6226,4.285714285714286,200.28571428571428,2.6879456389873972,125.61665952867769,"(24.0, 37.5]",Q2
36083,2020-05-17,159442,37,5,444,198,6424,4.714285714285714,219.71428571428572,2.956740202886137,137.8020130920872,"(24.0, 37.5]",Q2
36083,2020-05-18,159442,37,0,444,76,6500,4.0,217.57142857142858,2.508749263054904,136.45804027259354,"(24.0, 37.5]",Q2
36083,2020-05-19,159442,37,9,453,292,6792,4.714285714285714,198.0,2.956740202886137,124.18308852121774,"(24.0, 37.5]",Q2
36083,2020-05-20,159442,37,3,456,403,7195,4.714285714285714,215.85714285714286,2.956740202886137,135.3828620169986,"(24.0, 37.5]",Q2
36083,2020-05-21,159442,37,4,460,379,7574,4.571428571428571,240.85714285714286,2.86714201491989,151.06254491109172,"(24.0, 37.5]",Q2
36083,2020-05-22,159442,37,3,463,386,7960,3.5714285714285716,263.85714285714283,2.2399546991561645,165.4878531736574,"(24.0, 37.5]",Q2
36083,2020-05-23,159442,37,0,463,363,8323,3.4285714285714284,299.57142857142856,2.1503565111899174,187.88740016521905,"(24.0, 37.5]",Q2
36083,2020-05-24,159442,37,2,465,123,8446,3.0,288.85714285714283,1.8815619472911782,181.16753606775055,"(24.0, 37.5]",Q2
36083,2020-05-25,159442,37,1,466,158,8604,3.142857142857143,300.57142857142856,1.9711601352574244,188.51458748098278,"(24.0, 37.5]",Q2
36083,2020-05-26,159442,37,0,466,150,8754,1.8571428571428572,280.2857142857143,1.1647764435612056,175.79164478977577,"(24.0, 37.5]",Q2
36083,2020-05-27,159442,37,3,469,405,9159,1.8571428571428572,280.57142857142856,1.1647764435612056,175.97084116570826,"(24.0, 37.5]",Q2
36083,2020-05-28,159442,37,9,478,319,9478,2.5714285714285716,272.0,1.6127673833924385,170.59494988773346,"(24.0, 37.5]",Q2
36083,2020-05-29,159442,37,8,486,337,9815,3.2857142857142856,265.0,2.0607583232236713,166.20463867738738,"(24.0, 37.5]",Q2
36083,2020-05-30,159442,37,5,491,313,10128,4.0,257.85714285714283,2.508749263054904,161.72472927907504,"(24.0, 37.5]",Q2
36083,2020-05-31,159442,37,1,492,274,10402,3.857142857142857,279.42857142857144,2.4191510750886573,175.2540556619783,"(24.0, 37.5]",Q2
36083,2020-06-01,159442,37,1,493,168,10570,3.857142857142857,280.85714285714283,2.4191510750886573,176.15003754164076,"(24.0, 37.5]",Q2
36083,2020-06-02,159442,37,2,495,426,10996,4.142857142857143,320.2857142857143,2.5983474510211506,200.8791374203248,"(24.0, 37.5]",Q2
36083,2020-06-03,159442,37,0,495,312,11308,3.7142857142857144,307.0,2.329552887122411,192.54650593946388,"(24.0, 37.5]",Q2
36083,2020-06-04,159442,37,2,497,592,11900,2.7142857142857144,346.0,1.7023655713586847,217.00681125424921,"(24.0, 37.5]",Q2
36083,2020-06-05,159442,37,2,499,332,12232,1.8571428571428572,345.2857142857143,1.1647764435612056,216.55882031441794,"(24.0, 37.5]",Q2
36083,2020-06-06,159442,37,3,502,421,12653,1.5714285714285714,360.7142857142857,0.9855800676287122,226.23542461477263,"(24.0, 37.5]",Q2
36083,2020-06-07,159442,37,1,503,517,13170,1.5714285714285714,395.42857142857144,0.9855800676287122,248.0077842905705,"(24.0, 37.5]",Q2
36085,2020-03-02,476179,40,0,0,0,0,0.0,0.0,0.0,0.0,"(37.5, 52.0]",Q3
36085,2020-03-03,476179,40,0,0,0,0,0.0,0.0,0.0,0.0,"(37.5, 52.0]",Q3
36085,2020-03-04,476179,40,0,0,0,0,0.0,0.0,0.0,0.0,"(37.5, 52.0]",Q3
36085,2020-03-05,476179,40,0,0,0,0,0.0,0.0,0.0,0.0,"(37.5, 52.0]",Q3
36085,2020-03-06,476179,40,0,0,3,3,0.0,3.0,0.0,0.6300151833659191,"(37.5, 52.0]",Q3
36085,2020-03-07,476179,40,0,0,2,5,0.0,2.0,0.0,0.420010122243946,"(37.5, 52.0]",Q3
36085,2020-03-08,476179,40,0,0,0,5,0.0,0.7142857142857143,0.0,0.1500036150871236,"(37.5, 52.0]",Q3
36085,2020-03-09,476179,40,0,0,6,11,0.0,1.5714285714285714,0.0,0.3300079531916719,"(37.5, 52.0]",Q3
36085,2020-03-10,476179,40,1,1,5,16,0.14285714285714285,2.2857142857142856,0.030000723017424718,0.4800115682787955,"(37.5, 52.0]",Q3
36085,2020-03-11,476179,40,1,2,5,21,0.2857142857142857,3.0,0.060001446034849436,0.6300151833659191,"(37.5, 52.0]",Q3
36085,2020-03-12,476179,40,4,6,16,37,0.8571428571428571,5.285714285714286,0.18000433810454833,1.1100267516447146,"(37.5, 52.0]",Q3
36085,2020-03-13,476179,40,5,11,34,71,1.5714285714285714,9.714285714285714,0.3300079531916719,2.0400491651848807,"(37.5, 52.0]",Q3
36085,2020-03-14,476179,40,3,14,29,100,2.0,13.571428571428571,0.420010122243946,2.8500686866553484,"(37.5, 52.0]",Q3
36085,2020-03-15,476179,40,6,20,27,127,2.857142857142857,17.428571428571427,0.6000144603484944,3.6600882081258157,"(37.5, 52.0]",Q3
36085,2020-03-16,476179,40,11,31,35,162,4.428571428571429,21.571428571428573,0.9300224135401665,4.530109175631133,"(37.5, 52.0]",Q3
36085,2020-03-17,476179,40,26,57,61,223,8.0,29.571428571428573,1.680040488975784,6.2101496646069165,"(37.5, 52.0]",Q3
36085,2020-03-18,476179,40,33,90,110,333,12.571428571428571,44.57142857142857,2.6400636255333754,9.360225581436513,"(37.5, 52.0]",Q3
36085,2020-03-19,476179,40,116,206,272,605,28.571428571428573,81.14285714285714,6.000144603484944,17.04041067389724,"(37.5, 52.0]",Q3
36085,2020-03-20,476179,40,109,315,334,939,43.42857142857143,124.0,9.120219797297116,26.04062757912466,"(37.5, 52.0]",Q3
36085,2020-03-21,476179,40,207,522,645,1584,72.57142857142857,212.0,15.240367292851758,44.52107295785829,"(37.5, 52.0]",Q3
36085,2020-03-22,476179,40,193,715,417,2001,99.28571428571429,267.7142857142857,20.85050249711018,56.22135493465393,"(37.5, 52.0]",Q3
36085,2020-03-23,476179,40,200,915,487,2488,126.28571428571429,332.2857142857143,26.520639147403454,69.7816817385299,"(37.5, 52.0]",Q3
36085,2020-03-24,476179,40,110,1025,223,2711,138.28571428571428,355.42857142857144,29.04069988086713,74.6417988673527,"(37.5, 52.0]",Q3
36085,2020-03-25,476179,40,164,1189,293,3004,157.0,381.57142857142856,32.970794596149766,80.13193117954143,"(37.5, 52.0]",Q3
36085,2020-03-26,476179,40,223,1412,413,3417,172.28571428571428,401.7142857142857,36.18087195901421,84.36203312499832,"(37.5, 52.0]",Q3
36085,2020-03-27,476179,40,415,1827,847,4264,216.0,475.0,45.361093202346176,99.75240403293718,"(37.5, 52.0]",Q3
36085,2020-03-28,476179,40,402,2229,878,5142,243.85714285714286,508.2857142857143,51.211234190743994,106.74257249599715,"(37.5, 52.0]",Q3
36085,2020-03-29,476179,40,336,2565,711,5853,264.2857142857143,550.2857142857143,55.501337582235735,115.56278506312002,"(37.5, 52.0]",Q3
36085,2020-03-30,476179,40,324,2889,691,6544,282.0,579.4285714285714,59.221427236396394,121.68293255867466,"(37.5, 52.0]",Q3
36085,2020-03-31,476179,40,299,3188,616,7160,309.0,635.5714285714286,64.89156388668967,133.47321670452257,"(37.5, 52.0]",Q3
36085,2020-04-01,476179,40,279,3467,559,7719,325.42857142857144,673.5714285714286,68.34164703369352,141.45340902715753,"(37.5, 52.0]",Q3
36085,2020-04-02,476179,40,287,3754,563,8282,334.57142857142856,695.0,70.26169330680868,145.95351747977125,"(37.5, 52.0]",Q3
36085,2020-04-03,476179,40,319,4073,679,8961,320.85714285714283,671.0,67.38162389713591,140.91339601284392,"(37.5, 52.0]",Q3
36085,2020-04-04,476179,40,218,4291,513,9474,294.57142857142856,618.8571428571429,61.861490861929774,129.9631321114839,"(37.5, 52.0]",Q3
36085,2020-04-05,476179,40,288,4579,600,10074,287.7142857142857,603.0,60.42145615709339,126.63305185654974,"(37.5, 52.0]",Q3
36085,2020-04-06,476179,40,218,4797,605,10679,272.57142857142856,590.7142857142857,57.24137951724636,124.0529896770512,"(37.5, 52.0]",Q3
36085,2020-04-07,476179,40,546,5343,1262,11941,307.85714285714283,683.0,64.65155810255027,143.4334567463076,"(37.5, 52.0]",Q3
36085,2020-04-08,476179,40,641,5984,1528,13469,359.57142857142856,821.4285714285714,75.51181983485802,172.50415735019214,"(37.5, 52.0]",Q3
36085,2020-04-09,476179,40,500,6484,1212,14681,390.0,914.1428571428571,81.90197383756949,191.97462658850077,"(37.5, 52.0]",Q3
36085,2020-04-10,476179,40,376,6860,807,15488,398.14285714285717,932.4285714285714,83.6120150495627,195.81471913473115,"(37.5, 52.0]",Q3
36085,2020-04-11,476179,40,456,7316,1030,16518,432.14285714285717,1006.2857142857143,90.75218712770977,211.32509293473973,"(37.5, 52.0]",Q3
36085,2020-04-12,476179,40,352,7668,887,17405,441.2857142857143,1047.2857142857142,92.67223340082496,219.9353004407406,"(37.5, 52.0]",Q3
36085,2020-04-13,476179,40,292,7960,725,18130,451.85714285714283,1064.4285714285713,94.89228690411439,223.53538720283157,"(37.5, 52.0]",Q3
36085,2020-04-14,476179,40,338,8298,743,18873,422.14285714285717,990.2857142857143,88.65213651649005,207.96501195678817,"(37.5, 52.0]",Q3
36085,2020-04-15,476179,40,386,8684,1184,20057,385.7142857142857,941.1428571428571,81.00195214704674,197.64476323879404,"(37.5, 52.0]",Q3
36085,2020-04-16,476179,40,347,9031,1084,21141,363.85714285714283,922.8571428571429,76.41184152538075,193.80467069256372,"(37.5, 52.0]",Q3
36085,2020-04-17,476179,40,302,9333,1106,22247,353.2857142857143,965.5714285714286,74.19178802209133,202.77488687477367,"(37.5, 52.0]",Q3
36085,2020-04-18,476179,40,341,9674,1288,23535,336.85714285714283,1002.4285714285714,70.74170487508749,210.51507341326928,"(37.5, 52.0]",Q3
36085,2020-04-19,476179,40,239,9913,874,24409,320.7142857142857,1000.5714285714286,67.3516231741185,210.12506401404275,"(37.5, 52.0]",Q3
36085,2020-04-20,476179,40,208,10121,882,25291,308.7142857142857,1023.0,64.83156244065482,214.8351775277784,"(37.5, 52.0]",Q3
36085,2020-04-21,476179,40,224,10345,998,26289,292.42857142857144,1059.4285714285713,61.4114800166684,222.4853618972217,"(37.5, 52.0]",Q3
36085,2020-04-22,476179,40,245,10590,1031,27320,272.2857142857143,1037.5714285714287,57.18137807121152,217.89525127555578,"(37.5, 52.0]",Q3
36085,2020-04-23,476179,40,293,10883,1272,28592,264.57142857142856,1064.4285714285713,55.56133902827058,223.53538720283157,"(37.5, 52.0]",Q3
36085,2020-04-24,476179,40,246,11129,1011,29603,256.57142857142856,1050.857142857143,53.8812985392948,220.68531851617627,"(37.5, 52.0]",Q3
36085,2020-04-25,476179,40,154,11283,882,30485,229.85714285714286,992.8571428571429,48.27116333503637,208.50502497110182,"(37.5, 52.0]",Q3
36085,2020-04-26,476179,40,140,11423,658,31143,215.71428571428572,962.0,45.30109175631133,202.02486879933807,"(37.5, 52.0]",Q3
36085,2020-04-27,476179,40,93,11516,567,31710,199.28571428571428,917.0,41.85100860930748,192.57464104884926,"(37.5, 52.0]",Q3
36085,2020-04-28,476179,40,144,11660,935,32645,187.85714285714286,908.0,39.45095076791351,190.68459549875152,"(37.5, 52.0]",Q3
36085,2020-04-29,476179,40,151,11811,841,33486,174.42857142857142,880.8571428571429,36.63088280427558,184.98445812544082,"(37.5, 52.0]",Q3
36085,2020-04-30,476179,40,126,11937,849,34335,150.57142857142858,820.4285714285714,31.620762060365657,172.29415228907015,"(37.5, 52.0]",Q3
36085,2020-05-01,476179,40,157,12094,918,35253,137.85714285714286,807.1428571428571,28.950697711814858,169.50408504844964,"(37.5, 52.0]",Q3
36085,2020-05-02,476179,40,101,12195,729,35982,130.28571428571428,785.2857142857143,27.360659391891343,164.9139744267837,"(37.5, 52.0]",Q3
36085,2020-05-03,476179,40,60,12255,549,36531,118.85714285714286,769.7142857142857,24.96060155049737,161.64389561788437,"(37.5, 52.0]",Q3
36085,2020-05-04,476179,40,62,12317,573,37104,114.42857142857143,770.5714285714286,24.0305791369572,161.82389995598894,"(37.5, 52.0]",Q3
36085,2020-05-05,476179,40,84,12401,702,37806,105.85714285714286,737.2857142857143,22.23053575591172,154.833731492929,"(37.5, 52.0]",Q3
36085,2020-05-06,476179,40,105,12506,828,38634,99.28571428571429,735.4285714285714,20.85050249711018,154.44372209370246,"(37.5, 52.0]",Q3
36085,2020-05-07,476179,40,72,12578,672,39306,91.57142857142857,710.1428571428571,19.230463454169247,149.13359411961827,"(37.5, 52.0]",Q3
36085,2020-05-08,476179,40,72,12650,832,40138,79.42857142857143,697.8571428571429,16.680401997688143,146.55353194011977,"(37.5, 52.0]",Q3
36085,2020-05-09,476179,40,52,12702,717,40855,72.42857142857143,696.1428571428571,15.210366569834333,146.19352326391063,"(37.5, 52.0]",Q3
36085,2020-05-10,476179,40,45,12747,493,41348,70.28571428571429,688.1428571428571,14.760355724572962,144.51348277493486,"(37.5, 52.0]",Q3
36085,2020-05-11,476179,40,22,12769,517,41865,64.57142857142857,680.1428571428571,13.560326803875974,142.8334422859591,"(37.5, 52.0]",Q3
36085,2020-05-12,476179,40,41,12810,806,42671,58.42857142857143,695.0,12.27029571412671,145.95351747977125,"(37.5, 52.0]",Q3
36085,2020-05-13,476179,40,51,12861,869,43540,50.714285714285715,700.8571428571429,10.650256671185776,147.18354712348568,"(37.5, 52.0]",Q3
36085,2020-05-14,476179,40,48,12909,812,44352,47.285714285714285,720.8571428571429,9.930239318767581,151.38364834592517,"(37.5, 52.0]",Q3
36085,2020-05-15,476179,40,65,12974,843,45195,46.285714285714285,722.4285714285714,9.72023425764561,151.71365629911682,"(37.5, 52.0]",Q3
36085,2020-05-16,476179,40,37,13011,713,45908,44.142857142857146,721.8571428571429,9.270223412384238,151.5936534070471,"(37.5, 52.0]",Q3
36085,2020-05-17,476179,40,36,13047,571,46479,42.857142857142854,733.0,9.000216905227415,153.93370980240624,"(37.5, 52.0]",Q3
36085,2020-05-18,476179,40,22,13069,621,47100,42.857142857142854,747.8571428571429,9.000216905227415,157.0537849962184,"(37.5, 52.0]",Q3
36085,2020-05-19,476179,40,31,13100,751,47851,41.42857142857143,740.0,8.70020967505317,155.40374523026003,"(37.5, 52.0]",Q3
36085,2020-05-20,476179,40,40,13140,908,48759,39.857142857142854,745.5714285714286,8.370201721861497,156.5737734279396,"(37.5, 52.0]",Q3
36085,2020-05-21,476179,40,31,13171,877,49636,37.42857142857143,754.8571428571429,7.860189430565277,158.52382042407223,"(37.5, 52.0]",Q3
36085,2020-05-22,476179,40,44,13215,1232,50868,34.42857142857143,810.4285714285714,7.230174247199358,170.19410167785043,"(37.5, 52.0]",Q3
36085,2020-05-23,476179,40,51,13266,1120,51988,36.42857142857143,868.5714285714286,7.650184369443304,182.4043959459423,"(37.5, 52.0]",Q3
36085,2020-05-24,476179,40,21,13287,732,52720,34.285714285714285,891.5714285714286,7.200173524181932,187.23451235174767,"(37.5, 52.0]",Q3
36085,2020-05-25,476179,40,38,13325,1047,53767,36.57142857142857,952.4285714285714,7.680185092460728,200.0148203571706,"(37.5, 52.0]",Q3
36085,2020-05-26,476179,40,23,13348,720,54487,35.42857142857143,948.0,7.440179308321332,199.08479794363043,"(37.5, 52.0]",Q3
36085,2020-05-27,476179,40,56,13404,1623,56110,37.714285714285715,1050.142857142857,7.9201908766001266,220.5353149010891,"(37.5, 52.0]",Q3
36085,2020-05-28,476179,40,51,13455,1731,57841,40.57142857142857,1172.142857142857,8.52020533694862,246.15593235796982,"(37.5, 52.0]",Q3
36085,2020-05-29,476179,40,50,13505,1376,59217,41.42857142857143,1192.7142857142858,8.70020967505317,250.476036472479,"(37.5, 52.0]",Q3
36085,2020-05-30,476179,40,17,13522,1214,60431,36.57142857142857,1206.142857142857,7.680185092460728,253.2961044361169,"(37.5, 52.0]",Q3
36085,2020-05-31,476179,40,15,13537,1200,61631,35.714285714285715,1273.0,7.5001807543561805,267.33644280827167,"(37.5, 52.0]",Q3
36085,2020-06-01,476179,40,25,13562,972,62603,33.857142857142854,1262.2857142857142,7.1101713551296575,265.0863885819648,"(37.5, 52.0]",Q3
36085,2020-06-02,476179,40,23,13585,991,63594,33.857142857142854,1301.0,7.1101713551296575,273.2165845196869,"(37.5, 52.0]",Q3
36085,2020-06-03,476179,40,36,13621,1784,65378,31.0,1324.0,6.510156894781165,278.0467009254923,"(37.5, 52.0]",Q3
36085,2020-06-04,476179,40,42,13663,1576,66954,29.714285714285715,1301.857142857143,6.240150387624342,273.39658885779147,"(37.5, 52.0]",Q3
36085,2020-06-05,476179,40,28,13691,1886,68840,26.571428571428573,1374.7142857142858,5.580134481240998,288.6969575966781,"(37.5, 52.0]",Q3
36085,2020-06-06,476179,40,26,13717,1379,70219,27.857142857142858,1398.2857142857142,5.850140988397821,293.64707689455315,"(37.5, 52.0]",Q3
36085,2020-06-07,476179,40,10,13727,1182,71401,27.142857142857142,1395.7142857142858,5.700137373310697,293.10706388023954,"(37.5, 52.0]",Q3
36087,2020-03-02,325695,43,0,0,0,0,0.0,0.0,0.0,0.0,"(37.5, 52.0]",Q3
36087,2020-03-03,325695,43,0,0,0,0,0.0,0.0,0.0,0.0,"(37.5, 52.0]",Q3
36087,2020-03-04,325695,43,0,0,0,0,0.0,0.0,0.0,0.0,"(37.5, 52.0]",Q3
36087,2020-03-05,325695,43,0,0,0,0,0.0,0.0,0.0,0.0,"(37.5, 52.0]",Q3
36087,2020-03-06,325695,43,1,1,1,1,1.0,1.0,0.3070357236064416,0.3070357236064416,"(37.5, 52.0]",Q3
36087,2020-03-07,325695,43,0,1,0,1,0.0,0.0,0.0,0.0,"(37.5, 52.0]",Q3
36087,2020-03-08,325695,43,0,1,2,3,0.14285714285714285,0.42857142857142855,0.043862246229491655,0.13158673868847498,"(37.5, 52.0]",Q3
36087,2020-03-09,325695,43,3,4,7,10,0.5714285714285714,1.4285714285714286,0.17544898491796662,0.4386224622949166,"(37.5, 52.0]",Q3
36087,2020-03-10,325695,43,0,4,2,12,0.5714285714285714,1.7142857142857142,0.17544898491796662,0.5263469547538999,"(37.5, 52.0]",Q3
36087,2020-03-11,325695,43,2,6,2,14,0.8571428571428571,2.0,0.26317347737694996,0.6140714472128832,"(37.5, 52.0]",Q3
36087,2020-03-12,325695,43,2,8,5,19,1.1428571428571428,2.7142857142857144,0.35089796983593324,0.8333826783603416,"(37.5, 52.0]",Q3
36087,2020-03-13,325695,43,1,9,8,27,1.1428571428571428,3.7142857142857144,0.35089796983593324,1.1404184019667831,"(37.5, 52.0]",Q3
36087,2020-03-14,325695,43,3,12,21,48,1.5714285714285714,6.714285714285714,0.4824847085244082,2.061525572786108,"(37.5, 52.0]",Q3
36087,2020-03-15,325695,43,1,13,35,83,1.7142857142857142,11.428571428571429,0.5263469547538999,3.5089796983593327,"(37.5, 52.0]",Q3
36087,2020-03-16,325695,43,9,22,39,122,2.5714285714285716,16.0,0.7895204321308499,4.912571577703066,"(37.5, 52.0]",Q3
36087,2020-03-17,325695,43,8,30,29,151,3.7142857142857144,19.857142857142858,1.1404184019667831,6.09685222589934,"(37.5, 52.0]",Q3
36087,2020-03-18,325695,43,23,53,58,209,6.714285714285714,27.857142857142858,2.061525572786108,8.553138014750873,"(37.5, 52.0]",Q3
36087,2020-03-19,325695,43,48,101,192,401,13.285714285714286,54.57142857142857,4.079188899342724,16.755378059665816,"(37.5, 52.0]",Q3
36087,2020-03-20,325695,43,161,262,569,970,36.142857142857146,134.71428571428572,11.09714829606139,41.36209819441064,"(37.5, 52.0]",Q3
36087,2020-03-21,325695,43,193,455,604,1574,63.285714285714285,218.0,19.430975079664805,66.93378774620427,"(37.5, 52.0]",Q3
36087,2020-03-22,325695,43,137,592,393,1967,82.71428571428571,269.14285714285717,25.396240566875665,82.6364718963623,"(37.5, 52.0]",Q3
36087,2020-03-23,325695,43,79,671,315,2282,92.71428571428571,308.57142857142856,28.466597802940083,94.74245185570197,"(37.5, 52.0]",Q3
36087,2020-03-24,325695,43,297,968,592,2874,134.0,389.0,41.14278696326318,119.4368964829058,"(37.5, 52.0]",Q3
36087,2020-03-25,325695,43,229,1197,567,3441,163.42857142857142,461.7142857142857,50.17840968653845,141.76277981371703,"(37.5, 52.0]",Q3
36087,2020-03-26,325695,43,260,1457,588,4029,193.71428571428572,518.2857142857143,59.47720588719069,159.13222932059577,"(37.5, 52.0]",Q3
36087,2020-03-27,325695,43,439,1896,1078,5107,233.42857142857142,591.0,71.67091033898937,181.458112651407,"(37.5, 52.0]",Q3
36087,2020-03-28,325695,43,313,2209,827,5934,250.57142857142858,622.8571428571429,76.93437988652838,191.23939356058364,"(37.5, 52.0]",Q3
36087,2020-03-29,325695,43,302,2511,604,6538,274.14285714285717,653.0,84.1716505143945,200.49432751500638,"(37.5, 52.0]",Q3
36087,2020-03-30,325695,43,352,2863,739,7277,313.14285714285717,713.5714285714286,96.14604373504572,219.09191991631081,"(37.5, 52.0]",Q3
36087,2020-03-31,325695,43,458,3321,930,8207,336.14285714285717,761.8571428571429,103.20786537799388,233.91735914187902,"(37.5, 52.0]",Q3
36087,2020-04-01,325695,43,430,3751,904,9111,364.85714285714283,810.0,112.02417687012169,248.6989361212177,"(37.5, 52.0]",Q3
36087,2020-04-02,325695,43,538,4289,997,10108,404.57142857142856,868.4285714285714,124.21788132192039,266.6385948290798,"(37.5, 52.0]",Q3
36087,2020-04-03,325695,43,583,4872,1124,11232,425.14285714285717,875.0,130.53404477896717,268.6562581556364,"(37.5, 52.0]",Q3
36087,2020-04-04,325695,43,454,5326,880,12112,445.2857142857143,882.5714285714286,136.7186214973255,270.9809572057995,"(37.5, 52.0]",Q3
36087,2020-04-05,325695,43,377,5703,732,12844,456.0,900.8571428571429,140.00828996453737,276.59532472317443,"(37.5, 52.0]",Q3
36087,2020-04-06,325695,43,287,5990,662,13506,446.7142857142857,889.8571428571429,137.15724395962042,273.21793176350354,"(37.5, 52.0]",Q3
36087,2020-04-07,325695,43,423,6413,1027,14533,441.7142857142857,903.7142857142857,135.6220653415882,277.4725696477642,"(37.5, 52.0]",Q3
36087,2020-04-08,325695,43,252,6665,648,15181,416.2857142857143,867.1428571428571,127.81458551273869,266.24383461301437,"(37.5, 52.0]",Q3
36087,2020-04-09,325695,43,457,7122,1013,16194,404.7142857142857,869.4285714285714,124.26174356814988,266.9456305526862,"(37.5, 52.0]",Q3
36087,2020-04-10,325695,43,355,7477,785,16979,372.14285714285717,821.0,114.26115142782578,252.07632908088857,"(37.5, 52.0]",Q3
36087,2020-04-11,325695,43,244,7721,569,17548,342.14285714285717,776.5714285714286,105.05007971963252,238.43517050351664,"(37.5, 52.0]",Q3
36087,2020-04-12,325695,43,244,7965,586,18134,323.14285714285717,755.7142857142857,99.21640097111013,232.03128255401086,"(37.5, 52.0]",Q3
36087,2020-04-13,325695,43,370,8335,779,18913,335.0,772.4285714285714,102.85696740815794,237.16316536286138,"(37.5, 52.0]",Q3
36087,2020-04-14,325695,43,139,8474,371,19284,294.42857142857144,678.7142857142857,90.40008947898231,208.38953183631486,"(37.5, 52.0]",Q3
36087,2020-04-15,325695,43,278,8752,830,20114,298.14285714285717,704.7142857142857,91.5405078809491,216.37246065008233,"(37.5, 52.0]",Q3
36087,2020-04-16,325695,43,235,8987,678,20792,266.42857142857144,656.8571428571429,81.80308921800194,201.67860816320265,"(37.5, 52.0]",Q3
36087,2020-04-17,325695,43,184,9171,610,21402,242.0,631.8571428571429,74.30264511275887,194.00271507304163,"(37.5, 52.0]",Q3
36087,2020-04-18,325695,43,193,9364,547,21949,234.71428571428572,628.7142857142857,72.0656705550548,193.03774565599278,"(37.5, 52.0]",Q3
36087,2020-04-19,325695,43,93,9457,316,22265,213.14285714285714,590.1428571428571,65.44247137440155,181.19493917403003,"(37.5, 52.0]",Q3
36087,2020-04-20,325695,43,111,9568,407,22672,176.14285714285714,537.0,54.08214960096321,164.87818357665913,"(37.5, 52.0]",Q3
36087,2020-04-21,325695,43,131,9699,478,23150,175.0,552.2857142857143,53.73125163112728,169.57144392321476,"(37.5, 52.0]",Q3
36087,2020-04-22,325695,43,129,9828,584,23734,153.71428571428572,517.1428571428571,47.19577694293302,158.78133135075979,"(37.5, 52.0]",Q3
36087,2020-04-23,325695,43,263,10091,1255,24989,157.71428571428572,599.5714285714286,48.423919837358795,184.0898474251765,"(37.5, 52.0]",Q3
36087,2020-04-24,325695,43,1000,11091,2606,27595,274.2857142857143,884.7142857142857,84.21551276062398,271.63889089924186,"(37.5, 52.0]",Q3
36087,2020-04-25,325695,43,165,11256,677,28272,270.2857142857143,903.2857142857143,82.98736986619822,277.34098290907576,"(37.5, 52.0]",Q3
36087,2020-04-26,325695,43,110,11366,565,28837,272.7142857142857,938.8571428571429,83.73302805209958,288.2626822202192,"(37.5, 52.0]",Q3
36087,2020-04-27,325695,43,87,11453,537,29374,269.2857142857143,957.4285714285714,82.68033414259178,293.9647742300531,"(37.5, 52.0]",Q3
36087,2020-04-28,325695,43,133,11586,528,29902,269.57142857142856,964.5714285714286,82.76805863505075,296.15788654152766,"(37.5, 52.0]",Q3
36087,2020-04-29,325695,43,122,11708,691,30593,268.57142857142856,979.8571428571429,82.46102291144432,300.8511468880833,"(37.5, 52.0]",Q3
36087,2020-04-30,325695,43,104,11812,823,31416,245.85714285714286,918.1428571428571,75.48692576095515,281.9026565169429,"(37.5, 52.0]",Q3
36087,2020-05-01,325695,43,133,11945,779,32195,122.0,657.1428571428571,37.45835827998588,201.7663326556616,"(37.5, 52.0]",Q3
36087,2020-05-02,325695,43,80,12025,598,32793,109.85714285714286,645.8571428571429,33.73006735047908,198.3012152035318,"(37.5, 52.0]",Q3
36087,2020-05-03,325695,43,70,12095,476,33269,104.14285714285714,633.1428571428571,31.975577501299416,194.39747528910704,"(37.5, 52.0]",Q3
36087,2020-05-04,325695,43,49,12144,437,33706,98.71428571428571,618.8571428571429,30.30881214457873,190.01125066615788,"(37.5, 52.0]",Q3
36087,2020-05-05,325695,43,60,12204,401,34107,88.28571428571429,600.7142857142857,27.106868169825844,184.4407453950124,"(37.5, 52.0]",Q3
36087,2020-05-06,325695,43,76,12280,852,34959,81.71428571428571,623.7142857142857,25.089204843269226,191.50256703796057,"(37.5, 52.0]",Q3
36087,2020-05-07,325695,43,69,12349,740,35699,76.71428571428571,611.8571428571429,23.55402622523702,187.86200060091278,"(37.5, 52.0]",Q3
36087,2020-05-08,325695,43,51,12400,669,36368,65.0,596.1428571428571,19.957322034418706,183.03715351566868,"(37.5, 52.0]",Q3
36087,2020-05-09,325695,43,51,12451,582,36950,60.857142857142854,593.8571428571429,18.685316893763446,182.33535757599682,"(37.5, 52.0]",Q3
36087,2020-05-10,325695,43,33,12484,564,37514,55.57142857142857,606.4285714285714,17.062413783272255,186.1952352441921,"(37.5, 52.0]",Q3
36087,2020-05-11,325695,43,20,12504,368,37882,51.42857142857143,596.5714285714286,15.790408642616999,183.16874025435717,"(37.5, 52.0]",Q3
36087,2020-05-12,325695,43,39,12543,637,38519,48.42857142857143,630.2857142857143,14.869301471797673,193.5202303645172,"(37.5, 52.0]",Q3
36087,2020-05-13,325695,43,53,12596,1096,39615,45.142857142857146,665.1428571428571,13.860469808519364,204.22261844451313,"(37.5, 52.0]",Q3
36087,2020-05-14,325695,43,41,12637,851,40466,41.142857142857146,681.0,12.632326914093598,209.09132777598674,"(37.5, 52.0]",Q3
36087,2020-05-15,325695,43,51,12688,1035,41501,41.142857142857146,733.2857142857143,12.632326914093598,225.1449098959807,"(37.5, 52.0]",Q3
36087,2020-05-16,325695,43,70,12758,779,42280,43.857142857142854,761.4285714285714,13.465709592453939,233.78577240319058,"(37.5, 52.0]",Q3
36087,2020-05-17,325695,43,19,12777,486,42766,41.857142857142854,750.2857142857143,12.851638145241056,230.3645171972902,"(37.5, 52.0]",Q3
36087,2020-05-18,325695,43,21,12798,338,43104,42.0,746.0,12.895500391470549,229.04864981040546,"(37.5, 52.0]",Q3
36087,2020-05-19,325695,43,33,12831,577,43681,41.142857142857146,737.4285714285714,12.632326914093598,226.41691503663594,"(37.5, 52.0]",Q3
36087,2020-05-20,325695,43,46,12877,1091,44772,40.142857142857146,736.7142857142857,12.325291190487157,226.19760380548846,"(37.5, 52.0]",Q3
36087,2020-05-21,325695,43,28,12905,790,45562,38.285714285714285,728.0,11.755081989503765,223.52200678548948,"(37.5, 52.0]",Q3
36087,2020-05-22,325695,43,29,12934,814,46376,35.142857142857146,696.4285714285714,10.790112572454948,213.82845036877185,"(37.5, 52.0]",Q3
36087,2020-05-23,325695,43,29,12963,735,47111,29.285714285714285,690.1428571428571,8.99176047704579,211.8985115346742,"(37.5, 52.0]",Q3
36087,2020-05-24,325695,43,33,12996,634,47745,31.285714285714285,711.2857142857143,9.605831924258673,218.39012397663896,"(37.5, 52.0]",Q3
36087,2020-05-25,325695,43,23,13019,652,48397,31.571428571428573,756.1428571428571,9.693556416717657,232.16286929269933,"(37.5, 52.0]",Q3
36087,2020-05-26,325695,43,28,13047,554,48951,30.857142857142858,752.8571428571429,9.474245185570197,231.15403762942105,"(37.5, 52.0]",Q3
36087,2020-05-27,325695,43,29,13076,1115,50066,28.428571428571427,756.2857142857143,8.72858699966884,232.20673153892886,"(37.5, 52.0]",Q3
36087,2020-05-28,325695,43,24,13100,1097,51163,27.857142857142858,800.1428571428571,8.553138014750873,245.67244113138275,"(37.5, 52.0]",Q3
36087,2020-05-29,325695,43,28,13128,807,51970,27.714285714285715,799.1428571428571,8.509275768521382,245.3654054077763,"(37.5, 52.0]",Q3
36087,2020-05-30,325695,43,23,13151,616,52586,26.857142857142858,782.1428571428571,8.246102291144432,240.14579810646683,"(37.5, 52.0]",Q3
36087,2020-05-31,325695,43,34,13185,682,53268,27.0,789.0,8.289964537373924,242.25118592548245,"(37.5, 52.0]",Q3
36087,2020-06-01,325695,43,38,13223,785,54053,29.142857142857142,808.0,8.947898230816298,248.08486467400482,"(37.5, 52.0]",Q3
36087,2020-06-02,325695,43,36,13259,1088,55141,30.285714285714285,884.2857142857143,9.298796200652232,271.50730416055336,"(37.5, 52.0]",Q3
36087,2020-06-03,325695,43,21,13280,969,56110,29.142857142857142,863.4285714285714,8.947898230816298,265.10341621104754,"(37.5, 52.0]",Q3
36087,2020-06-04,325695,43,17,13297,1191,57301,28.142857142857142,876.8571428571429,8.640862507209857,269.2264673566198,"(37.5, 52.0]",Q3
36087,2020-06-05,325695,43,18,13315,1030,58331,26.714285714285715,908.7142857142857,8.20224004491494,279.0077482657964,"(37.5, 52.0]",Q3
36087,2020-06-06,325695,43,10,13325,795,59126,24.857142857142858,934.2857142857143,7.632030843931548,286.85909034087547,"(37.5, 52.0]",Q3
36087,2020-06-07,325695,43,15,13340,761,59887,22.142857142857142,945.5714285714286,6.7986481655712065,290.3242077930053,"(37.5, 52.0]",Q3
36089,2020-03-02,108047,58,0,0,0,0,0.0,0.0,0.0,0.0,"(52.0, 100.0]",Q4
36089,2020-03-03,108047,58,0,0,0,0,0.0,0.0,0.0,0.0,"(52.0, 100.0]",Q4
36089,2020-03-04,108047,58,0,0,0,0,0.0,0.0,0.0,0.0,"(52.0, 100.0]",Q4
36089,2020-03-05,108047,58,0,0,0,0,0.0,0.0,0.0,0.0,"(52.0, 100.0]",Q4
36089,2020-03-06,108047,58,0,0,0,0,0.0,0.0,0.0,0.0,"(52.0, 100.0]",Q4
36089,2020-03-07,108047,58,0,0,2,2,0.0,2.0,0.0,1.8510463039232927,"(52.0, 100.0]",Q4
36089,2020-03-08,108047,58,0,0,0,2,0.0,0.2857142857142857,0.0,0.2644351862747561,"(52.0, 100.0]",Q4
36089,2020-03-09,108047,58,0,0,0,2,0.0,0.2857142857142857,0.0,0.2644351862747561,"(52.0, 100.0]",Q4
36089,2020-03-10,108047,58,0,0,1,3,0.0,0.42857142857142855,0.0,0.39665277941213417,"(52.0, 100.0]",Q4
36089,2020-03-11,108047,58,0,0,2,5,0.0,0.7142857142857143,0.0,0.6610879656868902,"(52.0, 100.0]",Q4
36089,2020-03-12,108047,58,0,0,1,6,0.0,0.8571428571428571,0.0,0.7933055588242683,"(52.0, 100.0]",Q4
36089,2020-03-13,108047,58,0,0,1,7,0.0,1.0,0.0,0.9255231519616464,"(52.0, 100.0]",Q4
36089,2020-03-14,108047,58,0,0,1,8,0.0,0.8571428571428571,0.0,0.7933055588242683,"(52.0, 100.0]",Q4
36089,2020-03-15,108047,58,0,0,1,9,0.0,1.0,0.0,0.9255231519616464,"(52.0, 100.0]",Q4
36089,2020-03-16,108047,58,0,0,0,9,0.0,1.0,0.0,0.9255231519616464,"(52.0, 100.0]",Q4
36089,2020-03-17,108047,58,0,0,7,16,0.0,1.8571428571428572,0.0,1.7188287107859146,"(52.0, 100.0]",Q4
36089,2020-03-18,108047,58,0,0,3,19,0.0,2.0,0.0,1.8510463039232927,"(52.0, 100.0]",Q4
36089,2020-03-19,108047,58,0,0,7,26,0.0,2.857142857142857,0.0,2.644351862747561,"(52.0, 100.0]",Q4
36089,2020-03-20,108047,58,0,0,7,33,0.0,3.7142857142857144,0.0,3.437657421571829,"(52.0, 100.0]",Q4
36089,2020-03-21,108047,58,1,1,20,53,0.14285714285714285,6.428571428571429,0.13221759313737805,5.949791691182012,"(52.0, 100.0]",Q4
36089,2020-03-22,108047,58,0,1,9,62,0.14285714285714285,7.571428571428571,0.13221759313737805,7.007532436281036,"(52.0, 100.0]",Q4
36089,2020-03-23,108047,58,0,1,6,68,0.14285714285714285,8.428571428571429,0.13221759313737805,7.800837995105304,"(52.0, 100.0]",Q4
36089,2020-03-24,108047,58,0,1,10,78,0.14285714285714285,8.857142857142858,0.13221759313737805,8.197490774517439,"(52.0, 100.0]",Q4
36089,2020-03-25,108047,58,1,2,14,92,0.2857142857142857,10.428571428571429,0.2644351862747561,9.651884299028598,"(52.0, 100.0]",Q4
36089,2020-03-26,108047,58,1,3,29,121,0.42857142857142855,13.571428571428571,0.39665277941213417,12.560671348050914,"(52.0, 100.0]",Q4
36089,2020-03-27,108047,58,5,8,82,203,1.1428571428571428,24.285714285714285,1.0577407450990244,22.476990833354268,"(52.0, 100.0]",Q4
36089,2020-03-28,108047,58,4,12,65,268,1.5714285714285714,30.714285714285715,1.4543935245111583,28.426782524536282,"(52.0, 100.0]",Q4
36089,2020-03-29,108047,58,1,13,44,312,1.7142857142857142,35.714285714285715,1.5866111176485367,33.054398284344515,"(52.0, 100.0]",Q4
36089,2020-03-30,108047,58,17,30,74,386,4.142857142857143,45.42857142857143,3.8343102009839636,42.04519461768622,"(52.0, 100.0]",Q4
36089,2020-03-31,108047,58,4,34,32,418,4.714285714285714,48.57142857142857,4.363180573533476,44.953981666708536,"(52.0, 100.0]",Q4
36089,2020-04-01,108047,58,5,39,30,448,5.285714285714286,50.857142857142854,4.892050946082988,47.069463156906586,"(52.0, 100.0]",Q4
36089,2020-04-02,108047,58,4,43,54,502,5.714285714285714,54.42857142857143,5.288703725495122,50.37490298534104,"(52.0, 100.0]",Q4
36089,2020-04-03,108047,58,9,52,81,583,6.285714285714286,54.285714285714285,5.817574098044633,50.242685392203654,"(52.0, 100.0]",Q4
36089,2020-04-04,108047,58,3,55,46,629,6.142857142857143,51.57142857142857,5.685356504907256,47.73055112259347,"(52.0, 100.0]",Q4
36089,2020-04-05,108047,58,4,59,43,672,6.571428571428571,51.42857142857143,6.08200928431939,47.5983335294561,"(52.0, 100.0]",Q4
36089,2020-04-06,108047,58,1,60,64,736,4.285714285714286,50.0,3.9665277941213413,46.276157598082314,"(52.0, 100.0]",Q4
36089,2020-04-07,108047,58,9,69,69,805,5.0,55.285714285714285,4.627615759808232,51.1682085441653,"(52.0, 100.0]",Q4
36089,2020-04-08,108047,58,7,76,50,855,5.285714285714286,58.142857142857146,4.892050946082988,53.812560406912866,"(52.0, 100.0]",Q4
36089,2020-04-09,108047,58,2,78,24,879,5.0,53.857142857142854,4.627615759808232,49.84603261279152,"(52.0, 100.0]",Q4
36089,2020-04-10,108047,58,2,80,19,898,4.0,45.0,3.7020926078465854,41.648541838274085,"(52.0, 100.0]",Q4
36089,2020-04-11,108047,58,5,85,65,963,4.285714285714286,47.714285714285715,3.9665277941213413,44.16067610788427,"(52.0, 100.0]",Q4
36089,2020-04-12,108047,58,4,89,47,1010,4.285714285714286,48.285714285714285,3.9665277941213413,44.68954648043378,"(52.0, 100.0]",Q4
36089,2020-04-13,108047,58,3,92,29,1039,4.571428571428571,43.285714285714285,4.2309629803960975,40.06193072062555,"(52.0, 100.0]",Q4
36089,2020-04-14,108047,58,0,92,7,1046,3.2857142857142856,34.42857142857143,3.041004642159695,31.86443994610811,"(52.0, 100.0]",Q4
36089,2020-04-15,108047,58,1,93,48,1094,2.4285714285714284,34.142857142857146,2.247699083335427,31.600004759833357,"(52.0, 100.0]",Q4
36089,2020-04-16,108047,58,3,96,16,1110,2.5714285714285716,33.0,2.379916676472805,30.54226401473433,"(52.0, 100.0]",Q4
36089,2020-04-17,108047,58,2,98,6,1116,2.5714285714285716,31.142857142857142,2.379916676472805,28.823435303948415,"(52.0, 100.0]",Q4
36089,2020-04-18,108047,58,7,105,25,1141,2.857142857142857,25.428571428571427,2.644351862747561,23.534731578453293,"(52.0, 100.0]",Q4
36089,2020-04-19,108047,58,5,110,24,1165,3.0,22.142857142857142,2.776569455884939,20.493726936293598,"(52.0, 100.0]",Q4
36089,2020-04-20,108047,58,10,120,17,1182,4.0,20.428571428571427,3.7020926078465854,18.907115818645057,"(52.0, 100.0]",Q4
36089,2020-04-21,108047,58,3,123,6,1188,4.428571428571429,20.285714285714285,4.098745387258719,18.77489822550768,"(52.0, 100.0]",Q4
36089,2020-04-22,108047,58,16,139,94,1282,6.571428571428571,26.857142857142858,6.08200928431939,24.85690750982707,"(52.0, 100.0]",Q4
36089,2020-04-23,108047,58,5,144,37,1319,6.857142857142857,29.857142857142858,6.346444470594147,27.633476965712013,"(52.0, 100.0]",Q4
36089,2020-04-24,108047,58,12,156,64,1383,8.285714285714286,38.142857142857146,7.668620401967927,35.30209736767994,"(52.0, 100.0]",Q4
36089,2020-04-25,108047,58,11,167,36,1419,8.857142857142858,39.714285714285715,8.197490774517439,36.756490892191096,"(52.0, 100.0]",Q4
36089,2020-04-26,108047,58,2,169,27,1446,8.428571428571429,40.142857142857146,7.800837995105304,37.15314367160323,"(52.0, 100.0]",Q4
36089,2020-04-27,108047,58,1,170,19,1465,7.142857142857143,40.42857142857143,6.610879656868903,37.41757885787799,"(52.0, 100.0]",Q4
36089,2020-04-28,108047,58,0,170,84,1549,6.714285714285714,51.57142857142857,6.214226877456768,47.73055112259347,"(52.0, 100.0]",Q4
36089,2020-04-29,108047,58,3,173,277,1826,4.857142857142857,77.71428571428571,4.495398166670854,71.92637066673366,"(52.0, 100.0]",Q4
36089,2020-04-30,108047,58,3,176,157,1983,4.571428571428571,94.85714285714286,4.2309629803960975,87.79248184321902,"(52.0, 100.0]",Q4
36089,2020-05-01,108047,58,0,176,130,2113,2.857142857142857,104.28571428571429,2.644351862747561,96.51884299028598,"(52.0, 100.0]",Q4
36089,2020-05-02,108047,58,1,177,125,2238,1.4285714285714286,117.0,1.3221759313737804,108.28620877951262,"(52.0, 100.0]",Q4
36089,2020-05-03,108047,58,1,178,85,2323,1.2857142857142858,125.28571428571429,1.1899583382364025,115.95482918148055,"(52.0, 100.0]",Q4
36089,2020-05-04,108047,58,0,178,38,2361,1.1428571428571428,128.0,1.0577407450990244,118.46696345109073,"(52.0, 100.0]",Q4
36089,2020-05-05,108047,58,2,180,34,2395,1.4285714285714286,120.85714285714286,1.3221759313737804,111.85608379422182,"(52.0, 100.0]",Q4
36089,2020-05-06,108047,58,1,181,53,2448,1.1428571428571428,88.85714285714286,1.0577407450990244,82.23934293144914,"(52.0, 100.0]",Q4
36089,2020-05-07,108047,58,6,187,845,3293,1.5714285714285714,187.14285714285714,1.4543935245111583,173.20504700996523,"(52.0, 100.0]",Q4
36089,2020-05-08,108047,58,0,187,164,3457,1.5714285714285714,192.0,1.4543935245111583,177.7004451766361,"(52.0, 100.0]",Q4
36089,2020-05-09,108047,58,0,187,51,3508,1.4285714285714286,181.42857142857142,1.3221759313737804,167.91634328447012,"(52.0, 100.0]",Q4
36089,2020-05-10,108047,58,3,190,47,3555,1.7142857142857142,176.0,1.5866111176485367,162.89207474524974,"(52.0, 100.0]",Q4
36089,2020-05-11,108047,58,1,191,18,3573,1.8571428571428572,173.14285714285714,1.7188287107859146,160.2477228825022,"(52.0, 100.0]",Q4
36089,2020-05-12,108047,58,1,192,151,3724,1.7142857142857142,189.85714285714286,1.5866111176485367,175.7171812795754,"(52.0, 100.0]",Q4
36089,2020-05-13,108047,58,0,192,105,3829,1.5714285714285714,197.28571428571428,1.4543935245111583,182.59249612271907,"(52.0, 100.0]",Q4
36089,2020-05-14,108047,58,0,192,332,4161,0.7142857142857143,124.0,0.6610879656868902,114.76487084324414,"(52.0, 100.0]",Q4
36089,2020-05-15,108047,58,0,192,1456,5617,0.7142857142857143,308.57142857142856,0.6610879656868902,285.59000117673656,"(52.0, 100.0]",Q4
36089,2020-05-16,108047,58,0,192,205,5822,0.7142857142857143,330.57142857142856,0.6610879656868902,305.9515105198928,"(52.0, 100.0]",Q4
36089,2020-05-17,108047,58,0,192,239,6061,0.2857142857142857,358.0,0.2644351862747561,331.3372884022694,"(52.0, 100.0]",Q4
36089,2020-05-18,108047,58,0,192,71,6132,0.14285714285714285,365.57142857142856,0.13221759313737805,338.3448208385504,"(52.0, 100.0]",Q4
36089,2020-05-19,108047,58,3,195,173,6305,0.42857142857142855,368.7142857142857,0.39665277941213417,341.25360788757274,"(52.0, 100.0]",Q4
36089,2020-05-20,108047,58,0,195,504,6809,0.42857142857142855,425.7142857142857,0.39665277941213417,394.00842754938657,"(52.0, 100.0]",Q4
36089,2020-05-21,108047,58,0,195,349,7158,0.42857142857142855,428.14285714285717,0.39665277941213417,396.25612663272204,"(52.0, 100.0]",Q4
36089,2020-05-22,108047,58,1,196,333,7491,0.5714285714285714,267.7142857142857,0.5288703725495122,247.7757695394465,"(52.0, 100.0]",Q4
36089,2020-05-23,108047,58,1,197,301,7792,0.7142857142857143,281.42857142857144,0.6610879656868902,260.46865848063476,"(52.0, 100.0]",Q4
36089,2020-05-24,108047,58,0,197,114,7906,0.7142857142857143,263.57142857142856,0.6610879656868902,243.9414593384625,"(52.0, 100.0]",Q4
36089,2020-05-25,108047,58,0,197,60,7966,0.7142857142857143,262.0,0.6610879656868902,242.48706581395135,"(52.0, 100.0]",Q4
36089,2020-05-26,108047,58,3,200,78,8044,0.7142857142857143,248.42857142857142,0.6610879656868902,229.9263944659004,"(52.0, 100.0]",Q4
36089,2020-05-27,108047,58,1,201,227,8271,0.8571428571428571,208.85714285714286,0.7933055588242683,193.30212116684672,"(52.0, 100.0]",Q4
36089,2020-05-28,108047,58,1,202,447,8718,1.0,222.85714285714286,0.9255231519616464,206.25944529430976,"(52.0, 100.0]",Q4
36089,2020-05-29,108047,58,0,202,136,8854,0.8571428571428571,194.71428571428572,0.7933055588242683,180.21257944624628,"(52.0, 100.0]",Q4
36089,2020-05-30,108047,58,2,204,303,9157,1.0,195.0,0.9255231519616464,180.47701463252102,"(52.0, 100.0]",Q4
36089,2020-05-31,108047,58,1,205,472,9629,1.1428571428571428,246.14285714285714,1.0577407450990244,227.81091297570237,"(52.0, 100.0]",Q4
36089,2020-06-01,108047,58,0,205,106,9735,1.1428571428571428,252.71428571428572,1.0577407450990244,233.89292226002178,"(52.0, 100.0]",Q4
36089,2020-06-02,108047,58,1,206,324,10059,0.8571428571428571,287.85714285714283,0.7933055588242683,266.41845017181674,"(52.0, 100.0]",Q4
36089,2020-06-03,108047,58,1,207,293,10352,0.8571428571428571,297.2857142857143,0.7933055588242683,275.1448113188837,"(52.0, 100.0]",Q4
36089,2020-06-04,108047,58,0,207,451,10803,0.7142857142857143,297.85714285714283,0.6610879656868902,275.67368169143316,"(52.0, 100.0]",Q4
36089,2020-06-05,108047,58,2,209,477,11280,1.0,346.57142857142856,0.9255231519616464,320.7598809512791,"(52.0, 100.0]",Q4
36089,2020-06-06,108047,58,0,209,382,11662,0.7142857142857143,357.85714285714283,0.6610879656868902,331.205070809132,"(52.0, 100.0]",Q4
36089,2020-06-07,108047,58,0,209,539,12201,0.5714285714285714,367.42857142857144,0.5288703725495122,340.0636495493364,"(52.0, 100.0]",Q4
36091,2020-03-02,230163,4,0,0,0,0,0.0,0.0,0.0,0.0,"(3.999, 24.0]",Q1
36091,2020-03-03,230163,4,0,0,0,0,0.0,0.0,0.0,0.0,"(3.999, 24.0]",Q1
36091,2020-03-04,230163,4,0,0,0,0,0.0,0.0,0.0,0.0,"(3.999, 24.0]",Q1
36091,2020-03-05,230163,4,0,0,0,0,0.0,0.0,0.0,0.0,"(3.999, 24.0]",Q1
36091,2020-03-06,230163,4,0,0,0,0,0.0,0.0,0.0,0.0,"(3.999, 24.0]",Q1
36091,2020-03-07,230163,4,0,0,1,1,0.0,1.0,0.0,0.43447469836594066,"(3.999, 24.0]",Q1
36091,2020-03-08,230163,4,0,0,0,1,0.0,0.14285714285714285,0.0,0.06206781405227724,"(3.999, 24.0]",Q1
36091,2020-03-09,230163,4,2,2,9,10,0.2857142857142857,1.4285714285714286,0.12413562810455447,0.6206781405227724,"(3.999, 24.0]",Q1
36091,2020-03-10,230163,4,0,2,2,12,0.2857142857142857,1.7142857142857142,0.12413562810455447,0.7448137686273267,"(3.999, 24.0]",Q1
36091,2020-03-11,230163,4,1,3,31,43,0.42857142857142855,6.142857142857143,0.18620344215683168,2.6689160042479214,"(3.999, 24.0]",Q1
36091,2020-03-12,230163,4,0,3,32,75,0.42857142857142855,10.714285714285714,0.18620344215683168,4.655086053920793,"(3.999, 24.0]",Q1
36091,2020-03-13,230163,4,0,3,41,116,0.42857142857142855,16.571428571428573,0.18620344215683168,7.19986643006416,"(3.999, 24.0]",Q1
36091,2020-03-14,230163,4,0,3,45,161,0.42857142857142855,22.857142857142858,0.18620344215683168,9.930850248364358,"(3.999, 24.0]",Q1
36091,2020-03-15,230163,4,2,5,66,227,0.7142857142857143,32.285714285714285,0.3103390702613862,14.027325975814655,"(3.999, 24.0]",Q1
36091,2020-03-16,230163,4,4,9,55,282,1.0,38.857142857142854,0.43447469836594066,16.88244542221941,"(3.999, 24.0]",Q1
36091,2020-03-17,230163,4,5,14,76,358,1.7142857142857142,49.42857142857143,0.7448137686273267,21.475463662087925,"(3.999, 24.0]",Q1
36091,2020-03-18,230163,4,4,18,156,514,2.142857142857143,67.28571428571429,0.9310172107841584,29.23394041862258,"(3.999, 24.0]",Q1
36091,2020-03-19,230163,4,6,24,102,616,3.0,77.28571428571429,1.303424095097822,33.578687402281986,"(3.999, 24.0]",Q1
36091,2020-03-20,230163,4,11,35,279,895,4.571428571428571,111.28571428571429,1.9861700496728716,48.35082714672397,"(3.999, 24.0]",Q1
36091,2020-03-21,230163,4,6,41,143,1038,5.428571428571429,125.28571428571429,2.358576933986535,54.43347292384714,"(3.999, 24.0]",Q1
36091,2020-03-22,230163,4,12,53,164,1202,6.857142857142857,139.28571428571428,2.979255074509307,60.516118700970296,"(3.999, 24.0]",Q1
36091,2020-03-23,230163,4,7,60,76,1278,7.285714285714286,142.28571428571428,3.165458516666139,61.81954279606812,"(3.999, 24.0]",Q1
36091,2020-03-24,230163,4,4,64,69,1347,7.142857142857143,141.28571428571428,3.103390702613862,61.38506809770218,"(3.999, 24.0]",Q1
36091,2020-03-25,230163,4,9,73,55,1402,7.857142857142857,126.85714285714286,3.4137297728752483,55.11621887842219,"(3.999, 24.0]",Q1
36091,2020-03-26,230163,4,9,82,69,1471,8.285714285714286,122.14285714285714,3.59993321503208,53.06798101469704,"(3.999, 24.0]",Q1
36091,2020-03-27,230163,4,14,96,82,1553,8.714285714285714,94.0,3.7861366571889112,40.84062164639842,"(3.999, 24.0]",Q1
36091,2020-03-28,230163,4,6,102,51,1604,8.714285714285714,80.85714285714286,3.7861366571889112,35.13038275358892,"(3.999, 24.0]",Q1
36091,2020-03-29,230163,4,3,105,15,1619,7.428571428571429,59.57142857142857,3.2275263307184168,25.882278459799608,"(3.999, 24.0]",Q1
36091,2020-03-30,230163,4,3,108,23,1642,6.857142857142857,52.0,2.979255074509307,22.592684315028915,"(3.999, 24.0]",Q1
36091,2020-03-31,230163,4,14,122,78,1720,8.285714285714286,53.285714285714285,3.59993321503208,23.15129464149941,"(3.999, 24.0]",Q1
36091,2020-04-01,230163,4,10,132,69,1789,8.428571428571429,55.285714285714285,3.6620010290843568,24.02024403823129,"(3.999, 24.0]",Q1
36091,2020-04-02,230163,4,9,141,53,1842,8.428571428571429,53.0,3.6620010290843568,23.027159013394858,"(3.999, 24.0]",Q1
36091,2020-04-03,230163,4,0,141,57,1899,6.428571428571429,49.42857142857143,2.793051632352476,21.475463662087925,"(3.999, 24.0]",Q1
36091,2020-04-04,230163,4,7,148,110,2009,6.571428571428571,57.857142857142854,2.855119446404753,25.137464691172283,"(3.999, 24.0]",Q1
36091,2020-04-05,230163,4,5,153,34,2043,6.857142857142857,60.57142857142857,2.979255074509307,26.316753158165547,"(3.999, 24.0]",Q1
36091,2020-04-06,230163,4,2,155,40,2083,6.714285714285714,63.0,2.9171872604570304,27.37190599705426,"(3.999, 24.0]",Q1
36091,2020-04-07,230163,4,7,162,73,2156,5.714285714285714,62.285714285714285,2.4827125620910895,27.061566926792878,"(3.999, 24.0]",Q1
36091,2020-04-08,230163,4,10,172,113,2269,5.714285714285714,68.57142857142857,2.4827125620910895,29.79255074509307,"(3.999, 24.0]",Q1
36091,2020-04-09,230163,4,10,182,154,2423,5.857142857142857,83.0,2.5447803761433665,36.06139996437308,"(3.999, 24.0]",Q1
36091,2020-04-10,230163,4,5,187,68,2491,6.571428571428571,84.57142857142857,2.855119446404753,36.74414591894812,"(3.999, 24.0]",Q1
36091,2020-04-11,230163,4,9,196,88,2579,6.857142857142857,81.42857142857143,2.979255074509307,35.378654009798026,"(3.999, 24.0]",Q1
36091,2020-04-12,230163,4,5,201,61,2640,6.857142857142857,85.28571428571429,2.979255074509307,37.05448498920951,"(3.999, 24.0]",Q1
36091,2020-04-13,230163,4,23,224,193,2833,9.857142857142858,107.14285714285714,4.28267916960713,46.550860539207925,"(3.999, 24.0]",Q1
36091,2020-04-14,230163,4,3,227,71,2904,9.285714285714286,106.85714285714286,4.034407913398021,46.42672491110338,"(3.999, 24.0]",Q1
36091,2020-04-15,230163,4,4,231,92,2996,8.428571428571429,103.85714285714286,3.6620010290843568,45.12330081600555,"(3.999, 24.0]",Q1
36091,2020-04-16,230163,4,5,236,77,3073,7.714285714285714,92.85714285714286,3.351661958822971,40.3440791339802,"(3.999, 24.0]",Q1
36091,2020-04-17,230163,4,8,244,98,3171,8.142857142857142,97.14285714285714,3.5378654009798023,42.20611355554852,"(3.999, 24.0]",Q1
36091,2020-04-18,230163,4,7,251,105,3276,7.857142857142857,99.57142857142857,3.4137297728752483,43.261266394437236,"(3.999, 24.0]",Q1
36091,2020-04-19,230163,4,3,254,32,3308,7.571428571428571,95.42857142857143,3.2895941447706933,41.461299786921195,"(3.999, 24.0]",Q1
36091,2020-04-20,230163,4,3,257,42,3350,4.714285714285714,73.85714285714286,2.0482378637251486,32.08905986502734,"(3.999, 24.0]",Q1
36091,2020-04-21,230163,4,7,264,101,3451,5.285714285714286,78.14285714285714,2.2965091199342575,33.95109428659565,"(3.999, 24.0]",Q1
36091,2020-04-22,230163,4,1,265,52,3503,4.857142857142857,72.42857142857143,2.110305677777426,31.468381724504564,"(3.999, 24.0]",Q1
36091,2020-04-23,230163,4,13,278,127,3630,6.0,79.57142857142857,2.606848190195644,34.57177242711842,"(3.999, 24.0]",Q1
36091,2020-04-24,230163,4,42,320,642,4272,10.857142857142858,157.28571428571428,4.71715386797307,68.33666327155723,"(3.999, 24.0]",Q1
36091,2020-04-25,230163,4,10,330,217,4489,11.285714285714286,173.28571428571428,4.903357310129902,75.28825844541228,"(3.999, 24.0]",Q1
36091,2020-04-26,230163,4,6,336,114,4603,11.714285714285714,185.0,5.089560752286733,80.37781919769903,"(3.999, 24.0]",Q1
36091,2020-04-27,230163,4,7,343,116,4719,12.285714285714286,195.57142857142858,5.337832008495843,84.97083743756754,"(3.999, 24.0]",Q1
36091,2020-04-28,230163,4,3,346,125,4844,11.714285714285714,199.0,5.089560752286733,86.4604649748222,"(3.999, 24.0]",Q1
36091,2020-04-29,230163,4,8,354,195,5039,12.714285714285714,219.42857142857142,5.524035450652674,95.33616238429782,"(3.999, 24.0]",Q1
36091,2020-04-30,230163,4,4,358,171,5210,11.428571428571429,225.71428571428572,4.965425124182179,98.06714620259804,"(3.999, 24.0]",Q1
36091,2020-05-01,230163,4,3,361,173,5383,5.857142857142857,158.71428571428572,2.5447803761433665,68.95734141208001,"(3.999, 24.0]",Q1
36091,2020-05-02,230163,4,2,363,203,5586,4.714285714285714,156.71428571428572,2.0482378637251486,68.08839201534813,"(3.999, 24.0]",Q1
36091,2020-05-03,230163,4,4,367,103,5689,4.428571428571429,155.14285714285714,1.9241022356205943,67.40564606077308,"(3.999, 24.0]",Q1
36091,2020-05-04,230163,4,1,368,115,5804,3.5714285714285716,155.0,1.551695351306931,67.3435782467208,"(3.999, 24.0]",Q1
36091,2020-05-05,230163,4,3,371,173,5977,3.5714285714285716,161.85714285714286,1.551695351306931,70.32283332123012,"(3.999, 24.0]",Q1
36091,2020-05-06,230163,4,3,374,157,6134,2.857142857142857,156.42857142857142,1.2413562810455447,67.96425638724357,"(3.999, 24.0]",Q1
36091,2020-05-07,230163,4,14,388,174,6308,4.285714285714286,156.85714285714286,1.8620344215683169,68.1504598294004,"(3.999, 24.0]",Q1
36091,2020-05-08,230163,4,11,399,179,6487,5.428571428571429,157.71428571428572,2.358576933986535,68.52286671371408,"(3.999, 24.0]",Q1
36091,2020-05-09,230163,4,3,402,183,6670,5.571428571428571,154.85714285714286,2.420644748038812,67.28151043266853,"(3.999, 24.0]",Q1
36091,2020-05-10,230163,4,1,403,170,6840,5.142857142857143,164.42857142857142,2.2344413058819805,71.4400539741711,"(3.999, 24.0]",Q1
36091,2020-05-11,230163,4,4,407,154,6994,5.571428571428571,170.0,2.420644748038812,73.86069872220992,"(3.999, 24.0]",Q1
36091,2020-05-12,230163,4,3,410,196,7190,5.571428571428571,173.28571428571428,2.420644748038812,75.28825844541228,"(3.999, 24.0]",Q1
36091,2020-05-13,230163,4,5,415,280,7470,5.857142857142857,190.85714285714286,2.5447803761433665,82.92259957384239,"(3.999, 24.0]",Q1
36091,2020-05-14,230163,4,6,421,266,7736,4.714285714285714,204.0,2.0482378637251486,88.63283846665189,"(3.999, 24.0]",Q1
36091,2020-05-15,230163,4,2,423,358,8094,3.4285714285714284,229.57142857142858,1.4896275372546535,99.74297718200953,"(3.999, 24.0]",Q1
36091,2020-05-16,230163,4,5,428,560,8654,3.7142857142857144,283.42857142857144,1.6137631653592084,123.14254307971804,"(3.999, 24.0]",Q1
36091,2020-05-17,230163,4,6,434,242,8896,4.428571428571429,293.7142857142857,1.9241022356205943,127.611425691482,"(3.999, 24.0]",Q1
36091,2020-05-18,230163,4,2,436,139,9035,4.142857142857143,291.57142857142856,1.79996660751604,126.68040848069784,"(3.999, 24.0]",Q1
36091,2020-05-19,230163,4,2,438,267,9302,4.0,301.7142857142857,1.7378987934637626,131.0872232784095,"(3.999, 24.0]",Q1
36091,2020-05-20,230163,4,2,440,458,9760,3.5714285714285716,327.14285714285717,1.551695351306931,142.1352941797149,"(3.999, 24.0]",Q1
36091,2020-05-21,230163,4,8,448,351,10111,3.857142857142857,339.2857142857143,1.6758309794114854,147.41105837415844,"(3.999, 24.0]",Q1
36091,2020-05-22,230163,4,4,452,254,10365,4.142857142857143,324.42857142857144,1.79996660751604,140.9560057127216,"(3.999, 24.0]",Q1
36091,2020-05-23,230163,4,4,456,316,10681,4.0,289.57142857142856,1.7378987934637626,125.81145908396596,"(3.999, 24.0]",Q1
36091,2020-05-24,230163,4,5,461,185,10866,3.857142857142857,281.42857142857144,1.6758309794114854,122.27359368298617,"(3.999, 24.0]",Q1
36091,2020-05-25,230163,4,2,463,312,11178,3.857142857142857,306.14285714285717,1.6758309794114854,133.01132551403012,"(3.999, 24.0]",Q1
36091,2020-05-26,230163,4,2,465,285,11463,3.857142857142857,308.7142857142857,1.6758309794114854,134.12854616697112,"(3.999, 24.0]",Q1
36091,2020-05-27,230163,4,3,468,292,11755,4.0,285.0,1.7378987934637626,123.82528903429309,"(3.999, 24.0]",Q1
36091,2020-05-28,230163,4,5,473,511,12266,3.5714285714285716,307.85714285714283,1.551695351306931,133.75613928265744,"(3.999, 24.0]",Q1
36091,2020-05-29,230163,4,4,477,518,12784,3.5714285714285716,345.57142857142856,1.551695351306931,150.14204219245863,"(3.999, 24.0]",Q1
36091,2020-05-30,230163,4,3,480,399,13183,3.4285714285714284,357.42857142857144,1.4896275372546535,155.29367075879765,"(3.999, 24.0]",Q1
36091,2020-05-31,230163,4,3,483,487,13670,3.142857142857143,400.57142857142856,1.3654919091500992,174.03815060258538,"(3.999, 24.0]",Q1
36091,2020-06-01,230163,4,1,484,317,13987,3.0,401.2857142857143,1.303424095097822,174.34848967284674,"(3.999, 24.0]",Q1
36091,2020-06-02,230163,4,5,489,609,14596,3.4285714285714284,447.57142857142856,1.4896275372546535,194.45846142578458,"(3.999, 24.0]",Q1
36091,2020-06-03,230163,4,4,493,741,15337,3.5714285714285716,511.7142857142857,1.551695351306931,222.32690993525708,"(3.999, 24.0]",Q1
36091,2020-06-04,230163,4,3,496,574,15911,3.2857142857142856,520.7142857142857,1.4275597232023765,226.2371822205505,"(3.999, 24.0]",Q1
36091,2020-06-05,230163,4,5,501,610,16521,3.4285714285714284,533.8571428571429,1.4896275372546535,231.94742111336004,"(3.999, 24.0]",Q1
36091,2020-06-06,230163,4,1,502,520,17041,3.142857142857143,551.1428571428571,1.3654919091500992,239.4576266136856,"(3.999, 24.0]",Q1
36091,2020-06-07,230163,4,2,504,654,17695,3.0,575.0,1.303424095097822,249.82295156041585,"(3.999, 24.0]",Q1
36093,2020-03-02,155350,27,0,0,0,0,0.0,0.0,0.0,0.0,"(24.0, 37.5]",Q2
36093,2020-03-03,155350,27,0,0,0,0,0.0,0.0,0.0,0.0,"(24.0, 37.5]",Q2
36093,2020-03-04,155350,27,0,0,0,0,0.0,0.0,0.0,0.0,"(24.0, 37.5]",Q2
36093,2020-03-05,155350,27,0,0,0,0,0.0,0.0,0.0,0.0,"(24.0, 37.5]",Q2
36093,2020-03-06,155350,27,0,0,0,0,0.0,0.0,0.0,0.0,"(24.0, 37.5]",Q2
36093,2020-03-07,155350,27,0,0,0,0,0.0,0.0,0.0,0.0,"(24.0, 37.5]",Q2
36093,2020-03-08,155350,27,0,0,1,1,0.0,0.14285714285714285,0.0,0.09195825095406684,"(24.0, 37.5]",Q2
36093,2020-03-09,155350,27,0,0,2,3,0.0,0.42857142857142855,0.0,0.27587475286220053,"(24.0, 37.5]",Q2
36093,2020-03-10,155350,27,0,0,0,3,0.0,0.42857142857142855,0.0,0.27587475286220053,"(24.0, 37.5]",Q2
36093,2020-03-11,155350,27,0,0,12,15,0.0,2.142857142857143,0.0,1.3793737643110027,"(24.0, 37.5]",Q2
36093,2020-03-12,155350,27,0,0,5,20,0.0,2.857142857142857,0.0,1.8391650190813371,"(24.0, 37.5]",Q2
36093,2020-03-13,155350,27,1,1,20,40,0.14285714285714285,5.714285714285714,0.09195825095406684,3.6783300381626742,"(24.0, 37.5]",Q2
36093,2020-03-14,155350,27,1,2,54,94,0.2857142857142857,13.428571428571429,0.1839165019081337,8.644075589682284,"(24.0, 37.5]",Q2
36093,2020-03-15,155350,27,2,4,42,136,0.5714285714285714,19.285714285714285,0.3678330038162674,12.414363878799026,"(24.0, 37.5]",Q2
36093,2020-03-16,155350,27,1,5,27,163,0.7142857142857143,22.857142857142858,0.4597912547703343,14.713320152650697,"(24.0, 37.5]",Q2
36093,2020-03-17,155350,27,9,14,98,261,2.0,36.857142857142854,1.2874155133569358,23.725228746149245,"(24.0, 37.5]",Q2
36093,2020-03-18,155350,27,4,18,131,392,2.5714285714285716,53.857142857142854,1.6552485171732034,34.6682606096832,"(24.0, 37.5]",Q2
36093,2020-03-19,155350,27,3,21,115,507,3.0,69.57142857142857,1.931123270035404,44.78366821463055,"(24.0, 37.5]",Q2
36093,2020-03-20,155350,27,11,32,157,664,4.428571428571429,89.14285714285714,2.8507057795760726,57.38194859533772,"(24.0, 37.5]",Q2
36093,2020-03-21,155350,27,7,39,123,787,5.285714285714286,99.0,3.4024552853004733,63.727067911168334,"(24.0, 37.5]",Q2
36093,2020-03-22,155350,27,5,44,62,849,5.714285714285714,101.85714285714286,3.6783300381626742,65.56623293024967,"(24.0, 37.5]",Q2
36093,2020-03-23,155350,27,2,46,50,899,5.857142857142857,105.14285714285714,3.7702882891167406,67.6812727021932,"(24.0, 37.5]",Q2
36093,2020-03-24,155350,27,9,55,53,952,5.857142857142857,98.71428571428571,3.7702882891167406,63.54315140926019,"(24.0, 37.5]",Q2
36093,2020-03-25,155350,27,7,62,32,984,6.285714285714286,84.57142857142857,4.046163041978941,54.43928456480757,"(24.0, 37.5]",Q2
36093,2020-03-26,155350,27,4,66,41,1025,6.428571428571429,74.0,4.1381212929330085,47.634373994206626,"(24.0, 37.5]",Q2
36093,2020-03-27,155350,27,6,72,43,1068,5.714285714285714,57.714285714285715,3.6783300381626742,37.15113338544301,"(24.0, 37.5]",Q2
36093,2020-03-28,155350,27,4,76,28,1096,5.285714285714286,44.142857142857146,3.4024552853004733,28.415099544806658,"(24.0, 37.5]",Q2
36093,2020-03-29,155350,27,4,80,12,1108,5.142857142857143,37.0,3.310497034346407,23.817186997103313,"(24.0, 37.5]",Q2
36093,2020-03-30,155350,27,5,85,33,1141,5.571428571428571,34.57142857142857,3.5863717872086074,22.253896730884176,"(24.0, 37.5]",Q2
36093,2020-03-31,155350,27,8,93,22,1163,5.428571428571429,30.142857142857142,3.494413536254541,19.403190951308105,"(24.0, 37.5]",Q2
36093,2020-04-01,155350,27,8,101,31,1194,5.571428571428571,30.0,3.5863717872086074,19.31123270035404,"(24.0, 37.5]",Q2
36093,2020-04-02,155350,27,9,110,42,1236,6.285714285714286,30.142857142857142,4.046163041978941,19.403190951308105,"(24.0, 37.5]",Q2
36093,2020-04-03,155350,27,7,117,38,1274,6.428571428571429,29.428571428571427,4.1381212929330085,18.94339969653777,"(24.0, 37.5]",Q2
36093,2020-04-04,155350,27,11,128,64,1338,7.428571428571429,34.57142857142857,4.781829049611477,22.253896730884176,"(24.0, 37.5]",Q2
36093,2020-04-05,155350,27,10,138,64,1402,8.285714285714286,42.0,5.333578555335878,27.035725780495657,"(24.0, 37.5]",Q2
36093,2020-04-06,155350,27,7,145,35,1437,8.571428571428571,42.285714285714285,5.517495057244011,27.219642282403786,"(24.0, 37.5]",Q2
36093,2020-04-07,155350,27,4,149,23,1460,8.0,42.42857142857143,5.149662053427743,27.311600533357858,"(24.0, 37.5]",Q2
36093,2020-04-08,155350,27,18,167,104,1564,9.428571428571429,52.857142857142854,6.069244562968412,34.024552853004735,"(24.0, 37.5]",Q2
36093,2020-04-09,155350,27,24,191,183,1747,11.571428571428571,73.0,7.448618327279415,46.99066623752816,"(24.0, 37.5]",Q2
36093,2020-04-10,155350,27,3,194,24,1771,11.0,71.0,7.080785323463148,45.70325072417123,"(24.0, 37.5]",Q2
36093,2020-04-11,155350,27,5,199,27,1798,10.142857142857142,65.71428571428571,6.529035817738747,42.30079543887075,"(24.0, 37.5]",Q2
36093,2020-04-12,155350,27,5,204,27,1825,9.428571428571429,60.42857142857143,6.069244562968412,38.89834015357028,"(24.0, 37.5]",Q2
36093,2020-04-13,155350,27,31,235,232,2057,12.857142857142858,88.57142857142857,8.276242585866017,57.014115591521445,"(24.0, 37.5]",Q2
36093,2020-04-14,155350,27,2,237,18,2075,12.571428571428571,87.85714285714286,8.092326083957882,56.55432433675112,"(24.0, 37.5]",Q2
36093,2020-04-15,155350,27,8,245,45,2120,11.142857142857142,79.42857142857143,7.172743574417215,51.12878753046117,"(24.0, 37.5]",Q2
36093,2020-04-16,155350,27,5,250,35,2155,8.428571428571429,58.285714285714285,5.425536806289945,37.518966389259276,"(24.0, 37.5]",Q2
36093,2020-04-17,155350,27,9,259,38,2193,9.285714285714286,60.285714285714285,5.977286312014346,38.80638190261621,"(24.0, 37.5]",Q2
36093,2020-04-18,155350,27,9,268,36,2229,9.857142857142858,61.57142857142857,6.345119315830614,39.63400616120281,"(24.0, 37.5]",Q2
36093,2020-04-19,155350,27,1,269,23,2252,9.285714285714286,61.0,5.977286312014346,39.26617315738655,"(24.0, 37.5]",Q2
36093,2020-04-20,155350,27,4,273,23,2275,5.428571428571429,31.142857142857142,3.494413536254541,20.046898707986575,"(24.0, 37.5]",Q2
36093,2020-04-21,155350,27,7,280,24,2299,6.142857142857143,32.0,3.9542047910248748,20.598648213710973,"(24.0, 37.5]",Q2
36093,2020-04-22,155350,27,8,288,47,2346,6.142857142857143,32.285714285714285,3.9542047910248748,20.782564715619106,"(24.0, 37.5]",Q2
36093,2020-04-23,155350,27,9,297,33,2379,6.714285714285714,32.0,4.322037794841142,20.598648213710973,"(24.0, 37.5]",Q2
36093,2020-04-24,155350,27,134,431,964,3343,24.571428571428573,164.28571428571428,15.816819164099499,105.75198859717689,"(24.0, 37.5]",Q2
36093,2020-04-25,155350,27,18,449,186,3529,25.857142857142858,185.71428571428572,16.644443422686102,119.54572624028692,"(24.0, 37.5]",Q2
36093,2020-04-26,155350,27,8,457,96,3625,26.857142857142858,196.14285714285714,17.28815117936457,126.2586785599338,"(24.0, 37.5]",Q2
36093,2020-04-27,155350,27,12,469,119,3744,28.0,209.85714285714286,18.023817186997103,135.08667065152423,"(24.0, 37.5]",Q2
36093,2020-04-28,155350,27,10,479,184,3928,28.428571428571427,232.71428571428572,18.299691939859304,149.7999908041749,"(24.0, 37.5]",Q2
36093,2020-04-29,155350,27,22,501,246,4174,30.428571428571427,261.14285714285717,19.58710745321624,168.09968274403423,"(24.0, 37.5]",Q2
36093,2020-04-30,155350,27,13,514,195,4369,31.0,284.2857142857143,19.954940457032507,182.99691939859304,"(24.0, 37.5]",Q2
36093,2020-05-01,155350,27,7,521,194,4563,12.857142857142858,174.28571428571428,8.276242585866017,112.18906616396157,"(24.0, 37.5]",Q2
36093,2020-05-02,155350,27,6,527,146,4709,11.142857142857142,168.57142857142858,7.172743574417215,108.51073612579889,"(24.0, 37.5]",Q2
36093,2020-05-03,155350,27,8,535,126,4835,11.142857142857142,172.85714285714286,7.172743574417215,111.2694836544209,"(24.0, 37.5]",Q2
36093,2020-05-04,155350,27,2,537,98,4933,9.714285714285714,169.85714285714286,6.253161064876545,109.3383603843855,"(24.0, 37.5]",Q2
36093,2020-05-05,155350,27,14,551,178,5111,10.285714285714286,169.0,6.620994068692814,108.78661087866108,"(24.0, 37.5]",Q2
36093,2020-05-06,155350,27,0,551,194,5305,7.142857142857143,161.57142857142858,4.597912547703343,104.00478182904962,"(24.0, 37.5]",Q2
36093,2020-05-07,155350,27,7,558,144,5449,6.285714285714286,154.28571428571428,4.046163041978941,99.31491103039221,"(24.0, 37.5]",Q2
36093,2020-05-08,155350,27,13,571,204,5653,7.142857142857143,155.71428571428572,4.597912547703343,100.23449353993288,"(24.0, 37.5]",Q2
36093,2020-05-09,155350,27,0,571,199,5852,6.285714285714286,163.28571428571428,4.046163041978941,105.10828084049841,"(24.0, 37.5]",Q2
36093,2020-05-10,155350,27,4,575,113,5965,5.714285714285714,161.42857142857142,3.6783300381626742,103.91282357809554,"(24.0, 37.5]",Q2
36093,2020-05-11,155350,27,6,581,102,6067,6.285714285714286,162.0,4.046163041978941,104.28065658191181,"(24.0, 37.5]",Q2
36093,2020-05-12,155350,27,6,587,164,6231,5.142857142857143,160.0,3.310497034346407,102.99324106855488,"(24.0, 37.5]",Q2
36093,2020-05-13,155350,27,10,597,276,6507,6.571428571428571,171.71428571428572,4.230079543887075,110.53381764678836,"(24.0, 37.5]",Q2
36093,2020-05-14,155350,27,6,603,170,6677,6.428571428571429,175.42857142857142,4.1381212929330085,112.92473217159409,"(24.0, 37.5]",Q2
36093,2020-05-15,155350,27,10,613,272,6949,6.0,185.14285714285714,3.862246540070808,119.17789323647064,"(24.0, 37.5]",Q2
36093,2020-05-16,155350,27,7,620,175,7124,7.0,181.71428571428572,4.505954296749276,116.97089521357304,"(24.0, 37.5]",Q2
36093,2020-05-17,155350,27,9,629,233,7357,7.714285714285714,198.85714285714286,4.9657455515196105,128.00588532806105,"(24.0, 37.5]",Q2
36093,2020-05-18,155350,27,2,631,83,7440,7.142857142857143,196.14285714285714,4.597912547703343,126.2586785599338,"(24.0, 37.5]",Q2
36093,2020-05-19,155350,27,2,633,392,7832,6.571428571428571,228.71428571428572,4.230079543887075,147.22515977746104,"(24.0, 37.5]",Q2
36093,2020-05-20,155350,27,5,638,378,8210,5.857142857142857,243.28571428571428,3.7702882891167406,156.60490137477584,"(24.0, 37.5]",Q2
36093,2020-05-21,155350,27,7,645,667,8877,6.0,314.2857142857143,3.862246540070808,202.30815209894706,"(24.0, 37.5]",Q2
36093,2020-05-22,155350,27,3,648,248,9125,5.0,310.85714285714283,3.21853878339234,200.10115407604945,"(24.0, 37.5]",Q2
36093,2020-05-23,155350,27,10,658,641,9766,5.428571428571429,377.42857142857144,3.494413536254541,242.95369902064462,"(24.0, 37.5]",Q2
36093,2020-05-24,155350,27,6,664,340,10106,5.0,392.7142857142857,3.21853878339234,252.79323187272976,"(24.0, 37.5]",Q2
36093,2020-05-25,155350,27,4,668,143,10249,5.285714285714286,401.2857142857143,3.4024552853004733,258.3107269299738,"(24.0, 37.5]",Q2
36093,2020-05-26,155350,27,5,673,243,10492,5.714285714285714,380.0,3.6783300381626742,244.60894753781784,"(24.0, 37.5]",Q2
36093,2020-05-27,155350,27,3,676,485,10977,5.428571428571429,395.2857142857143,3.494413536254541,254.44848038990298,"(24.0, 37.5]",Q2
36093,2020-05-28,155350,27,4,680,792,11769,5.0,413.14285714285717,3.21853878339234,265.9432617591614,"(24.0, 37.5]",Q2
36093,2020-05-29,155350,27,6,686,477,12246,5.428571428571429,445.85714285714283,3.494413536254541,287.0017012276426,"(24.0, 37.5]",Q2
36093,2020-05-30,155350,27,3,689,324,12570,4.428571428571429,400.57142857142856,2.8507057795760726,257.8509356752034,"(24.0, 37.5]",Q2
36093,2020-05-31,155350,27,4,693,482,13052,4.142857142857143,420.85714285714283,2.666789277667939,270.9090073106809,"(24.0, 37.5]",Q2
36093,2020-06-01,155350,27,3,696,481,13533,4.0,469.14285714285717,2.5748310267138717,301.99089613315556,"(24.0, 37.5]",Q2
36093,2020-06-02,155350,27,5,701,406,13939,4.0,492.42857142857144,2.5748310267138717,316.98009103866843,"(24.0, 37.5]",Q2
36093,2020-06-03,155350,27,0,701,565,14504,3.5714285714285716,503.85714285714283,2.2989562738516716,324.3367511149938,"(24.0, 37.5]",Q2
36093,2020-06-04,155350,27,5,706,802,15306,3.7142857142857144,505.2857142857143,2.3909145248057384,325.2563336245344,"(24.0, 37.5]",Q2
36093,2020-06-05,155350,27,4,710,497,15803,3.4285714285714284,508.14285714285717,2.2069980228976043,327.09549864361577,"(24.0, 37.5]",Q2
36093,2020-06-06,155350,27,1,711,579,16382,3.142857142857143,544.5714285714286,2.0230815209894706,350.5448526369028,"(24.0, 37.5]",Q2
36093,2020-06-07,155350,27,1,712,533,16915,2.7142857142857144,551.8571428571429,1.7472067681272705,355.2347234355603,"(24.0, 37.5]",Q2
36095,2020-03-02,31097,26,0,0,0,0,0.0,0.0,0.0,0.0,"(24.0, 37.5]",Q2
36095,2020-03-03,31097,26,0,0,0,0,0.0,0.0,0.0,0.0,"(24.0, 37.5]",Q2
36095,2020-03-04,31097,26,0,0,0,0,0.0,0.0,0.0,0.0,"(24.0, 37.5]",Q2
36095,2020-03-05,31097,26,0,0,0,0,0.0,0.0,0.0,0.0,"(24.0, 37.5]",Q2
36095,2020-03-06,31097,26,0,0,0,0,0.0,0.0,0.0,0.0,"(24.0, 37.5]",Q2
36095,2020-03-07,31097,26,0,0,0,0,0.0,0.0,0.0,0.0,"(24.0, 37.5]",Q2
36095,2020-03-08,31097,26,0,0,0,0,0.0,0.0,0.0,0.0,"(24.0, 37.5]",Q2
36095,2020-03-09,31097,26,0,0,0,0,0.0,0.0,0.0,0.0,"(24.0, 37.5]",Q2
36095,2020-03-10,31097,26,0,0,0,0,0.0,0.0,0.0,0.0,"(24.0, 37.5]",Q2
36095,2020-03-11,31097,26,0,0,2,2,0.0,0.2857142857142857,0.0,0.9187840811470099,"(24.0, 37.5]",Q2
36095,2020-03-12,31097,26,0,0,1,3,0.0,0.42857142857142855,0.0,1.378176121720515,"(24.0, 37.5]",Q2
36095,2020-03-13,31097,26,0,0,0,3,0.0,0.42857142857142855,0.0,1.378176121720515,"(24.0, 37.5]",Q2
36095,2020-03-14,31097,26,0,0,0,3,0.0,0.42857142857142855,0.0,1.378176121720515,"(24.0, 37.5]",Q2
36095,2020-03-15,31097,26,0,0,0,3,0.0,0.42857142857142855,0.0,1.378176121720515,"(24.0, 37.5]",Q2
36095,2020-03-16,31097,26,0,0,0,3,0.0,0.42857142857142855,0.0,1.378176121720515,"(24.0, 37.5]",Q2
36095,2020-03-17,31097,26,0,0,8,11,0.0,1.5714285714285714,0.0,5.0533124463085555,"(24.0, 37.5]",Q2
36095,2020-03-18,31097,26,1,1,8,19,0.14285714285714285,2.4285714285714284,0.45939204057350497,7.809664689749585,"(24.0, 37.5]",Q2
36095,2020-03-19,31097,26,0,1,10,29,0.14285714285714285,3.7142857142857144,0.45939204057350497,11.944193054911132,"(24.0, 37.5]",Q2
36095,2020-03-20,31097,26,0,1,16,45,0.14285714285714285,6.0,0.45939204057350497,19.294465704087212,"(24.0, 37.5]",Q2
36095,2020-03-21,31097,26,0,1,6,51,0.14285714285714285,6.857142857142857,0.45939204057350497,22.05081794752824,"(24.0, 37.5]",Q2
36095,2020-03-22,31097,26,0,1,3,54,0.14285714285714285,7.285714285714286,0.45939204057350497,23.428994069248755,"(24.0, 37.5]",Q2
36095,2020-03-23,31097,26,0,1,1,55,0.14285714285714285,7.428571428571429,0.45939204057350497,23.888386109822264,"(24.0, 37.5]",Q2
36095,2020-03-24,31097,26,1,2,3,58,0.2857142857142857,6.714285714285714,0.9187840811470099,21.591425906954736,"(24.0, 37.5]",Q2
36095,2020-03-25,31097,26,0,2,2,60,0.14285714285714285,5.857142857142857,0.45939204057350497,18.835073663513704,"(24.0, 37.5]",Q2
36095,2020-03-26,31097,26,1,3,3,63,0.2857142857142857,4.857142857142857,0.9187840811470099,15.61932937949917,"(24.0, 37.5]",Q2
36095,2020-03-27,31097,26,2,5,9,72,0.5714285714285714,3.857142857142857,1.8375681622940199,12.403585095484637,"(24.0, 37.5]",Q2
36095,2020-03-28,31097,26,0,5,5,77,0.5714285714285714,3.7142857142857144,1.8375681622940199,11.944193054911132,"(24.0, 37.5]",Q2
36095,2020-03-29,31097,26,1,6,3,80,0.7142857142857143,3.7142857142857144,2.296960202867525,11.944193054911132,"(24.0, 37.5]",Q2
36095,2020-03-30,31097,26,0,6,4,84,0.7142857142857143,4.142857142857143,2.296960202867525,13.322369176631648,"(24.0, 37.5]",Q2
36095,2020-03-31,31097,26,2,8,7,91,0.8571428571428571,4.714285714285714,2.75635224344103,15.159937338925667,"(24.0, 37.5]",Q2
36095,2020-04-01,31097,26,0,8,10,101,0.8571428571428571,5.857142857142857,2.75635224344103,18.835073663513704,"(24.0, 37.5]",Q2
36095,2020-04-02,31097,26,1,9,5,106,0.8571428571428571,6.142857142857143,2.75635224344103,19.753857744660717,"(24.0, 37.5]",Q2
36095,2020-04-03,31097,26,1,10,21,127,0.7142857142857143,7.857142857142857,2.296960202867525,25.26656223154278,"(24.0, 37.5]",Q2
36095,2020-04-04,31097,26,1,11,16,143,0.8571428571428571,9.428571428571429,2.75635224344103,30.319874677851335,"(24.0, 37.5]",Q2
36095,2020-04-05,31097,26,0,11,17,160,0.7142857142857143,11.428571428571429,2.296960202867525,36.7513632458804,"(24.0, 37.5]",Q2
36095,2020-04-06,31097,26,1,12,19,179,0.8571428571428571,13.571428571428571,2.75635224344103,43.64224385448298,"(24.0, 37.5]",Q2
36095,2020-04-07,31097,26,0,12,20,199,0.5714285714285714,15.428571428571429,1.8375681622940199,49.61434038193855,"(24.0, 37.5]",Q2
36095,2020-04-08,31097,26,0,12,8,207,0.5714285714285714,15.142857142857142,1.8375681622940199,48.69555630079153,"(24.0, 37.5]",Q2
36095,2020-04-09,31097,26,0,12,16,223,0.42857142857142855,16.714285714285715,1.378176121720515,53.7488687471001,"(24.0, 37.5]",Q2
36095,2020-04-10,31097,26,0,12,5,228,0.2857142857142857,14.428571428571429,0.9187840811470099,46.398596097924006,"(24.0, 37.5]",Q2
36095,2020-04-11,31097,26,0,12,2,230,0.14285714285714285,12.428571428571429,0.45939204057350497,39.96710752989494,"(24.0, 37.5]",Q2
36095,2020-04-12,31097,26,0,12,4,234,0.14285714285714285,10.571428571428571,0.45939204057350497,33.99501100243937,"(24.0, 37.5]",Q2
36095,2020-04-13,31097,26,8,20,59,293,1.1428571428571428,16.285714285714285,3.6751363245880397,52.37069262537956,"(24.0, 37.5]",Q2
36095,2020-04-14,31097,26,0,20,1,294,1.1428571428571428,13.571428571428571,3.6751363245880397,43.64224385448298,"(24.0, 37.5]",Q2
36095,2020-04-15,31097,26,0,20,5,299,1.1428571428571428,13.142857142857142,3.6751363245880397,42.26406773276246,"(24.0, 37.5]",Q2
36095,2020-04-16,31097,26,0,20,0,299,1.1428571428571428,10.857142857142858,3.6751363245880397,34.913795083586386,"(24.0, 37.5]",Q2
36095,2020-04-17,31097,26,0,20,1,300,1.1428571428571428,10.285714285714286,3.6751363245880397,33.07622692129236,"(24.0, 37.5]",Q2
36095,2020-04-18,31097,26,0,20,2,302,1.1428571428571428,10.285714285714286,3.6751363245880397,33.07622692129236,"(24.0, 37.5]",Q2
36095,2020-04-19,31097,26,0,20,4,306,1.1428571428571428,10.285714285714286,3.6751363245880397,33.07622692129236,"(24.0, 37.5]",Q2
36095,2020-04-20,31097,26,0,20,4,310,0.0,2.4285714285714284,0.0,7.809664689749585,"(24.0, 37.5]",Q2
36095,2020-04-21,31097,26,0,20,0,310,0.0,2.2857142857142856,0.0,7.3502726491760795,"(24.0, 37.5]",Q2
36095,2020-04-22,31097,26,1,21,8,318,0.14285714285714285,2.7142857142857144,0.45939204057350497,8.728448770896597,"(24.0, 37.5]",Q2
36095,2020-04-23,31097,26,0,21,13,331,0.14285714285714285,4.571428571428571,0.45939204057350497,14.700545298352159,"(24.0, 37.5]",Q2
36095,2020-04-24,31097,26,12,33,177,508,1.8571428571428572,29.714285714285715,5.972096527455566,95.55354443928906,"(24.0, 37.5]",Q2
36095,2020-04-25,31097,26,2,35,29,537,2.142857142857143,33.57142857142857,6.890880608602576,107.95712953477369,"(24.0, 37.5]",Q2
36095,2020-04-26,31097,26,0,35,15,552,2.142857142857143,35.142857142857146,6.890880608602576,113.01044198108224,"(24.0, 37.5]",Q2
36095,2020-04-27,31097,26,3,38,19,571,2.5714285714285716,37.285714285714285,8.26905673032309,119.90132258968482,"(24.0, 37.5]",Q2
36095,2020-04-28,31097,26,1,39,21,592,2.7142857142857144,40.285714285714285,8.728448770896597,129.5485554417284,"(24.0, 37.5]",Q2
36095,2020-04-29,31097,26,3,42,17,609,3.0,41.57142857142857,9.647232852043606,133.68308380688995,"(24.0, 37.5]",Q2
36095,2020-04-30,31097,26,1,43,24,633,3.142857142857143,43.142857142857146,10.106624892617111,138.73639625319854,"(24.0, 37.5]",Q2
36095,2020-05-01,31097,26,0,43,16,649,1.4285714285714286,20.142857142857142,4.59392040573505,64.7742777208642,"(24.0, 37.5]",Q2
36095,2020-05-02,31097,26,2,45,20,669,1.4285714285714286,18.857142857142858,4.59392040573505,60.63974935570267,"(24.0, 37.5]",Q2
36095,2020-05-03,31097,26,0,45,21,690,1.4285714285714286,19.714285714285715,4.59392040573505,63.3961015991437,"(24.0, 37.5]",Q2
36095,2020-05-04,31097,26,0,45,29,719,1.0,21.142857142857142,3.215744284014535,67.99002200487874,"(24.0, 37.5]",Q2
36095,2020-05-05,31097,26,0,45,29,748,0.8571428571428571,22.285714285714285,2.75635224344103,71.66515832946678,"(24.0, 37.5]",Q2
36095,2020-05-06,31097,26,0,45,20,768,0.42857142857142855,22.714285714285715,1.378176121720515,73.04333445118729,"(24.0, 37.5]",Q2
36095,2020-05-07,31097,26,0,45,15,783,0.2857142857142857,21.428571428571427,0.9187840811470099,68.90880608602575,"(24.0, 37.5]",Q2
36095,2020-05-08,31097,26,1,46,32,815,0.42857142857142855,23.714285714285715,1.378176121720515,76.25907873520184,"(24.0, 37.5]",Q2
36095,2020-05-09,31097,26,0,46,23,838,0.14285714285714285,24.142857142857142,0.45939204057350497,77.63725485692234,"(24.0, 37.5]",Q2
36095,2020-05-10,31097,26,0,46,19,857,0.14285714285714285,23.857142857142858,0.45939204057350497,76.71847077577534,"(24.0, 37.5]",Q2
36095,2020-05-11,31097,26,0,46,32,889,0.14285714285714285,24.285714285714285,0.45939204057350497,78.09664689749584,"(24.0, 37.5]",Q2
36095,2020-05-12,31097,26,1,47,27,916,0.2857142857142857,24.0,0.9187840811470099,77.17786281634885,"(24.0, 37.5]",Q2
36095,2020-05-13,31097,26,0,47,32,948,0.2857142857142857,25.714285714285715,0.9187840811470099,82.6905673032309,"(24.0, 37.5]",Q2
36095,2020-05-14,31097,26,0,47,8,956,0.2857142857142857,24.714285714285715,0.9187840811470099,79.47482301921637,"(24.0, 37.5]",Q2
36095,2020-05-15,31097,26,0,47,22,978,0.14285714285714285,23.285714285714285,0.45939204057350497,74.88090261348133,"(24.0, 37.5]",Q2
36095,2020-05-16,31097,26,0,47,39,1017,0.14285714285714285,25.571428571428573,0.45939204057350497,82.2311752626574,"(24.0, 37.5]",Q2
36095,2020-05-17,31097,26,1,48,36,1053,0.2857142857142857,28.0,0.9187840811470099,90.04083995240698,"(24.0, 37.5]",Q2
36095,2020-05-18,31097,26,0,48,21,1074,0.2857142857142857,26.428571428571427,0.9187840811470099,84.98752750609842,"(24.0, 37.5]",Q2
36095,2020-05-19,31097,26,0,48,34,1108,0.14285714285714285,27.428571428571427,0.45939204057350497,88.20327179011296,"(24.0, 37.5]",Q2
36095,2020-05-20,31097,26,1,49,33,1141,0.2857142857142857,27.571428571428573,0.9187840811470099,88.66266383068648,"(24.0, 37.5]",Q2
36095,2020-05-21,31097,26,0,49,27,1168,0.2857142857142857,30.285714285714285,0.9187840811470099,97.39111260158306,"(24.0, 37.5]",Q2
36095,2020-05-22,31097,26,0,49,23,1191,0.2857142857142857,30.428571428571427,0.9187840811470099,97.85050464215655,"(24.0, 37.5]",Q2
36095,2020-05-23,31097,26,0,49,29,1220,0.2857142857142857,29.0,0.9187840811470099,93.25658423642152,"(24.0, 37.5]",Q2
36095,2020-05-24,31097,26,0,49,21,1241,0.14285714285714285,26.857142857142858,0.45939204057350497,86.36570362781895,"(24.0, 37.5]",Q2
36095,2020-05-25,31097,26,0,49,12,1253,0.14285714285714285,25.571428571428573,0.45939204057350497,82.2311752626574,"(24.0, 37.5]",Q2
36095,2020-05-26,31097,26,0,49,46,1299,0.14285714285714285,27.285714285714285,0.45939204057350497,87.74387974953946,"(24.0, 37.5]",Q2
36095,2020-05-27,31097,26,0,49,74,1373,0.0,33.142857142857146,0.0,106.57895341305318,"(24.0, 37.5]",Q2
36095,2020-05-28,31097,26,0,49,32,1405,0.0,33.857142857142854,0.0,108.87591361592068,"(24.0, 37.5]",Q2
36095,2020-05-29,31097,26,1,50,32,1437,0.14285714285714285,35.142857142857146,0.45939204057350497,113.01044198108224,"(24.0, 37.5]",Q2
36095,2020-05-30,31097,26,0,50,41,1478,0.14285714285714285,36.857142857142854,0.45939204057350497,118.52314646796428,"(24.0, 37.5]",Q2
36095,2020-05-31,31097,26,0,50,47,1525,0.14285714285714285,40.57142857142857,0.45939204057350497,130.46733952287542,"(24.0, 37.5]",Q2
36095,2020-06-01,31097,26,1,51,39,1564,0.2857142857142857,44.42857142857143,0.9187840811470099,142.87092461836008,"(24.0, 37.5]",Q2
36095,2020-06-02,31097,26,0,51,46,1610,0.2857142857142857,44.42857142857143,0.9187840811470099,142.87092461836008,"(24.0, 37.5]",Q2
36095,2020-06-03,31097,26,0,51,63,1673,0.2857142857142857,42.857142857142854,0.9187840811470099,137.8176121720515,"(24.0, 37.5]",Q2
36095,2020-06-04,31097,26,0,51,60,1733,0.2857142857142857,46.857142857142854,0.9187840811470099,150.68058930810963,"(24.0, 37.5]",Q2
36095,2020-06-05,31097,26,3,54,85,1818,0.5714285714285714,54.42857142857143,1.8375681622940199,175.02836745850541,"(24.0, 37.5]",Q2
36095,2020-06-06,31097,26,0,54,59,1877,0.5714285714285714,57.0,1.8375681622940199,183.2974241888285,"(24.0, 37.5]",Q2
36095,2020-06-07,31097,26,0,54,65,1942,0.5714285714285714,59.57142857142857,1.8375681622940199,191.5664809191516,"(24.0, 37.5]",Q2
36097,2020-03-02,17912,22,0,0,0,0,0.0,0.0,0.0,0.0,"(3.999, 24.0]",Q1
36097,2020-03-03,17912,22,0,0,0,0,0.0,0.0,0.0,0.0,"(3.999, 24.0]",Q1
36097,2020-03-04,17912,22,0,0,0,0,0.0,0.0,0.0,0.0,"(3.999, 24.0]",Q1
36097,2020-03-05,17912,22,0,0,0,0,0.0,0.0,0.0,0.0,"(3.999, 24.0]",Q1
36097,2020-03-06,17912,22,0,0,0,0,0.0,0.0,0.0,0.0,"(3.999, 24.0]",Q1
36097,2020-03-07,17912,22,0,0,0,0,0.0,0.0,0.0,0.0,"(3.999, 24.0]",Q1
36097,2020-03-08,17912,22,0,0,0,0,0.0,0.0,0.0,0.0,"(3.999, 24.0]",Q1
36097,2020-03-09,17912,22,0,0,0,0,0.0,0.0,0.0,0.0,"(3.999, 24.0]",Q1
36097,2020-03-10,17912,22,0,0,0,0,0.0,0.0,0.0,0.0,"(3.999, 24.0]",Q1
36097,2020-03-11,17912,22,0,0,0,0,0.0,0.0,0.0,0.0,"(3.999, 24.0]",Q1
36097,2020-03-12,17912,22,0,0,0,0,0.0,0.0,0.0,0.0,"(3.999, 24.0]",Q1
36097,2020-03-13,17912,22,0,0,0,0,0.0,0.0,0.0,0.0,"(3.999, 24.0]",Q1
36097,2020-03-14,17912,22,0,0,1,1,0.0,0.14285714285714285,0.0,0.7975499266254067,"(3.999, 24.0]",Q1
36097,2020-03-15,17912,22,0,0,1,2,0.0,0.2857142857142857,0.0,1.5950998532508134,"(3.999, 24.0]",Q1
36097,2020-03-16,17912,22,0,0,2,4,0.0,0.5714285714285714,0.0,3.1901997065016268,"(3.999, 24.0]",Q1
36097,2020-03-17,17912,22,0,0,0,4,0.0,0.5714285714285714,0.0,3.1901997065016268,"(3.999, 24.0]",Q1
36097,2020-03-18,17912,22,0,0,1,5,0.0,0.7142857142857143,0.0,3.987749633127034,"(3.999, 24.0]",Q1
36097,2020-03-19,17912,22,0,0,0,5,0.0,0.7142857142857143,0.0,3.987749633127034,"(3.999, 24.0]",Q1
36097,2020-03-20,17912,22,0,0,9,14,0.0,2.0,0.0,11.165698972755694,"(3.999, 24.0]",Q1
36097,2020-03-21,17912,22,0,0,3,17,0.0,2.2857142857142856,0.0,12.760798826006507,"(3.999, 24.0]",Q1
36097,2020-03-22,17912,22,0,0,7,24,0.0,3.142857142857143,0.0,17.54609838575895,"(3.999, 24.0]",Q1
36097,2020-03-23,17912,22,0,0,8,32,0.0,4.0,0.0,22.331397945511387,"(3.999, 24.0]",Q1
36097,2020-03-24,17912,22,0,0,0,32,0.0,4.0,0.0,22.331397945511387,"(3.999, 24.0]",Q1
36097,2020-03-25,17912,22,0,0,1,33,0.0,4.0,0.0,22.331397945511387,"(3.999, 24.0]",Q1
36097,2020-03-26,17912,22,0,0,8,41,0.0,5.142857142857143,0.0,28.711797358514644,"(3.999, 24.0]",Q1
36097,2020-03-27,17912,22,1,1,6,47,0.14285714285714285,4.714285714285714,0.7975499266254067,26.31914757863842,"(3.999, 24.0]",Q1
36097,2020-03-28,17912,22,0,1,7,54,0.14285714285714285,5.285714285714286,0.7975499266254067,29.509347285140045,"(3.999, 24.0]",Q1
36097,2020-03-29,17912,22,1,2,6,60,0.2857142857142857,5.142857142857143,1.5950998532508134,28.711797358514644,"(3.999, 24.0]",Q1
36097,2020-03-30,17912,22,0,2,6,66,0.2857142857142857,4.857142857142857,1.5950998532508134,27.11669750526383,"(3.999, 24.0]",Q1
36097,2020-03-31,17912,22,0,2,1,67,0.2857142857142857,5.0,1.5950998532508134,27.914247431889233,"(3.999, 24.0]",Q1
36097,2020-04-01,17912,22,1,3,8,75,0.42857142857142855,6.0,2.39264977987622,33.49709691826708,"(3.999, 24.0]",Q1
36097,2020-04-02,17912,22,0,3,13,88,0.42857142857142855,6.714285714285714,2.39264977987622,37.48484655139412,"(3.999, 24.0]",Q1
36097,2020-04-03,17912,22,1,4,5,93,0.42857142857142855,6.571428571428571,2.39264977987622,36.687296624768706,"(3.999, 24.0]",Q1
36097,2020-04-04,17912,22,0,4,2,95,0.42857142857142855,5.857142857142857,2.39264977987622,32.699546991641675,"(3.999, 24.0]",Q1
36097,2020-04-05,17912,22,0,4,9,104,0.2857142857142857,6.285714285714286,1.5950998532508134,35.0921967715179,"(3.999, 24.0]",Q1
36097,2020-04-06,17912,22,0,4,4,108,0.2857142857142857,6.0,1.5950998532508134,33.49709691826708,"(3.999, 24.0]",Q1
36097,2020-04-07,17912,22,0,4,12,120,0.2857142857142857,7.571428571428571,1.5950998532508134,42.27014611114656,"(3.999, 24.0]",Q1
36097,2020-04-08,17912,22,0,4,20,140,0.14285714285714285,9.285714285714286,0.7975499266254067,51.84074523065144,"(3.999, 24.0]",Q1
36097,2020-04-09,17912,22,1,5,4,144,0.2857142857142857,8.0,1.5950998532508134,44.662795891022775,"(3.999, 24.0]",Q1
36097,2020-04-10,17912,22,0,5,7,151,0.14285714285714285,8.285714285714286,0.7975499266254067,46.2578957442736,"(3.999, 24.0]",Q1
36097,2020-04-11,17912,22,0,5,1,152,0.14285714285714285,8.142857142857142,0.7975499266254067,45.46034581764818,"(3.999, 24.0]",Q1
36097,2020-04-12,17912,22,0,5,1,153,0.14285714285714285,7.0,0.7975499266254067,39.07994640464493,"(3.999, 24.0]",Q1
36097,2020-04-13,17912,22,1,6,11,164,0.2857142857142857,8.0,1.5950998532508134,44.662795891022775,"(3.999, 24.0]",Q1
36097,2020-04-14,17912,22,0,6,0,164,0.2857142857142857,6.285714285714286,1.5950998532508134,35.0921967715179,"(3.999, 24.0]",Q1
36097,2020-04-15,17912,22,0,6,5,169,0.2857142857142857,4.142857142857143,1.5950998532508134,23.1289478721368,"(3.999, 24.0]",Q1
36097,2020-04-16,17912,22,0,6,8,177,0.14285714285714285,4.714285714285714,0.7975499266254067,26.31914757863842,"(3.999, 24.0]",Q1
36097,2020-04-17,17912,22,0,6,4,181,0.14285714285714285,4.285714285714286,0.7975499266254067,23.926497798762203,"(3.999, 24.0]",Q1
36097,2020-04-18,17912,22,0,6,0,181,0.14285714285714285,4.142857142857143,0.7975499266254067,23.1289478721368,"(3.999, 24.0]",Q1
36097,2020-04-19,17912,22,1,7,4,185,0.2857142857142857,4.571428571428571,1.5950998532508134,25.521597652013014,"(3.999, 24.0]",Q1
36097,2020-04-20,17912,22,0,7,4,189,0.14285714285714285,3.5714285714285716,0.7975499266254067,19.938748165635168,"(3.999, 24.0]",Q1
36097,2020-04-21,17912,22,0,7,10,199,0.14285714285714285,5.0,0.7975499266254067,27.914247431889233,"(3.999, 24.0]",Q1
36097,2020-04-22,17912,22,0,7,108,307,0.14285714285714285,19.714285714285715,0.7975499266254067,110.06188987430613,"(3.999, 24.0]",Q1
36097,2020-04-23,17912,22,0,7,18,325,0.14285714285714285,21.142857142857142,0.7975499266254067,118.03738914056018,"(3.999, 24.0]",Q1
36097,2020-04-24,17912,22,0,7,38,363,0.14285714285714285,26.0,0.7975499266254067,145.15408664582404,"(3.999, 24.0]",Q1
36097,2020-04-25,17912,22,0,7,10,373,0.14285714285714285,27.428571428571427,0.7975499266254067,153.12958591207808,"(3.999, 24.0]",Q1
36097,2020-04-26,17912,22,0,7,9,382,0.0,28.142857142857142,0.0,157.11733554520512,"(3.999, 24.0]",Q1
36097,2020-04-27,17912,22,0,7,8,390,0.0,28.714285714285715,0.0,160.30753525170675,"(3.999, 24.0]",Q1
36097,2020-04-28,17912,22,0,7,15,405,0.0,29.428571428571427,0.0,164.2952848848338,"(3.999, 24.0]",Q1
36097,2020-04-29,17912,22,0,7,7,412,0.0,15.0,0.0,83.74274229566771,"(3.999, 24.0]",Q1
36097,2020-04-30,17912,22,0,7,6,418,0.0,13.285714285714286,0.0,74.17214317616283,"(3.999, 24.0]",Q1
36097,2020-05-01,17912,22,0,7,7,425,0.0,8.857142857142858,0.0,49.44809545077522,"(3.999, 24.0]",Q1
36097,2020-05-02,17912,22,0,7,2,427,0.0,7.714285714285714,0.0,43.06769603777197,"(3.999, 24.0]",Q1
36097,2020-05-03,17912,22,0,7,12,439,0.0,8.142857142857142,0.0,45.46034581764818,"(3.999, 24.0]",Q1
36097,2020-05-04,17912,22,0,7,5,444,0.0,7.714285714285714,0.0,43.06769603777197,"(3.999, 24.0]",Q1
36097,2020-05-05,17912,22,0,7,31,475,0.0,10.0,0.0,55.82849486377847,"(3.999, 24.0]",Q1
36097,2020-05-06,17912,22,0,7,12,487,0.0,10.714285714285714,0.0,59.816244496905504,"(3.999, 24.0]",Q1
36097,2020-05-07,17912,22,0,7,9,496,0.0,11.142857142857142,0.0,62.20889427678173,"(3.999, 24.0]",Q1
36097,2020-05-08,17912,22,0,7,38,534,0.0,15.571428571428571,0.0,86.93294200216934,"(3.999, 24.0]",Q1
36097,2020-05-09,17912,22,0,7,31,565,0.0,19.714285714285715,0.0,110.06188987430613,"(3.999, 24.0]",Q1
36097,2020-05-10,17912,22,0,7,14,579,0.0,20.0,0.0,111.65698972755693,"(3.999, 24.0]",Q1
36097,2020-05-11,17912,22,1,8,17,596,0.14285714285714285,21.714285714285715,0.7975499266254067,121.22758884706184,"(3.999, 24.0]",Q1
36097,2020-05-12,17912,22,0,8,32,628,0.14285714285714285,21.857142857142858,0.7975499266254067,122.02513877368725,"(3.999, 24.0]",Q1
36097,2020-05-13,17912,22,0,8,46,674,0.14285714285714285,26.714285714285715,0.7975499266254067,149.14183627895108,"(3.999, 24.0]",Q1
36097,2020-05-14,17912,22,0,8,18,692,0.14285714285714285,28.0,0.7975499266254067,156.31978561857971,"(3.999, 24.0]",Q1
36097,2020-05-15,17912,22,0,8,52,744,0.14285714285714285,30.0,0.7975499266254067,167.48548459133542,"(3.999, 24.0]",Q1
36097,2020-05-16,17912,22,1,9,32,776,0.2857142857142857,30.142857142857142,1.5950998532508134,168.28303451796083,"(3.999, 24.0]",Q1
36097,2020-05-17,17912,22,1,10,55,831,0.42857142857142855,36.0,2.39264977987622,200.9825815096025,"(3.999, 24.0]",Q1
36097,2020-05-18,17912,22,0,10,57,888,0.2857142857142857,41.714285714285715,1.5950998532508134,232.88457857461876,"(3.999, 24.0]",Q1
36097,2020-05-19,17912,22,0,10,44,932,0.2857142857142857,43.42857142857143,1.5950998532508134,242.45517769412368,"(3.999, 24.0]",Q1
36097,2020-05-20,17912,22,0,10,42,974,0.2857142857142857,42.857142857142854,1.5950998532508134,239.26497798762202,"(3.999, 24.0]",Q1
36097,2020-05-21,17912,22,1,11,49,1023,0.42857142857142855,47.285714285714285,2.39264977987622,263.98902571300965,"(3.999, 24.0]",Q1
36097,2020-05-22,17912,22,0,11,78,1101,0.42857142857142855,51.0,2.39264977987622,284.72532380527025,"(3.999, 24.0]",Q1
36097,2020-05-23,17912,22,0,11,45,1146,0.2857142857142857,52.857142857142854,1.5950998532508134,295.09347285140046,"(3.999, 24.0]",Q1
36097,2020-05-24,17912,22,0,11,52,1198,0.14285714285714285,52.42857142857143,0.7975499266254067,292.70082307152427,"(3.999, 24.0]",Q1
36097,2020-05-25,17912,22,0,11,14,1212,0.14285714285714285,46.285714285714285,0.7975499266254067,258.40617622663177,"(3.999, 24.0]",Q1
36097,2020-05-26,17912,22,0,11,68,1280,0.14285714285714285,49.714285714285715,0.7975499266254067,277.54737446564155,"(3.999, 24.0]",Q1
36097,2020-05-27,17912,22,0,11,41,1321,0.14285714285714285,49.57142857142857,0.7975499266254067,276.7498245390162,"(3.999, 24.0]",Q1
36097,2020-05-28,17912,22,0,11,52,1373,0.0,50.0,0.0,279.14247431889237,"(3.999, 24.0]",Q1
36097,2020-05-29,17912,22,0,11,64,1437,0.0,48.0,0.0,267.97677534613666,"(3.999, 24.0]",Q1
36097,2020-05-30,17912,22,0,11,76,1513,0.0,52.42857142857143,0.0,292.70082307152427,"(3.999, 24.0]",Q1
36097,2020-05-31,17912,22,0,11,30,1543,0.0,49.285714285714285,0.0,275.1547246857653,"(3.999, 24.0]",Q1
36097,2020-06-01,17912,22,1,12,26,1569,0.14285714285714285,51.0,0.7975499266254067,284.72532380527025,"(3.999, 24.0]",Q1
36097,2020-06-02,17912,22,0,12,40,1609,0.14285714285714285,47.0,0.7975499266254067,262.39392585975884,"(3.999, 24.0]",Q1
36097,2020-06-03,17912,22,0,12,22,1631,0.14285714285714285,44.285714285714285,0.7975499266254067,247.2404772538761,"(3.999, 24.0]",Q1
36097,2020-06-04,17912,22,0,12,32,1663,0.14285714285714285,41.42857142857143,0.7975499266254067,231.289478721368,"(3.999, 24.0]",Q1
36097,2020-06-05,17912,22,0,12,139,1802,0.14285714285714285,52.142857142857146,0.7975499266254067,291.10572321827345,"(3.999, 24.0]",Q1
36097,2020-06-06,17912,22,0,12,47,1849,0.14285714285714285,48.0,0.7975499266254067,267.97677534613666,"(3.999, 24.0]",Q1
36097,2020-06-07,17912,22,0,12,45,1894,0.14285714285714285,50.142857142857146,0.7975499266254067,279.9400242455178,"(3.999, 24.0]",Q1
36099,2020-03-02,34300,26,0,0,0,0,0.0,0.0,0.0,0.0,"(24.0, 37.5]",Q2
36099,2020-03-03,34300,26,0,0,0,0,0.0,0.0,0.0,0.0,"(24.0, 37.5]",Q2
36099,2020-03-04,34300,26,0,0,0,0,0.0,0.0,0.0,0.0,"(24.0, 37.5]",Q2
36099,2020-03-05,34300,26,0,0,0,0,0.0,0.0,0.0,0.0,"(24.0, 37.5]",Q2
36099,2020-03-06,34300,26,0,0,0,0,0.0,0.0,0.0,0.0,"(24.0, 37.5]",Q2
36099,2020-03-07,34300,26,0,0,0,0,0.0,0.0,0.0,0.0,"(24.0, 37.5]",Q2
36099,2020-03-08,34300,26,0,0,0,0,0.0,0.0,0.0,0.0,"(24.0, 37.5]",Q2
36099,2020-03-09,34300,26,0,0,0,0,0.0,0.0,0.0,0.0,"(24.0, 37.5]",Q2
36099,2020-03-10,34300,26,0,0,0,0,0.0,0.0,0.0,0.0,"(24.0, 37.5]",Q2
36099,2020-03-11,34300,26,0,0,0,0,0.0,0.0,0.0,0.0,"(24.0, 37.5]",Q2
36099,2020-03-12,34300,26,0,0,0,0,0.0,0.0,0.0,0.0,"(24.0, 37.5]",Q2
36099,2020-03-13,34300,26,0,0,0,0,0.0,0.0,0.0,0.0,"(24.0, 37.5]",Q2
36099,2020-03-14,34300,26,0,0,0,0,0.0,0.0,0.0,0.0,"(24.0, 37.5]",Q2
36099,2020-03-15,34300,26,0,0,1,1,0.0,0.14285714285714285,0.0,0.41649312786339027,"(24.0, 37.5]",Q2
36099,2020-03-16,34300,26,0,0,1,2,0.0,0.2857142857142857,0.0,0.8329862557267805,"(24.0, 37.5]",Q2
36099,2020-03-17,34300,26,0,0,1,3,0.0,0.42857142857142855,0.0,1.2494793835901707,"(24.0, 37.5]",Q2
36099,2020-03-18,34300,26,0,0,2,5,0.0,0.7142857142857143,0.0,2.0824656393169514,"(24.0, 37.5]",Q2
36099,2020-03-19,34300,26,0,0,2,7,0.0,1.0,0.0,2.915451895043732,"(24.0, 37.5]",Q2
36099,2020-03-20,34300,26,0,0,6,13,0.0,1.8571428571428572,0.0,5.414410662224074,"(24.0, 37.5]",Q2
36099,2020-03-21,34300,26,0,0,3,16,0.0,2.2857142857142856,0.0,6.663890045814244,"(24.0, 37.5]",Q2
36099,2020-03-22,34300,26,0,0,4,20,0.0,2.7142857142857144,0.0,7.913369429404415,"(24.0, 37.5]",Q2
36099,2020-03-23,34300,26,0,0,11,31,0.0,4.142857142857143,0.0,12.078300708038318,"(24.0, 37.5]",Q2
36099,2020-03-24,34300,26,0,0,0,31,0.0,4.0,0.0,11.661807580174928,"(24.0, 37.5]",Q2
36099,2020-03-25,34300,26,0,0,6,37,0.0,4.571428571428571,0.0,13.327780091628489,"(24.0, 37.5]",Q2
36099,2020-03-26,34300,26,0,0,11,48,0.0,5.857142857142857,0.0,17.076218242399,"(24.0, 37.5]",Q2
36099,2020-03-27,34300,26,0,0,16,64,0.0,7.285714285714286,0.0,21.241149521032902,"(24.0, 37.5]",Q2
36099,2020-03-28,34300,26,0,0,4,68,0.0,7.428571428571429,0.0,21.657642648896296,"(24.0, 37.5]",Q2
36099,2020-03-29,34300,26,0,0,5,73,0.0,7.571428571428571,0.0,22.074135776759682,"(24.0, 37.5]",Q2
36099,2020-03-30,34300,26,2,2,7,80,0.2857142857142857,7.0,0.8329862557267805,20.408163265306122,"(24.0, 37.5]",Q2
36099,2020-03-31,34300,26,0,2,1,81,0.2857142857142857,7.142857142857143,0.8329862557267805,20.824656393169512,"(24.0, 37.5]",Q2
36099,2020-04-01,34300,26,2,4,14,95,0.5714285714285714,8.285714285714286,1.665972511453561,24.156601416076636,"(24.0, 37.5]",Q2
36099,2020-04-02,34300,26,2,6,13,108,0.8571428571428571,8.571428571428571,2.4989587671803415,24.989587671803413,"(24.0, 37.5]",Q2
36099,2020-04-03,34300,26,0,6,7,115,0.8571428571428571,7.285714285714286,2.4989587671803415,21.241149521032902,"(24.0, 37.5]",Q2
36099,2020-04-04,34300,26,3,9,15,130,1.2857142857142858,8.857142857142858,3.7484381507705122,25.822573927530193,"(24.0, 37.5]",Q2
36099,2020-04-05,34300,26,0,9,11,141,1.2857142857142858,9.714285714285714,3.7484381507705122,28.321532694710537,"(24.0, 37.5]",Q2
36099,2020-04-06,34300,26,1,10,8,149,1.1428571428571428,9.857142857142858,3.331945022907122,28.73802582257393,"(24.0, 37.5]",Q2
36099,2020-04-07,34300,26,2,12,14,163,1.4285714285714286,11.714285714285714,4.164931278633903,34.152436484798,"(24.0, 37.5]",Q2
36099,2020-04-08,34300,26,3,15,20,183,1.5714285714285714,12.571428571428571,4.581424406497293,36.65139525197834,"(24.0, 37.5]",Q2
36099,2020-04-09,34300,26,0,15,8,191,1.2857142857142858,11.857142857142858,3.7484381507705122,34.56892961266139,"(24.0, 37.5]",Q2
36099,2020-04-10,34300,26,1,16,5,196,1.4285714285714286,11.571428571428571,4.164931278633903,33.735943356934605,"(24.0, 37.5]",Q2
36099,2020-04-11,34300,26,0,16,3,199,1.0,9.857142857142858,2.915451895043732,28.73802582257393,"(24.0, 37.5]",Q2
36099,2020-04-12,34300,26,0,16,1,200,1.0,8.428571428571429,2.915451895043732,24.573094543940027,"(24.0, 37.5]",Q2
36099,2020-04-13,34300,26,2,18,33,233,1.1428571428571428,12.0,3.331945022907122,34.98542274052478,"(24.0, 37.5]",Q2
36099,2020-04-14,34300,26,0,18,1,234,0.8571428571428571,10.142857142857142,2.4989587671803415,29.571012078300704,"(24.0, 37.5]",Q2
36099,2020-04-15,34300,26,0,18,2,236,0.42857142857142855,7.571428571428571,1.2494793835901707,22.074135776759682,"(24.0, 37.5]",Q2
36099,2020-04-16,34300,26,0,18,3,239,0.42857142857142855,6.857142857142857,1.2494793835901707,19.991670137442732,"(24.0, 37.5]",Q2
36099,2020-04-17,34300,26,0,18,2,241,0.2857142857142857,6.428571428571429,0.8329862557267805,18.74219075385256,"(24.0, 37.5]",Q2
36099,2020-04-18,34300,26,0,18,5,246,0.2857142857142857,6.714285714285714,0.8329862557267805,19.575177009579342,"(24.0, 37.5]",Q2
36099,2020-04-19,34300,26,0,18,2,248,0.2857142857142857,6.857142857142857,0.8329862557267805,19.991670137442732,"(24.0, 37.5]",Q2
36099,2020-04-20,34300,26,0,18,0,248,0.0,2.142857142857143,0.0,6.247396917950853,"(24.0, 37.5]",Q2
36099,2020-04-21,34300,26,0,18,3,251,0.0,2.4285714285714284,0.0,7.080383173677634,"(24.0, 37.5]",Q2
36099,2020-04-22,34300,26,0,18,15,266,0.0,4.285714285714286,0.0,12.494793835901707,"(24.0, 37.5]",Q2
36099,2020-04-23,34300,26,0,18,5,271,0.0,4.571428571428571,0.0,13.327780091628489,"(24.0, 37.5]",Q2
36099,2020-04-24,34300,26,18,36,135,406,2.5714285714285716,23.571428571428573,7.4968763015410245,68.7213660974594,"(24.0, 37.5]",Q2
36099,2020-04-25,34300,26,2,38,11,417,2.857142857142857,24.428571428571427,8.329862557267806,71.22032486463974,"(24.0, 37.5]",Q2
36099,2020-04-26,34300,26,0,38,12,429,2.857142857142857,25.857142857142858,8.329862557267806,75.38525614327364,"(24.0, 37.5]",Q2
36099,2020-04-27,34300,26,0,38,9,438,2.857142857142857,27.142857142857142,8.329862557267806,79.13369429404415,"(24.0, 37.5]",Q2
36099,2020-04-28,34300,26,0,38,13,451,2.857142857142857,28.571428571428573,8.329862557267806,83.29862557267805,"(24.0, 37.5]",Q2
36099,2020-04-29,34300,26,1,39,24,475,3.0,29.857142857142858,8.746355685131196,87.04706372344857,"(24.0, 37.5]",Q2
36099,2020-04-30,34300,26,2,41,22,497,3.2857142857142856,32.285714285714285,9.579341940857976,94.12744689712619,"(24.0, 37.5]",Q2
36099,2020-05-01,34300,26,1,42,26,523,0.8571428571428571,16.714285714285715,2.4989587671803415,48.72969596001666,"(24.0, 37.5]",Q2
36099,2020-05-02,34300,26,3,45,51,574,1.0,22.428571428571427,2.915451895043732,65.38942107455226,"(24.0, 37.5]",Q2
36099,2020-05-03,34300,26,0,45,19,593,1.0,23.428571428571427,2.915451895043732,68.304872969596,"(24.0, 37.5]",Q2
36099,2020-05-04,34300,26,1,46,26,619,1.1428571428571428,25.857142857142858,3.331945022907122,75.38525614327364,"(24.0, 37.5]",Q2
36099,2020-05-05,34300,26,0,46,20,639,1.1428571428571428,26.857142857142858,3.331945022907122,78.30070803831737,"(24.0, 37.5]",Q2
36099,2020-05-06,34300,26,0,46,24,663,1.0,26.857142857142858,2.915451895043732,78.30070803831737,"(24.0, 37.5]",Q2
36099,2020-05-07,34300,26,0,46,19,682,0.7142857142857143,26.428571428571427,2.0824656393169514,77.0512286547272,"(24.0, 37.5]",Q2
36099,2020-05-08,34300,26,2,48,46,728,0.8571428571428571,29.285714285714285,2.4989587671803415,85.381091211995,"(24.0, 37.5]",Q2
36099,2020-05-09,34300,26,1,49,42,770,0.5714285714285714,28.0,1.665972511453561,81.63265306122449,"(24.0, 37.5]",Q2
36099,2020-05-10,34300,26,0,49,41,811,0.5714285714285714,31.142857142857142,1.665972511453561,90.79550187421907,"(24.0, 37.5]",Q2
36099,2020-05-11,34300,26,0,49,25,836,0.42857142857142855,31.0,1.2494793835901707,90.37900874635568,"(24.0, 37.5]",Q2
36099,2020-05-12,34300,26,0,49,49,885,0.42857142857142855,35.142857142857146,1.2494793835901707,102.45730945439402,"(24.0, 37.5]",Q2
36099,2020-05-13,34300,26,0,49,40,925,0.42857142857142855,37.42857142857143,1.2494793835901707,109.12119950020826,"(24.0, 37.5]",Q2
36099,2020-05-14,34300,26,0,49,30,955,0.42857142857142855,39.0,1.2494793835901707,113.70262390670554,"(24.0, 37.5]",Q2
36099,2020-05-15,34300,26,1,50,29,984,0.2857142857142857,36.57142857142857,0.8329862557267805,106.62224073302791,"(24.0, 37.5]",Q2
36099,2020-05-16,34300,26,1,51,48,1032,0.2857142857142857,37.42857142857143,0.8329862557267805,109.12119950020826,"(24.0, 37.5]",Q2
36099,2020-05-17,34300,26,0,51,122,1154,0.2857142857142857,49.0,0.8329862557267805,142.85714285714286,"(24.0, 37.5]",Q2
36099,2020-05-18,34300,26,0,51,65,1219,0.2857142857142857,54.714285714285715,0.8329862557267805,159.51686797167847,"(24.0, 37.5]",Q2
36099,2020-05-19,34300,26,1,52,50,1269,0.42857142857142855,54.857142857142854,1.2494793835901707,159.93336109954186,"(24.0, 37.5]",Q2
36099,2020-05-20,34300,26,0,52,79,1348,0.42857142857142855,60.42857142857143,1.2494793835901707,176.17659308621407,"(24.0, 37.5]",Q2
36099,2020-05-21,34300,26,2,54,54,1402,0.7142857142857143,63.857142857142854,2.0824656393169514,186.17242815493543,"(24.0, 37.5]",Q2
36099,2020-05-22,34300,26,0,54,51,1453,0.5714285714285714,67.0,1.665972511453561,195.33527696793,"(24.0, 37.5]",Q2
36099,2020-05-23,34300,26,1,55,103,1556,0.5714285714285714,74.85714285714286,1.665972511453561,218.24239900041653,"(24.0, 37.5]",Q2
36099,2020-05-24,34300,26,0,55,56,1612,0.5714285714285714,65.42857142857143,1.665972511453561,190.75385256143275,"(24.0, 37.5]",Q2
36099,2020-05-25,34300,26,0,55,86,1698,0.5714285714285714,68.42857142857143,1.665972511453561,199.50020824656394,"(24.0, 37.5]",Q2
36099,2020-05-26,34300,26,0,55,50,1748,0.42857142857142855,68.42857142857143,1.2494793835901707,199.50020824656394,"(24.0, 37.5]",Q2
36099,2020-05-27,34300,26,1,56,77,1825,0.5714285714285714,68.14285714285714,1.665972511453561,198.66722199083716,"(24.0, 37.5]",Q2
36099,2020-05-28,34300,26,1,57,140,1965,0.42857142857142855,80.42857142857143,1.2494793835901707,234.48563098708874,"(24.0, 37.5]",Q2
36099,2020-05-29,34300,26,1,58,68,2033,0.5714285714285714,82.85714285714286,1.665972511453561,241.56601416076634,"(24.0, 37.5]",Q2
36099,2020-05-30,34300,26,0,58,138,2171,0.42857142857142855,87.85714285714286,1.2494793835901707,256.143273635985,"(24.0, 37.5]",Q2
36099,2020-05-31,34300,26,1,59,81,2252,0.5714285714285714,91.42857142857143,1.665972511453561,266.5556018325698,"(24.0, 37.5]",Q2
36099,2020-06-01,34300,26,0,59,60,2312,0.5714285714285714,87.71428571428571,1.665972511453561,255.72678050812158,"(24.0, 37.5]",Q2
36099,2020-06-02,34300,26,1,60,157,2469,0.7142857142857143,103.0,2.0824656393169514,300.29154518950435,"(24.0, 37.5]",Q2
36099,2020-06-03,34300,26,0,60,106,2575,0.5714285714285714,107.14285714285714,1.665972511453561,312.3698458975427,"(24.0, 37.5]",Q2
36099,2020-06-04,34300,26,1,61,141,2716,0.5714285714285714,107.28571428571429,1.665972511453561,312.7863390254061,"(24.0, 37.5]",Q2
36099,2020-06-05,34300,26,0,61,165,2881,0.42857142857142855,121.14285714285714,1.2494793835901707,353.1861724281549,"(24.0, 37.5]",Q2
36099,2020-06-06,34300,26,0,61,162,3043,0.42857142857142855,124.57142857142857,1.2494793835901707,363.1820074968763,"(24.0, 37.5]",Q2
36099,2020-06-07,34300,26,0,61,118,3161,0.2857142857142857,129.85714285714286,0.8329862557267805,378.59225322782174,"(24.0, 37.5]",Q2
36101,2020-03-02,95796,45,0,0,0,0,0.0,0.0,0.0,0.0,"(37.5, 52.0]",Q3
36101,2020-03-03,95796,45,0,0,0,0,0.0,0.0,0.0,0.0,"(37.5, 52.0]",Q3
36101,2020-03-04,95796,45,0,0,0,0,0.0,0.0,0.0,0.0,"(37.5, 52.0]",Q3
36101,2020-03-05,95796,45,0,0,0,0,0.0,0.0,0.0,0.0,"(37.5, 52.0]",Q3
36101,2020-03-06,95796,45,0,0,0,0,0.0,0.0,0.0,0.0,"(37.5, 52.0]",Q3
36101,2020-03-07,95796,45,0,0,0,0,0.0,0.0,0.0,0.0,"(37.5, 52.0]",Q3
36101,2020-03-08,95796,45,0,0,0,0,0.0,0.0,0.0,0.0,"(37.5, 52.0]",Q3
36101,2020-03-09,95796,45,0,0,0,0,0.0,0.0,0.0,0.0,"(37.5, 52.0]",Q3
36101,2020-03-10,95796,45,0,0,0,0,0.0,0.0,0.0,0.0,"(37.5, 52.0]",Q3
36101,2020-03-11,95796,45,0,0,0,0,0.0,0.0,0.0,0.0,"(37.5, 52.0]",Q3
36101,2020-03-12,95796,45,0,0,0,0,0.0,0.0,0.0,0.0,"(37.5, 52.0]",Q3
36101,2020-03-13,95796,45,0,0,1,1,0.0,0.14285714285714285,0.0,0.14912641744659783,"(37.5, 52.0]",Q3
36101,2020-03-14,95796,45,0,0,0,1,0.0,0.14285714285714285,0.0,0.14912641744659783,"(37.5, 52.0]",Q3
36101,2020-03-15,95796,45,0,0,0,1,0.0,0.14285714285714285,0.0,0.14912641744659783,"(37.5, 52.0]",Q3
36101,2020-03-16,95796,45,0,0,0,1,0.0,0.14285714285714285,0.0,0.14912641744659783,"(37.5, 52.0]",Q3
36101,2020-03-17,95796,45,0,0,0,1,0.0,0.14285714285714285,0.0,0.14912641744659783,"(37.5, 52.0]",Q3
36101,2020-03-18,95796,45,0,0,4,5,0.0,0.7142857142857143,0.0,0.7456320872329891,"(37.5, 52.0]",Q3
36101,2020-03-19,95796,45,0,0,3,8,0.0,1.1428571428571428,0.0,1.1930113395727826,"(37.5, 52.0]",Q3
36101,2020-03-20,95796,45,2,2,27,35,0.2857142857142857,4.857142857142857,0.29825283489319565,5.070298193184326,"(37.5, 52.0]",Q3
36101,2020-03-21,95796,45,1,3,17,52,0.42857142857142855,7.285714285714286,0.4473792523397935,7.605447289776489,"(37.5, 52.0]",Q3
36101,2020-03-22,95796,45,1,4,10,62,0.5714285714285714,8.714285714285714,0.5965056697863913,9.096711464242468,"(37.5, 52.0]",Q3
36101,2020-03-23,95796,45,1,5,2,64,0.7142857142857143,9.0,0.7456320872329891,9.394964299135664,"(37.5, 52.0]",Q3
36101,2020-03-24,95796,45,3,8,13,77,1.1428571428571428,10.857142857142858,1.1930113395727826,11.333607725941436,"(37.5, 52.0]",Q3
36101,2020-03-25,95796,45,3,11,30,107,1.5714285714285714,14.571428571428571,1.6403905919125763,15.210894579552978,"(37.5, 52.0]",Q3
36101,2020-03-26,95796,45,1,12,25,132,1.7142857142857142,17.714285714285715,1.789517009359174,18.491675763378133,"(37.5, 52.0]",Q3
36101,2020-03-27,95796,45,1,13,27,159,1.5714285714285714,17.714285714285715,1.6403905919125763,18.491675763378133,"(37.5, 52.0]",Q3
36101,2020-03-28,95796,45,4,17,22,181,2.0,18.428571428571427,2.0877698442523696,19.23730785061112,"(37.5, 52.0]",Q3
36101,2020-03-29,95796,45,2,19,8,189,2.142857142857143,18.142857142857142,2.236896261698967,18.939055015717923,"(37.5, 52.0]",Q3
36101,2020-03-30,95796,45,5,24,39,228,2.7142857142857144,23.428571428571427,2.833401931485359,24.456732461242044,"(37.5, 52.0]",Q3
36101,2020-03-31,95796,45,14,38,56,284,4.285714285714286,29.571428571428573,4.473792523397934,30.869168411445752,"(37.5, 52.0]",Q3
36101,2020-04-01,95796,45,5,43,25,309,4.571428571428571,28.857142857142858,4.77204535829113,30.123536324212765,"(37.5, 52.0]",Q3
36101,2020-04-02,95796,45,3,46,36,345,4.857142857142857,30.428571428571427,5.070298193184326,31.76392691612534,"(37.5, 52.0]",Q3
36101,2020-04-03,95796,45,9,55,27,372,6.0,30.428571428571427,6.263309532757109,31.76392691612534,"(37.5, 52.0]",Q3
36101,2020-04-04,95796,45,8,63,31,403,6.571428571428571,31.714285714285715,6.8598152025435,33.10606467314472,"(37.5, 52.0]",Q3
36101,2020-04-05,95796,45,12,75,40,443,8.0,36.285714285714285,8.351079377009478,37.878110031435845,"(37.5, 52.0]",Q3
36101,2020-04-06,95796,45,0,75,22,465,7.285714285714286,33.857142857142854,7.605447289776489,35.34296093484368,"(37.5, 52.0]",Q3
36101,2020-04-07,95796,45,7,82,67,532,6.285714285714286,35.42857142857143,6.561562367650305,36.983351526756266,"(37.5, 52.0]",Q3
36101,2020-04-08,95796,45,7,89,50,582,6.571428571428571,39.0,6.8598152025435,40.71151196292121,"(37.5, 52.0]",Q3
36101,2020-04-09,95796,45,28,117,97,679,10.142857142857142,47.714285714285715,10.587975638708446,49.808223427163675,"(37.5, 52.0]",Q3
36101,2020-04-10,95796,45,2,119,28,707,9.142857142857142,47.857142857142854,9.54409071658226,49.95734984461026,"(37.5, 52.0]",Q3
36101,2020-04-11,95796,45,2,121,12,719,8.285714285714286,45.142857142857146,8.649332211902674,47.12394791312492,"(37.5, 52.0]",Q3
36101,2020-04-12,95796,45,2,123,10,729,6.857142857142857,40.857142857142854,7.158068037436696,42.650155389726976,"(37.5, 52.0]",Q3
36101,2020-04-13,95796,45,24,147,90,819,10.285714285714286,50.57142857142857,10.737102056155043,52.790751776095625,"(37.5, 52.0]",Q3
36101,2020-04-14,95796,45,4,151,24,843,9.857142857142858,44.42857142857143,10.28972280381525,46.378315825891924,"(37.5, 52.0]",Q3
36101,2020-04-15,95796,45,3,154,20,863,9.285714285714286,40.142857142857146,9.69321713402886,41.90452330249399,"(37.5, 52.0]",Q3
36101,2020-04-16,95796,45,0,154,25,888,5.285714285714286,29.857142857142858,5.51767744552412,31.167421246338947,"(37.5, 52.0]",Q3
36101,2020-04-17,95796,45,6,160,92,980,5.857142857142857,39.0,6.114183115310511,40.71151196292121,"(37.5, 52.0]",Q3
36101,2020-04-18,95796,45,7,167,100,1080,6.571428571428571,51.57142857142857,6.8598152025435,53.834636698221814,"(37.5, 52.0]",Q3
36101,2020-04-19,95796,45,0,167,4,1084,6.285714285714286,50.714285714285715,6.561562367650305,52.93987819354223,"(37.5, 52.0]",Q3
36101,2020-04-20,95796,45,3,170,33,1117,3.2857142857142856,42.57142857142857,3.42990760127175,44.43967239908615,"(37.5, 52.0]",Q3
36101,2020-04-21,95796,45,1,171,41,1158,2.857142857142857,45.0,2.9825283489319565,46.97482149567831,"(37.5, 52.0]",Q3
36101,2020-04-22,95796,45,0,171,24,1182,2.4285714285714284,45.57142857142857,2.535149096592163,47.57132716546471,"(37.5, 52.0]",Q3
36101,2020-04-23,95796,45,0,171,28,1210,2.4285714285714284,46.0,2.535149096592163,48.0187064178045,"(37.5, 52.0]",Q3
36101,2020-04-24,95796,45,33,204,556,1766,6.285714285714286,112.28571428571429,6.561562367650305,117.2133641130259,"(37.5, 52.0]",Q3
36101,2020-04-25,95796,45,3,207,35,1801,5.714285714285714,103.0,5.965056697863913,107.52014697899703,"(37.5, 52.0]",Q3
36101,2020-04-26,95796,45,2,209,10,1811,6.0,103.85714285714286,6.263309532757109,108.41490548367662,"(37.5, 52.0]",Q3
36101,2020-04-27,95796,45,1,210,58,1869,5.714285714285714,107.42857142857143,5.965056697863913,112.14306591984158,"(37.5, 52.0]",Q3
36101,2020-04-28,95796,45,4,214,105,1974,6.142857142857143,116.57142857142857,6.412435950203706,121.68715663642382,"(37.5, 52.0]",Q3
36101,2020-04-29,95796,45,2,216,63,2037,6.428571428571429,122.14285714285714,6.710688785096903,127.50308691684114,"(37.5, 52.0]",Q3
36101,2020-04-30,95796,45,0,216,42,2079,6.428571428571429,124.14285714285714,6.710688785096903,129.5908567610935,"(37.5, 52.0]",Q3
36101,2020-05-01,95796,45,1,217,62,2141,1.8571428571428572,53.57142857142857,1.938643426805772,55.92240654247419,"(37.5, 52.0]",Q3
36101,2020-05-02,95796,45,1,218,41,2182,1.5714285714285714,54.42857142857143,1.6403905919125763,56.81716504715378,"(37.5, 52.0]",Q3
36101,2020-05-03,95796,45,1,219,70,2252,1.4285714285714286,63.0,1.4912641744659783,65.76475009394964,"(37.5, 52.0]",Q3
36101,2020-05-04,95796,45,2,221,90,2342,1.5714285714285714,67.57142857142857,1.6403905919125763,70.53679545224078,"(37.5, 52.0]",Q3
36101,2020-05-05,95796,45,2,223,114,2456,1.2857142857142858,68.85714285714286,1.3421377570193804,71.87893320926017,"(37.5, 52.0]",Q3
36101,2020-05-06,95796,45,1,224,66,2522,1.1428571428571428,69.28571428571429,1.1930113395727826,72.32631246159995,"(37.5, 52.0]",Q3
36101,2020-05-07,95796,45,1,225,101,2623,1.2857142857142858,77.71428571428571,1.3421377570193804,81.12477109094921,"(37.5, 52.0]",Q3
36101,2020-05-08,95796,45,1,226,228,2851,1.2857142857142858,101.42857142857143,1.3421377570193804,105.87975638708446,"(37.5, 52.0]",Q3
36101,2020-05-09,95796,45,1,227,73,2924,1.2857142857142858,106.0,1.3421377570193804,110.65180174537558,"(37.5, 52.0]",Q3
36101,2020-05-10,95796,45,1,228,58,2982,1.2857142857142858,104.28571428571429,1.3421377570193804,108.86228473601642,"(37.5, 52.0]",Q3
36101,2020-05-11,95796,45,1,229,90,3072,1.1428571428571428,104.28571428571429,1.1930113395727826,108.86228473601642,"(37.5, 52.0]",Q3
36101,2020-05-12,95796,45,1,230,306,3378,1.0,131.71428571428572,1.0438849221261848,137.49455688576322,"(37.5, 52.0]",Q3
36101,2020-05-13,95796,45,0,230,103,3481,0.8571428571428571,137.0,0.894758504679587,143.01223433128732,"(37.5, 52.0]",Q3
36101,2020-05-14,95796,45,1,231,110,3591,0.8571428571428571,138.28571428571428,0.894758504679587,144.3543720883067,"(37.5, 52.0]",Q3
36101,2020-05-15,95796,45,2,233,68,3659,1.0,115.42857142857143,1.0438849221261848,120.49414529685106,"(37.5, 52.0]",Q3
36101,2020-05-16,95796,45,1,234,97,3756,1.0,118.85714285714286,1.0438849221261848,124.0731793155694,"(37.5, 52.0]",Q3
36101,2020-05-17,95796,45,1,235,67,3823,1.0,120.14285714285714,1.0438849221261848,125.41531707258876,"(37.5, 52.0]",Q3
36101,2020-05-18,95796,45,1,236,126,3949,1.0,125.28571428571429,1.0438849221261848,130.78386810066633,"(37.5, 52.0]",Q3
36101,2020-05-19,95796,45,1,237,314,4263,1.0,126.42857142857143,1.0438849221261848,131.9768794402391,"(37.5, 52.0]",Q3
36101,2020-05-20,95796,45,1,238,133,4396,1.1428571428571428,130.71428571428572,1.1930113395727826,136.450671963637,"(37.5, 52.0]",Q3
36101,2020-05-21,95796,45,2,240,161,4557,1.2857142857142858,138.0,1.3421377570193804,144.0561192534135,"(37.5, 52.0]",Q3
36101,2020-05-22,95796,45,0,240,114,4671,1.0,144.57142857142858,1.0438849221261848,150.91593445595703,"(37.5, 52.0]",Q3
36101,2020-05-23,95796,45,0,240,83,4754,0.8571428571428571,142.57142857142858,0.894758504679587,148.82816461170466,"(37.5, 52.0]",Q3
36101,2020-05-24,95796,45,0,240,72,4826,0.7142857142857143,143.28571428571428,0.7456320872329891,149.57379669893763,"(37.5, 52.0]",Q3
36101,2020-05-25,95796,45,0,240,79,4905,0.5714285714285714,136.57142857142858,0.5965056697863913,142.56485507894752,"(37.5, 52.0]",Q3
36101,2020-05-26,95796,45,1,241,221,5126,0.5714285714285714,123.28571428571429,0.5965056697863913,128.69609825641393,"(37.5, 52.0]",Q3
36101,2020-05-27,95796,45,0,241,132,5258,0.42857142857142855,123.14285714285714,0.4473792523397935,128.54697183896732,"(37.5, 52.0]",Q3
36101,2020-05-28,95796,45,0,241,98,5356,0.14285714285714285,114.14285714285714,0.14912641744659783,119.15200753983167,"(37.5, 52.0]",Q3
36101,2020-05-29,95796,45,0,241,133,5489,0.14285714285714285,116.85714285714286,0.14912641744659783,121.98540947131703,"(37.5, 52.0]",Q3
36101,2020-05-30,95796,45,0,241,122,5611,0.14285714285714285,122.42857142857143,0.14912641744659783,127.80133975173435,"(37.5, 52.0]",Q3
36101,2020-05-31,95796,45,0,241,91,5702,0.14285714285714285,125.14285714285714,0.14912641744659783,130.63474168321972,"(37.5, 52.0]",Q3
36101,2020-06-01,95796,45,1,242,133,5835,0.2857142857142857,132.85714285714286,0.29825283489319565,138.68756822533598,"(37.5, 52.0]",Q3
36101,2020-06-02,95796,45,1,243,332,6167,0.2857142857142857,148.71428571428572,0.29825283489319565,155.24060056190834,"(37.5, 52.0]",Q3
36101,2020-06-03,95796,45,2,245,187,6354,0.5714285714285714,156.57142857142858,0.5965056697863913,163.44255352147124,"(37.5, 52.0]",Q3
36101,2020-06-04,95796,45,1,246,148,6502,0.7142857142857143,163.71428571428572,0.7456320872329891,170.89887439380112,"(37.5, 52.0]",Q3
36101,2020-06-05,95796,45,5,251,360,6862,1.4285714285714286,196.14285714285714,1.4912641744659783,204.7505711541788,"(37.5, 52.0]",Q3
36101,2020-06-06,95796,45,0,251,120,6982,1.4285714285714286,195.85714285714286,1.4912641744659783,204.4523183192856,"(37.5, 52.0]",Q3
36101,2020-06-07,95796,45,0,251,162,7144,1.4285714285714286,206.0,1.4912641744659783,215.04029395799407,"(37.5, 52.0]",Q3
36103,2020-03-02,1481093,10,0,0,0,0,0.0,0.0,0.0,0.0,"(3.999, 24.0]",Q1
36103,2020-03-03,1481093,10,0,0,0,0,0.0,0.0,0.0,0.0,"(3.999, 24.0]",Q1
36103,2020-03-04,1481093,10,0,0,2,2,0.0,2.0,0.0,0.13503540966029817,"(3.999, 24.0]",Q1
36103,2020-03-05,1481093,10,0,0,2,4,0.0,2.0,0.0,0.13503540966029817,"(3.999, 24.0]",Q1
36103,2020-03-06,1481093,10,0,0,1,5,0.0,1.0,0.0,0.06751770483014909,"(3.999, 24.0]",Q1
36103,2020-03-07,1481093,10,0,0,2,7,0.0,2.0,0.0,0.13503540966029817,"(3.999, 24.0]",Q1
36103,2020-03-08,1481093,10,1,1,11,18,0.14285714285714285,2.5714285714285716,0.00964538640430701,0.1736169552775262,"(3.999, 24.0]",Q1
36103,2020-03-09,1481093,10,0,1,4,22,0.14285714285714285,3.142857142857143,0.00964538640430701,0.21219850089475428,"(3.999, 24.0]",Q1
36103,2020-03-10,1481093,10,5,6,24,46,0.8571428571428571,6.571428571428571,0.057872318425842076,0.4436877745981226,"(3.999, 24.0]",Q1
36103,2020-03-11,1481093,10,5,11,24,70,1.5714285714285714,9.714285714285714,0.10609925044737714,0.6558862754928768,"(3.999, 24.0]",Q1
36103,2020-03-12,1481093,10,11,22,73,143,3.142857142857143,19.857142857142858,0.21219850089475428,1.3407087101986748,"(3.999, 24.0]",Q1
36103,2020-03-13,1481093,10,10,32,79,222,4.571428571428571,31.0,0.30865236493782433,2.093048849734622,"(3.999, 24.0]",Q1
36103,2020-03-14,1481093,10,9,41,38,260,5.857142857142857,36.142857142857146,0.39546084257658753,2.4402827602896746,"(3.999, 24.0]",Q1
36103,2020-03-15,1481093,10,22,63,95,355,8.857142857142858,48.142857142857146,0.5980139570670348,3.250495218251463,"(3.999, 24.0]",Q1
36103,2020-03-16,1481093,10,22,85,109,464,12.0,63.142857142857146,0.8102124579617891,4.2632607907037,"(3.999, 24.0]",Q1
36103,2020-03-17,1481093,10,31,116,179,643,15.714285714285714,85.28571428571429,1.0609925044737714,5.758295683371287,"(3.999, 24.0]",Q1
36103,2020-03-18,1481093,10,62,178,361,1004,23.857142857142858,133.42857142857142,1.610779529519271,9.00879090162275,"(3.999, 24.0]",Q1
36103,2020-03-19,1481093,10,193,371,766,1770,49.857142857142854,232.42857142857142,3.3662398551031467,15.69304367980751,"(3.999, 24.0]",Q1
36103,2020-03-20,1481093,10,290,661,1461,3231,89.85714285714286,429.85714285714283,6.066948048309111,29.022967690559803,"(3.999, 24.0]",Q1
36103,2020-03-21,1481093,10,373,1034,1578,4809,141.85714285714286,649.8571428571429,9.577868699476864,43.876862753192604,"(3.999, 24.0]",Q1
36103,2020-03-22,1481093,10,424,1458,1153,5962,199.28571428571428,801.0,13.455314034008282,54.08168156894942,"(3.999, 24.0]",Q1
36103,2020-03-23,1481093,10,422,1880,1047,7009,256.42857142857144,935.0,17.313468595731088,63.12905401618939,"(3.999, 24.0]",Q1
36103,2020-03-24,1481093,10,380,2260,854,7863,306.2857142857143,1031.4285714285713,20.679708450834234,69.63968983909662,"(3.999, 24.0]",Q1
36103,2020-03-25,1481093,10,475,2735,1189,9052,365.2857142857143,1149.7142857142858,24.663253035813028,77.62606978186284,"(3.999, 24.0]",Q1
36103,2020-03-26,1481093,10,650,3385,1333,10385,430.57142857142856,1230.7142857142858,29.071194622581334,83.09500387310491,"(3.999, 24.0]",Q1
36103,2020-03-27,1481093,10,753,4138,1690,12075,496.7142857142857,1263.4285714285713,33.537008527775484,85.30379735969122,"(3.999, 24.0]",Q1
36103,2020-03-28,1481093,10,885,5023,2155,14230,569.8571428571429,1345.857142857143,38.47544636678067,90.86918531497636,"(3.999, 24.0]",Q1
36103,2020-03-29,1481093,10,768,5791,1598,15828,619.0,1409.4285714285713,41.793459289862284,95.16138226489298,"(3.999, 24.0]",Q1
36103,2020-03-30,1481093,10,922,6713,1857,17685,690.4285714285714,1525.142857142857,46.616152492015786,102.97414525238166,"(3.999, 24.0]",Q1
36103,2020-03-31,1481093,10,892,7605,1620,19305,763.5714285714286,1634.5714285714287,51.55459033102098,110.36251123808084,"(3.999, 24.0]",Q1
36103,2020-04-01,1481093,10,1141,8746,2148,21453,858.7142857142857,1771.5714285714287,57.978417676289446,119.61243679981126,"(3.999, 24.0]",Q1
36103,2020-04-02,1481093,10,1408,10154,2575,24028,967.0,1949.0,65.28962057075417,131.59200671396056,"(3.999, 24.0]",Q1
36103,2020-04-03,1481093,10,1216,11370,2463,26491,1033.142857142857,2059.4285714285716,69.7554344759483,139.0478904044899,"(3.999, 24.0]",Q1
36103,2020-04-04,1481093,10,1035,12405,2200,28691,1054.5714285714287,2065.8571428571427,71.20224243659437,139.4819327926837,"(3.999, 24.0]",Q1
36103,2020-04-05,1481093,10,1082,13487,2211,30902,1099.4285714285713,2153.4285714285716,74.23089376754676,145.39455465852393,"(3.999, 24.0]",Q1
36103,2020-04-06,1481093,10,1030,14517,2323,33225,1114.857142857143,2220.0,75.27259549921192,149.88930472293097,"(3.999, 24.0]",Q1
36103,2020-04-07,1481093,10,1327,15844,3139,36364,1177.0,2437.0,79.46833858508548,164.54064667107332,"(3.999, 24.0]",Q1
36103,2020-04-08,1481093,10,1569,17413,3889,40253,1238.142857142857,2685.714285714286,83.59656396612887,181.33326440097184,"(3.999, 24.0]",Q1
36103,2020-04-09,1481093,10,1279,18692,2942,43195,1219.7142857142858,2738.1428571428573,82.35230911997327,184.87312121135253,"(3.999, 24.0]",Q1
36103,2020-04-10,1481093,10,1191,19883,2556,45751,1216.142857142857,2751.4285714285716,82.1111744598656,185.77014214695308,"(3.999, 24.0]",Q1
36103,2020-04-11,1481093,10,933,20816,2215,47966,1201.5714285714287,2753.5714285714284,81.12734504662629,185.91482294301767,"(3.999, 24.0]",Q1
36103,2020-04-12,1481093,10,827,21643,2164,50130,1165.142857142857,2746.8571428571427,78.667771513528,185.4614897820152,"(3.999, 24.0]",Q1
36103,2020-04-13,1481093,10,819,22462,2246,52376,1135.0,2735.8571428571427,76.63259498221922,184.7187950288836,"(3.999, 24.0]",Q1
36103,2020-04-14,1481093,10,816,23278,2135,54511,1062.0,2592.4285714285716,71.70380252961833,175.03482707895935,"(3.999, 24.0]",Q1
36103,2020-04-15,1481093,10,904,24182,2536,57047,967.0,2399.1428571428573,65.28962057075417,161.98461927393197,"(3.999, 24.0]",Q1
36103,2020-04-16,1481093,10,853,25035,2496,59543,906.1428571428571,2335.4285714285716,61.18068596251937,157.68277693761104,"(3.999, 24.0]",Q1
36103,2020-04-17,1481093,10,1108,26143,3385,62928,894.2857142857143,2453.8571428571427,60.3801188909619,165.67880226678153,"(3.999, 24.0]",Q1
36103,2020-04-18,1481093,10,745,26888,2392,65320,867.4285714285714,2479.1428571428573,58.566786246952184,167.3860356603439,"(3.999, 24.0]",Q1
36103,2020-04-19,1481093,10,774,27662,2278,67598,859.8571428571429,2495.4285714285716,58.05558076752391,168.48560971043491,"(3.999, 24.0]",Q1
36103,2020-04-20,1481093,10,492,28154,1482,69080,813.1428571428571,2386.285714285714,54.901539413315504,161.11653449754434,"(3.999, 24.0]",Q1
36103,2020-04-21,1481093,10,700,28854,2188,71268,796.5714285714286,2393.8571428571427,53.7826745904159,161.6277399769726,"(3.999, 24.0]",Q1
36103,2020-04-22,1481093,10,713,29567,2428,73696,769.2857142857143,2378.4285714285716,51.940405787193264,160.58603824530746,"(3.999, 24.0]",Q1
36103,2020-04-23,1481093,10,1039,30606,3858,77554,795.8571428571429,2573.0,53.734447658394366,173.7230545279736,"(3.999, 24.0]",Q1
36103,2020-04-24,1481093,10,762,31368,2860,80414,746.4285714285714,2498.0,50.397143962504146,168.65922666571242,"(3.999, 24.0]",Q1
36103,2020-04-25,1481093,10,691,32059,2830,83244,738.7142857142857,2560.5714285714284,49.87629309667155,172.88390591079886,"(3.999, 24.0]",Q1
36103,2020-04-26,1481093,10,411,32470,1826,85070,686.8571428571429,2496.0,46.37501783190812,168.52419125605212,"(3.999, 24.0]",Q1
36103,2020-04-27,1481093,10,254,32724,1429,86499,652.8571428571429,2488.4285714285716,44.079415867683046,168.01298577662385,"(3.999, 24.0]",Q1
36103,2020-04-28,1481093,10,541,33265,2669,89168,630.1428571428571,2557.1428571428573,42.54579942939823,172.65241663709554,"(3.999, 24.0]",Q1
36103,2020-04-29,1481093,10,399,33664,2193,91361,585.2857142857143,2523.5714285714284,39.51714809844583,170.38575083208335,"(3.999, 24.0]",Q1
36103,2020-04-30,1481093,10,373,34037,2207,93568,490.14285714285717,2287.714285714286,33.09332075317736,154.4612178785725,"(3.999, 24.0]",Q1
36103,2020-05-01,1481093,10,441,34478,2660,96228,444.2857142857143,2259.1428571428573,29.99715171739481,152.5321405977111,"(3.999, 24.0]",Q1
36103,2020-05-02,1481093,10,377,34855,2521,98749,399.42857142857144,2215.0,26.968500386442404,149.55171619878024,"(3.999, 24.0]",Q1
36103,2020-05-03,1481093,10,222,35077,1640,100389,372.42857142857144,2188.4285714285716,25.145522356028383,147.75767432757914,"(3.999, 24.0]",Q1
36103,2020-05-04,1481093,10,198,35275,1586,101975,364.42857142857144,2210.8571428571427,24.605380717387188,149.27199999305532,"(3.999, 24.0]",Q1
36103,2020-05-05,1481093,10,268,35543,2112,104087,325.42857142857144,2131.285714285714,21.972190229011375,143.89951976585633,"(3.999, 24.0]",Q1
36103,2020-05-06,1481093,10,349,35892,2668,106755,318.2857142857143,2199.1428571428573,21.489920908796023,148.48107830790215,"(3.999, 24.0]",Q1
36103,2020-05-07,1481093,10,331,36223,2357,109112,312.2857142857143,2220.5714285714284,21.08481467981513,149.92788626854818,"(3.999, 24.0]",Q1
36103,2020-05-08,1481093,10,238,36461,2227,111339,283.2857142857143,2158.714285714286,19.126801239740804,145.75143395548326,"(3.999, 24.0]",Q1
36103,2020-05-09,1481093,10,241,36702,2556,113895,263.85714285714283,2163.714285714286,17.81502868875505,146.089022479634,"(3.999, 24.0]",Q1
36103,2020-05-10,1481093,10,209,36911,2014,115909,262.0,2217.1428571428573,17.68963866549906,149.69639699484483,"(3.999, 24.0]",Q1
36103,2020-05-11,1481093,10,151,37062,1964,117873,255.28571428571428,2271.1428571428573,17.23630550449663,153.3423530556729,"(3.999, 24.0]",Q1
36103,2020-05-12,1481093,10,243,37305,2950,120823,251.71428571428572,2390.8571428571427,16.99517084438896,161.42518686248215,"(3.999, 24.0]",Q1
36103,2020-05-13,1481093,10,239,37544,3229,124052,236.0,2471.0,15.934178339915185,166.8362486352984,"(3.999, 24.0]",Q1
36103,2020-05-14,1481093,10,175,37719,2777,126829,213.71428571428572,2531.0,14.429498060843292,170.88731092510733,"(3.999, 24.0]",Q1
36103,2020-05-15,1481093,10,223,37942,3048,129877,211.57142857142858,2648.285714285714,14.284817264778685,178.80617316304338,"(3.999, 24.0]",Q1
36103,2020-05-16,1481093,10,175,38117,2818,132695,202.14285714285714,2685.714285714286,13.64822176209442,181.33326440097184,"(3.999, 24.0]",Q1
36103,2020-05-17,1481093,10,107,38224,1948,134643,187.57142857142858,2676.285714285714,12.664392348855108,180.69666889828756,"(3.999, 24.0]",Q1
36103,2020-05-18,1481093,10,103,38327,2118,136761,180.71428571428572,2698.285714285714,12.201413801448371,182.18205840455084,"(3.999, 24.0]",Q1
36103,2020-05-19,1481093,10,84,38411,2416,139177,158.0,2622.0,10.667797363163556,177.0314220646509,"(3.999, 24.0]",Q1
36103,2020-05-20,1481093,10,142,38553,3623,142800,144.14285714285714,2678.285714285714,9.732194881945775,180.83170430794786,"(3.999, 24.0]",Q1
36103,2020-05-21,1481093,10,119,38672,3022,145822,136.14285714285714,2713.285714285714,9.192053243304583,183.19482397700307,"(3.999, 24.0]",Q1
36103,2020-05-22,1481093,10,130,38802,4005,149827,122.85714285714286,2850.0,8.29503230770403,192.4254587659249,"(3.999, 24.0]",Q1
36103,2020-05-23,1481093,10,162,38964,3865,153692,121.0,2999.5714285714284,8.169642284448038,202.52417833123434,"(3.999, 24.0]",Q1
36103,2020-05-24,1481093,10,126,39090,4010,157702,123.71428571428571,3294.1428571428573,8.352904626129872,222.4129650969154,"(3.999, 24.0]",Q1
36103,2020-05-25,1481093,10,109,39199,3241,160943,124.57142857142857,3454.5714285714284,8.410776944555714,233.24473402895214,"(3.999, 24.0]",Q1
36103,2020-05-26,1481093,10,59,39258,2492,163435,121.0,3465.4285714285716,8.169642284448038,233.9777833956795,"(3.999, 24.0]",Q1
36103,2020-05-27,1481093,10,101,39359,4482,167917,115.14285714285714,3588.1428571428573,7.774181441871452,242.26317031697926,"(3.999, 24.0]",Q1
36103,2020-05-28,1481093,10,86,39445,4591,172508,110.42857142857143,3812.285714285714,7.455883690529321,257.3967815853369,"(3.999, 24.0]",Q1
36103,2020-05-29,1481093,10,87,39532,4388,176896,104.28571428571429,3867.0,7.0411320751441195,261.0909645781865,"(3.999, 24.0]",Q1
36103,2020-05-30,1481093,10,111,39643,5138,182034,97.0,4048.8571428571427,6.549217368524461,273.3695414708693,"(3.999, 24.0]",Q1
36103,2020-05-31,1481093,10,62,39705,4294,186328,87.85714285714286,4089.4285714285716,5.931912638648813,276.10883120969254,"(3.999, 24.0]",Q1
36103,2020-06-01,1481093,10,275,39980,4365,190693,111.57142857142857,4250.0,7.533046781763776,286.9502455281336,"(3.999, 24.0]",Q1
36103,2020-06-02,1481093,10,82,40062,4840,195533,114.85714285714286,4585.428571428572,7.754890669062838,309.5976128054465,"(3.999, 24.0]",Q1
36103,2020-06-03,1481093,10,91,40153,5178,200711,113.42857142857143,4684.857142857143,7.658436805019768,316.3108017428442,"(3.999, 24.0]",Q1
36103,2020-06-04,1481093,10,86,40239,5202,205913,113.42857142857143,4772.142857142857,7.658436805019768,322.2041328358757,"(3.999, 24.0]",Q1
36103,2020-06-05,1481093,10,39,40278,5505,211418,106.57142857142857,4931.714285714285,7.195458257613031,332.97802944948666,"(3.999, 24.0]",Q1
36103,2020-06-06,1481093,10,51,40329,4582,216000,98.0,4852.285714285715,6.616735073354611,327.615194608692,"(3.999, 24.0]",Q1
36103,2020-06-07,1481093,10,48,40377,4833,220833,96.0,4929.285714285715,6.481699663694313,332.81405788061346,"(3.999, 24.0]",Q1
36105,2020-03-02,75498,68,0,0,0,0,0.0,0.0,0.0,0.0,"(52.0, 100.0]",Q4
36105,2020-03-03,75498,68,0,0,0,0,0.0,0.0,0.0,0.0,"(52.0, 100.0]",Q4
36105,2020-03-04,75498,68,0,0,0,0,0.0,0.0,0.0,0.0,"(52.0, 100.0]",Q4
36105,2020-03-05,75498,68,0,0,0,0,0.0,0.0,0.0,0.0,"(52.0, 100.0]",Q4
36105,2020-03-06,75498,68,0,0,0,0,0.0,0.0,0.0,0.0,"(52.0, 100.0]",Q4
36105,2020-03-07,75498,68,0,0,0,0,0.0,0.0,0.0,0.0,"(52.0, 100.0]",Q4
36105,2020-03-08,75498,68,0,0,0,0,0.0,0.0,0.0,0.0,"(52.0, 100.0]",Q4
36105,2020-03-09,75498,68,0,0,0,0,0.0,0.0,0.0,0.0,"(52.0, 100.0]",Q4
36105,2020-03-10,75498,68,0,0,0,0,0.0,0.0,0.0,0.0,"(52.0, 100.0]",Q4
36105,2020-03-11,75498,68,0,0,1,1,0.0,0.14285714285714285,0.0,0.18921977119545266,"(52.0, 100.0]",Q4
36105,2020-03-12,75498,68,0,0,0,1,0.0,0.14285714285714285,0.0,0.18921977119545266,"(52.0, 100.0]",Q4
36105,2020-03-13,75498,68,0,0,1,2,0.0,0.2857142857142857,0.0,0.3784395423909053,"(52.0, 100.0]",Q4
36105,2020-03-14,75498,68,0,0,7,9,0.0,1.2857142857142858,0.0,1.7029779407590744,"(52.0, 100.0]",Q4
36105,2020-03-15,75498,68,0,0,2,11,0.0,1.5714285714285714,0.0,2.081417483149979,"(52.0, 100.0]",Q4
36105,2020-03-16,75498,68,1,1,9,20,0.14285714285714285,2.857142857142857,0.18921977119545266,3.784395423909053,"(52.0, 100.0]",Q4
36105,2020-03-17,75498,68,0,1,14,34,0.14285714285714285,4.857142857142857,0.18921977119545266,6.43347222064539,"(52.0, 100.0]",Q4
36105,2020-03-18,75498,68,2,3,23,57,0.42857142857142855,8.0,0.567659313586358,10.59630718694535,"(52.0, 100.0]",Q4
36105,2020-03-19,75498,68,5,8,79,136,1.1428571428571428,19.285714285714285,1.5137581695636213,25.544669111386106,"(52.0, 100.0]",Q4
36105,2020-03-20,75498,68,4,12,42,178,1.7142857142857142,25.142857142857142,2.270637254345432,33.30267973039967,"(52.0, 100.0]",Q4
36105,2020-03-21,75498,68,4,16,37,215,2.2857142857142856,29.428571428571427,3.0275163391272426,38.97927286626325,"(52.0, 100.0]",Q4
36105,2020-03-22,75498,68,7,23,83,298,3.2857142857142856,41.0,4.352054737495411,54.30607433309491,"(52.0, 100.0]",Q4
36105,2020-03-23,75498,68,7,30,44,342,4.142857142857143,46.0,5.487373364668128,60.92876632493576,"(52.0, 100.0]",Q4
36105,2020-03-24,75498,68,9,39,23,365,5.428571428571429,47.285714285714285,7.190351305427202,62.631744265694834,"(52.0, 100.0]",Q4
36105,2020-03-25,75498,68,14,53,53,418,7.142857142857143,51.57142857142857,9.460988559772634,68.30833740155842,"(52.0, 100.0]",Q4
36105,2020-03-26,75498,68,11,64,62,480,8.0,49.142857142857146,10.59630718694535,65.09160129123572,"(52.0, 100.0]",Q4
36105,2020-03-27,75498,68,8,72,49,529,8.571428571428571,50.142857142857146,11.353186271727159,66.4161396896039,"(52.0, 100.0]",Q4
36105,2020-03-28,75498,68,16,88,91,620,10.285714285714286,57.857142857142854,13.623823526072595,76.63400733415833,"(52.0, 100.0]",Q4
36105,2020-03-29,75498,68,13,101,53,673,11.142857142857142,53.57142857142857,14.759142153245307,70.95741419829474,"(52.0, 100.0]",Q4
36105,2020-03-30,75498,68,8,109,33,706,11.285714285714286,52.0,14.948361924440762,68.87599671514478,"(52.0, 100.0]",Q4
36105,2020-03-31,75498,68,12,121,55,761,11.714285714285714,56.57142857142857,15.516021238027118,74.93102939339926,"(52.0, 100.0]",Q4
36105,2020-04-01,75498,68,22,143,96,857,12.857142857142858,62.714285714285715,17.02977940759074,83.06747955480373,"(52.0, 100.0]",Q4
36105,2020-04-02,75498,68,25,168,140,997,14.857142857142858,73.85714285714286,19.678856204327076,97.82662170804903,"(52.0, 100.0]",Q4
36105,2020-04-03,75498,68,25,193,133,1130,17.285714285714285,85.85714285714286,22.89559231464977,113.72108248846706,"(52.0, 100.0]",Q4
36105,2020-04-04,75498,68,41,234,153,1283,20.857142857142858,94.71428571428571,27.62608659453609,125.45270830258511,"(52.0, 100.0]",Q4
36105,2020-04-05,75498,68,19,253,91,1374,21.714285714285715,100.14285714285714,28.76140522170881,132.64305960801232,"(52.0, 100.0]",Q4
36105,2020-04-06,75498,68,17,270,77,1451,23.0,106.42857142857143,30.46438316246788,140.96872954061226,"(52.0, 100.0]",Q4
36105,2020-04-07,75498,68,9,279,56,1507,22.571428571428573,106.57142857142857,29.896723848881525,141.15794931180767,"(52.0, 100.0]",Q4
36105,2020-04-08,75498,68,15,294,60,1567,21.571428571428573,101.42857142857143,28.572185450513356,134.3460375487714,"(52.0, 100.0]",Q4
36105,2020-04-09,75498,68,24,318,115,1682,21.428571428571427,97.85714285714286,28.382965679317895,129.6155432688851,"(52.0, 100.0]",Q4
36105,2020-04-10,75498,68,22,340,99,1781,21.0,93.0,27.815306365731544,123.18207104823969,"(52.0, 100.0]",Q4
36105,2020-04-11,75498,68,18,358,65,1846,17.714285714285715,80.42857142857143,23.463251628236133,106.53073118303985,"(52.0, 100.0]",Q4
36105,2020-04-12,75498,68,22,380,73,1919,18.142857142857142,77.85714285714286,24.030910941822487,103.12477530152171,"(52.0, 100.0]",Q4
36105,2020-04-13,75498,68,35,415,133,2052,20.714285714285715,85.85714285714286,27.436866823340637,113.72108248846706,"(52.0, 100.0]",Q4
36105,2020-04-14,75498,68,9,424,37,2089,20.714285714285715,83.14285714285714,27.436866823340637,110.12590683575345,"(52.0, 100.0]",Q4
36105,2020-04-15,75498,68,13,437,39,2128,20.428571428571427,80.14285714285714,27.05842728094973,106.15229164064894,"(52.0, 100.0]",Q4
36105,2020-04-16,75498,68,68,505,192,2320,26.714285714285715,91.14285714285714,35.38409721354965,120.7222140226988,"(52.0, 100.0]",Q4
36105,2020-04-17,75498,68,19,524,92,2412,26.285714285714285,90.14285714285714,34.81643789996329,119.39767562433063,"(52.0, 100.0]",Q4
36105,2020-04-18,75498,68,13,537,38,2450,25.571428571428573,86.28571428571429,33.87033904398603,114.28874180205342,"(52.0, 100.0]",Q4
36105,2020-04-19,75498,68,7,544,30,2480,23.428571428571427,80.14285714285714,31.032042476054237,106.15229164064894,"(52.0, 100.0]",Q4
36105,2020-04-20,75498,68,11,555,44,2524,20.0,67.42857142857143,26.49076796736337,89.31173200425367,"(52.0, 100.0]",Q4
36105,2020-04-21,75498,68,6,561,45,2569,19.571428571428573,68.57142857142857,25.923108653777017,90.82549017381727,"(52.0, 100.0]",Q4
36105,2020-04-22,75498,68,19,580,52,2621,20.428571428571427,70.42857142857143,27.05842728094973,93.28534719935817,"(52.0, 100.0]",Q4
36105,2020-04-23,75498,68,48,628,253,2874,17.571428571428573,79.14285714285714,23.274031857040683,104.82775324228076,"(52.0, 100.0]",Q4
36105,2020-04-24,75498,68,61,689,296,3170,23.571428571428573,108.28571428571429,31.22126224724969,143.42858656615314,"(52.0, 100.0]",Q4
36105,2020-04-25,75498,68,35,724,160,3330,26.714285714285715,125.71428571428571,35.38409721354965,166.51339865199833,"(52.0, 100.0]",Q4
36105,2020-04-26,75498,68,24,748,120,3450,29.142857142857142,138.57142857142858,38.600833323872344,183.5431780595891,"(52.0, 100.0]",Q4
36105,2020-04-27,75498,68,21,769,77,3527,30.571428571428573,143.28571428571428,40.493031035826874,189.787430509039,"(52.0, 100.0]",Q4
36105,2020-04-28,75498,68,42,811,114,3641,35.714285714285715,153.14285714285714,47.304942798863166,202.84359472152528,"(52.0, 100.0]",Q4
36105,2020-04-29,75498,68,27,838,102,3743,36.857142857142854,160.28571428571428,48.81870096842678,212.30458328129788,"(52.0, 100.0]",Q4
36105,2020-04-30,75498,68,42,880,122,3865,36.0,141.57142857142858,47.683382341254074,187.51679325469362,"(52.0, 100.0]",Q4
36105,2020-05-01,75498,68,51,931,128,3993,34.57142857142857,117.57142857142857,45.79118462929954,155.72787169385754,"(52.0, 100.0]",Q4
36105,2020-05-02,75498,68,20,951,105,4098,32.42857142857143,109.71428571428571,42.95288806136776,145.32078427810765,"(52.0, 100.0]",Q4
36105,2020-05-03,75498,68,25,976,106,4204,32.57142857142857,107.71428571428571,43.142107832563205,142.6717074813713,"(52.0, 100.0]",Q4
36105,2020-05-04,75498,68,8,984,111,4315,30.714285714285715,112.57142857142857,40.68225080702233,149.1051797020167,"(52.0, 100.0]",Q4
36105,2020-05-05,75498,68,12,996,99,4414,26.428571428571427,110.42857142857143,35.005657671158744,146.2668831340849,"(52.0, 100.0]",Q4
36105,2020-05-06,75498,68,25,1021,150,4564,26.142857142857142,117.28571428571429,34.627218128767836,155.34943215146666,"(52.0, 100.0]",Q4
36105,2020-05-07,75498,68,18,1039,90,4654,22.714285714285715,112.71428571428571,30.085943620076975,149.29439947321217,"(52.0, 100.0]",Q4
36105,2020-05-08,75498,68,32,1071,143,4797,20.0,114.85714285714286,26.49076796736337,152.13269604114396,"(52.0, 100.0]",Q4
36105,2020-05-09,75498,68,22,1093,115,4912,20.285714285714285,116.28571428571429,26.86920750975428,154.0248937530985,"(52.0, 100.0]",Q4
36105,2020-05-10,75498,68,16,1109,78,4990,19.0,112.28571428571429,25.166229568995206,148.7267401596258,"(52.0, 100.0]",Q4
36105,2020-05-11,75498,68,10,1119,95,5085,19.285714285714285,110.0,25.544669111386106,145.69922382049856,"(52.0, 100.0]",Q4
36105,2020-05-12,75498,68,16,1135,89,5174,19.857142857142858,108.57142857142857,26.301548196167925,143.80702610854402,"(52.0, 100.0]",Q4
36105,2020-05-13,75498,68,33,1168,178,5352,21.0,112.57142857142857,27.815306365731544,149.1051797020167,"(52.0, 100.0]",Q4
36105,2020-05-14,75498,68,21,1189,127,5479,21.428571428571427,117.85714285714286,28.382965679317895,156.10631123624847,"(52.0, 100.0]",Q4
36105,2020-05-15,75498,68,28,1217,176,5655,20.857142857142858,122.57142857142857,27.62608659453609,162.3505636856984,"(52.0, 100.0]",Q4
36105,2020-05-16,75498,68,14,1231,138,5793,19.714285714285715,125.85714285714286,26.11232842497247,166.70261842319383,"(52.0, 100.0]",Q4
36105,2020-05-17,75498,68,15,1246,133,5926,19.571428571428573,133.71428571428572,25.923108653777017,177.1097058389437,"(52.0, 100.0]",Q4
36105,2020-05-18,75498,68,12,1258,111,6037,19.857142857142858,136.0,26.301548196167925,180.13722217807094,"(52.0, 100.0]",Q4
36105,2020-05-19,75498,68,9,1267,116,6153,18.857142857142858,139.85714285714286,24.977009797799752,185.24615600034815,"(52.0, 100.0]",Q4
36105,2020-05-20,75498,68,14,1281,157,6310,16.142857142857142,136.85714285714286,21.381834145086152,181.27254080524366,"(52.0, 100.0]",Q4
36105,2020-05-21,75498,68,6,1287,158,6468,14.0,141.28571428571428,18.54353757715436,187.13835371230266,"(52.0, 100.0]",Q4
36105,2020-05-22,75498,68,10,1297,148,6616,11.428571428571429,137.28571428571428,15.137581695636213,181.84020011883,"(52.0, 100.0]",Q4
36105,2020-05-23,75498,68,13,1310,155,6771,11.285714285714286,139.71428571428572,14.948361924440762,185.05693622915274,"(52.0, 100.0]",Q4
36105,2020-05-24,75498,68,14,1324,170,6941,11.142857142857142,145.0,14.759142153245307,192.05806776338446,"(52.0, 100.0]",Q4
36105,2020-05-25,75498,68,14,1338,238,7179,11.428571428571429,163.14285714285714,15.137581695636213,216.08897870520693,"(52.0, 100.0]",Q4
36105,2020-05-26,75498,68,2,1340,77,7256,10.428571428571429,157.57142857142858,13.813043297268045,208.7094076285843,"(52.0, 100.0]",Q4
36105,2020-05-27,75498,68,11,1351,209,7465,10.0,165.0,13.245383983681686,218.54883573074784,"(52.0, 100.0]",Q4
36105,2020-05-28,75498,68,13,1364,160,7625,11.0,165.28571428571428,14.569922382049857,218.92727527313872,"(52.0, 100.0]",Q4
36105,2020-05-29,75498,68,11,1375,254,7879,11.142857142857142,180.42857142857142,14.759142153245307,238.98457101985667,"(52.0, 100.0]",Q4
36105,2020-05-30,75498,68,12,1387,237,8116,11.0,192.14285714285714,14.569922382049857,254.50059225788382,"(52.0, 100.0]",Q4
36105,2020-05-31,75498,68,2,1389,145,8261,9.285714285714286,188.57142857142858,12.299285127704424,249.77009797799752,"(52.0, 100.0]",Q4
36105,2020-06-01,75498,68,3,1392,108,8369,7.714285714285714,170.0,10.217867644554445,225.17152772258868,"(52.0, 100.0]",Q4
36105,2020-06-02,75498,68,1,1393,155,8524,7.571428571428571,181.14285714285714,10.028647873358992,239.93066987583398,"(52.0, 100.0]",Q4
36105,2020-06-03,75498,68,12,1405,186,8710,7.714285714285714,177.85714285714286,10.217867644554445,235.57861513833856,"(52.0, 100.0]",Q4
36105,2020-06-04,75498,68,4,1409,167,8877,6.428571428571429,178.85714285714286,8.51488970379537,236.90315353670678,"(52.0, 100.0]",Q4
36105,2020-06-05,75498,68,2,1411,176,9053,5.142857142857143,167.71428571428572,6.8119117630362975,222.14401138346145,"(52.0, 100.0]",Q4
36105,2020-06-06,75498,68,4,1415,177,9230,4.0,159.14285714285714,5.298153593472675,210.79082511173425,"(52.0, 100.0]",Q4
36105,2020-06-07,75498,68,2,1417,123,9353,4.0,156.0,5.298153593472675,206.62799014543432,"(52.0, 100.0]",Q4
36107,2020-03-02,48560,11,0,0,0,0,0.0,0.0,0.0,0.0,"(3.999, 24.0]",Q1
36107,2020-03-03,48560,11,0,0,0,0,0.0,0.0,0.0,0.0,"(3.999, 24.0]",Q1
36107,2020-03-04,48560,11,0,0,0,0,0.0,0.0,0.0,0.0,"(3.999, 24.0]",Q1
36107,2020-03-05,48560,11,0,0,0,0,0.0,0.0,0.0,0.0,"(3.999, 24.0]",Q1
36107,2020-03-06,48560,11,0,0,0,0,0.0,0.0,0.0,0.0,"(3.999, 24.0]",Q1
36107,2020-03-07,48560,11,0,0,0,0,0.0,0.0,0.0,0.0,"(3.999, 24.0]",Q1
36107,2020-03-08,48560,11,0,0,0,0,0.0,0.0,0.0,0.0,"(3.999, 24.0]",Q1
36107,2020-03-09,48560,11,0,0,0,0,0.0,0.0,0.0,0.0,"(3.999, 24.0]",Q1
36107,2020-03-10,48560,11,0,0,0,0,0.0,0.0,0.0,0.0,"(3.999, 24.0]",Q1
36107,2020-03-11,48560,11,0,0,1,1,0.0,0.14285714285714285,0.0,0.29418686749823486,"(3.999, 24.0]",Q1
36107,2020-03-12,48560,11,0,0,0,1,0.0,0.14285714285714285,0.0,0.29418686749823486,"(3.999, 24.0]",Q1
36107,2020-03-13,48560,11,1,1,1,2,0.14285714285714285,0.2857142857142857,0.29418686749823486,0.5883737349964697,"(3.999, 24.0]",Q1
36107,2020-03-14,48560,11,0,1,0,2,0.14285714285714285,0.2857142857142857,0.29418686749823486,0.5883737349964697,"(3.999, 24.0]",Q1
36107,2020-03-15,48560,11,0,1,1,3,0.14285714285714285,0.42857142857142855,0.29418686749823486,0.8825606024947045,"(3.999, 24.0]",Q1
36107,2020-03-16,48560,11,0,1,3,6,0.14285714285714285,0.8571428571428571,0.29418686749823486,1.765121204989409,"(3.999, 24.0]",Q1
36107,2020-03-17,48560,11,0,1,5,11,0.14285714285714285,1.5714285714285714,0.29418686749823486,3.2360555424805835,"(3.999, 24.0]",Q1
36107,2020-03-18,48560,11,0,1,0,11,0.14285714285714285,1.4285714285714286,0.29418686749823486,2.9418686749823486,"(3.999, 24.0]",Q1
36107,2020-03-19,48560,11,0,1,0,11,0.14285714285714285,1.4285714285714286,0.29418686749823486,2.9418686749823486,"(3.999, 24.0]",Q1
36107,2020-03-20,48560,11,0,1,5,16,0.0,2.0,0.0,4.118616144975288,"(3.999, 24.0]",Q1
36107,2020-03-21,48560,11,0,1,4,20,0.0,2.5714285714285716,0.0,5.295363614968228,"(3.999, 24.0]",Q1
36107,2020-03-22,48560,11,0,1,4,24,0.0,3.0,0.0,6.177924217462933,"(3.999, 24.0]",Q1
36107,2020-03-23,48560,11,0,1,3,27,0.0,3.0,0.0,6.177924217462933,"(3.999, 24.0]",Q1
36107,2020-03-24,48560,11,0,1,1,28,0.0,2.4285714285714284,0.0,5.001176747469993,"(3.999, 24.0]",Q1
36107,2020-03-25,48560,11,1,2,12,40,0.14285714285714285,4.142857142857143,0.29418686749823486,8.531419157448813,"(3.999, 24.0]",Q1
36107,2020-03-26,48560,11,0,2,10,50,0.14285714285714285,5.571428571428571,0.29418686749823486,11.47328783243116,"(3.999, 24.0]",Q1
36107,2020-03-27,48560,11,2,4,18,68,0.42857142857142855,7.428571428571429,0.8825606024947045,15.297717109908215,"(3.999, 24.0]",Q1
36107,2020-03-28,48560,11,0,4,21,89,0.42857142857142855,9.857142857142858,0.8825606024947045,20.298893857378207,"(3.999, 24.0]",Q1
36107,2020-03-29,48560,11,0,4,15,104,0.42857142857142855,11.428571428571429,0.8825606024947045,23.53494939985879,"(3.999, 24.0]",Q1
36107,2020-03-30,48560,11,3,7,21,125,0.8571428571428571,14.0,1.765121204989409,28.83031301482702,"(3.999, 24.0]",Q1
36107,2020-03-31,48560,11,0,7,15,140,0.8571428571428571,16.0,1.765121204989409,32.948929159802304,"(3.999, 24.0]",Q1
36107,2020-04-01,48560,11,0,7,14,154,0.7142857142857143,16.285714285714285,1.4709343374911743,33.53730289479878,"(3.999, 24.0]",Q1
36107,2020-04-02,48560,11,0,7,18,172,0.7142857142857143,17.428571428571427,1.4709343374911743,35.89079783478465,"(3.999, 24.0]",Q1
36107,2020-04-03,48560,11,0,7,9,181,0.42857142857142855,16.142857142857142,0.8825606024947045,33.243116027300545,"(3.999, 24.0]",Q1
36107,2020-04-04,48560,11,0,7,8,189,0.42857142857142855,14.285714285714286,0.8825606024947045,29.41868674982349,"(3.999, 24.0]",Q1
36107,2020-04-05,48560,11,1,8,10,199,0.5714285714285714,13.571428571428571,1.1767474699929394,27.947752412332314,"(3.999, 24.0]",Q1
36107,2020-04-06,48560,11,0,8,10,209,0.14285714285714285,12.0,0.29418686749823486,24.711696869851732,"(3.999, 24.0]",Q1
36107,2020-04-07,48560,11,4,12,29,238,0.7142857142857143,14.0,1.4709343374911743,28.83031301482702,"(3.999, 24.0]",Q1
36107,2020-04-08,48560,11,5,17,32,270,1.4285714285714286,16.571428571428573,2.9418686749823486,34.12567662979525,"(3.999, 24.0]",Q1
36107,2020-04-09,48560,11,1,18,16,286,1.5714285714285714,16.285714285714285,3.2360555424805835,33.53730289479878,"(3.999, 24.0]",Q1
36107,2020-04-10,48560,11,1,19,10,296,1.7142857142857142,16.428571428571427,3.530242409978818,33.83148976229701,"(3.999, 24.0]",Q1
36107,2020-04-11,48560,11,0,19,8,304,1.7142857142857142,16.428571428571427,3.530242409978818,33.83148976229701,"(3.999, 24.0]",Q1
36107,2020-04-12,48560,11,1,20,3,307,1.7142857142857142,15.428571428571429,3.530242409978818,31.77218168980937,"(3.999, 24.0]",Q1
36107,2020-04-13,48560,11,4,24,52,359,2.2857142857142856,21.428571428571427,4.706989879971758,44.128030124735226,"(3.999, 24.0]",Q1
36107,2020-04-14,48560,11,1,25,14,373,1.8571428571428572,19.285714285714285,3.8244292774770536,39.7152271122617,"(3.999, 24.0]",Q1
36107,2020-04-15,48560,11,2,27,16,389,1.4285714285714286,17.0,2.9418686749823486,35.00823723228995,"(3.999, 24.0]",Q1
36107,2020-04-16,48560,11,3,30,13,402,1.7142857142857142,16.571428571428573,3.530242409978818,34.12567662979525,"(3.999, 24.0]",Q1
36107,2020-04-17,48560,11,2,32,16,418,1.8571428571428572,17.428571428571427,3.8244292774770536,35.89079783478465,"(3.999, 24.0]",Q1
36107,2020-04-18,48560,11,3,35,10,428,2.2857142857142856,17.714285714285715,4.706989879971758,36.47917156978113,"(3.999, 24.0]",Q1
36107,2020-04-19,48560,11,2,37,6,434,2.4285714285714284,18.142857142857142,5.001176747469993,37.36173217227583,"(3.999, 24.0]",Q1
36107,2020-04-20,48560,11,0,37,5,439,1.8571428571428572,11.428571428571429,3.8244292774770536,23.53494939985879,"(3.999, 24.0]",Q1
36107,2020-04-21,48560,11,2,39,10,449,2.0,10.857142857142858,4.118616144975288,22.35820192986585,"(3.999, 24.0]",Q1
36107,2020-04-22,48560,11,1,40,13,462,1.8571428571428572,10.428571428571429,3.8244292774770536,21.475641327371147,"(3.999, 24.0]",Q1
36107,2020-04-23,48560,11,0,40,10,472,1.4285714285714286,10.0,2.9418686749823486,20.59308072487644,"(3.999, 24.0]",Q1
36107,2020-04-24,48560,11,31,71,173,645,5.571428571428571,32.42857142857143,11.47328783243116,66.78041892209932,"(3.999, 24.0]",Q1
36107,2020-04-25,48560,11,0,71,8,653,5.142857142857143,32.142857142857146,10.590727229936457,66.19204518710285,"(3.999, 24.0]",Q1
36107,2020-04-26,48560,11,0,71,8,661,4.857142857142857,32.42857142857143,10.002353494939985,66.78041892209932,"(3.999, 24.0]",Q1
36107,2020-04-27,48560,11,11,82,86,747,6.428571428571429,44.0,13.238409037420569,90.60955518945634,"(3.999, 24.0]",Q1
36107,2020-04-28,48560,11,2,84,68,815,6.428571428571429,52.285714285714285,13.238409037420569,107.67239350435396,"(3.999, 24.0]",Q1
36107,2020-04-29,48560,11,4,88,69,884,6.857142857142857,60.285714285714285,14.120969639915272,124.14685808425513,"(3.999, 24.0]",Q1
36107,2020-04-30,48560,11,2,90,19,903,7.142857142857143,61.57142857142857,14.709343374911745,126.79453989173923,"(3.999, 24.0]",Q1
36107,2020-05-01,48560,11,0,90,20,923,2.7142857142857144,39.714285714285715,5.589550482466462,81.7839491645093,"(3.999, 24.0]",Q1
36107,2020-05-02,48560,11,0,90,25,948,2.7142857142857144,42.142857142857146,5.589550482466462,86.7851259119793,"(3.999, 24.0]",Q1
36107,2020-05-03,48560,11,0,90,50,998,2.7142857142857144,48.142857142857146,5.589550482466462,99.14097434690517,"(3.999, 24.0]",Q1
36107,2020-05-04,48560,11,2,92,67,1065,1.4285714285714286,45.42857142857143,2.9418686749823486,93.55142386443869,"(3.999, 24.0]",Q1
36107,2020-05-05,48560,11,4,96,76,1141,1.7142857142857142,46.57142857142857,3.530242409978818,95.90491880442457,"(3.999, 24.0]",Q1
36107,2020-05-06,48560,11,1,97,40,1181,1.2857142857142858,42.42857142857143,2.647681807484114,87.37349964697576,"(3.999, 24.0]",Q1
36107,2020-05-07,48560,11,2,99,40,1221,1.2857142857142858,45.42857142857143,2.647681807484114,93.55142386443869,"(3.999, 24.0]",Q1
36107,2020-05-08,48560,11,5,104,83,1304,2.0,54.42857142857143,4.118616144975288,112.0851965168275,"(3.999, 24.0]",Q1
36107,2020-05-09,48560,11,1,105,31,1335,2.142857142857143,55.285714285714285,4.412803012473523,113.8503177218169,"(3.999, 24.0]",Q1
36107,2020-05-10,48560,11,2,107,40,1375,2.4285714285714284,53.857142857142854,5.001176747469993,110.90844904683453,"(3.999, 24.0]",Q1
36107,2020-05-11,48560,11,0,107,35,1410,2.142857142857143,49.285714285714285,4.412803012473523,101.49446928689103,"(3.999, 24.0]",Q1
36107,2020-05-12,48560,11,1,108,92,1502,1.7142857142857142,51.57142857142857,3.530242409978818,106.20145916686279,"(3.999, 24.0]",Q1
36107,2020-05-13,48560,11,0,108,59,1561,1.5714285714285714,54.285714285714285,3.2360555424805835,111.79100964932925,"(3.999, 24.0]",Q1
36107,2020-05-14,48560,11,2,110,42,1603,1.5714285714285714,54.57142857142857,3.2360555424805835,112.3793833843257,"(3.999, 24.0]",Q1
36107,2020-05-15,48560,11,2,112,57,1660,1.1428571428571428,50.857142857142854,2.353494939985879,104.73052482937162,"(3.999, 24.0]",Q1
36107,2020-05-16,48560,11,1,113,59,1719,1.1428571428571428,54.857142857142854,2.353494939985879,112.96775711932217,"(3.999, 24.0]",Q1
36107,2020-05-17,48560,11,0,113,82,1801,0.8571428571428571,60.857142857142854,1.765121204989409,125.32360555424806,"(3.999, 24.0]",Q1
36107,2020-05-18,48560,11,0,113,113,1914,0.8571428571428571,72.0,1.765121204989409,148.27018121911038,"(3.999, 24.0]",Q1
36107,2020-05-19,48560,11,1,114,106,2020,0.8571428571428571,74.0,1.765121204989409,152.3887973640857,"(3.999, 24.0]",Q1
36107,2020-05-20,48560,11,3,117,89,2109,1.2857142857142858,78.28571428571429,2.647681807484114,161.21440338903273,"(3.999, 24.0]",Q1
36107,2020-05-21,48560,11,1,118,105,2214,1.1428571428571428,87.28571428571429,2.353494939985879,179.74817604142152,"(3.999, 24.0]",Q1
36107,2020-05-22,48560,11,3,121,96,2310,1.2857142857142858,92.85714285714286,2.647681807484114,191.22146387385268,"(3.999, 24.0]",Q1
36107,2020-05-23,48560,11,1,122,79,2389,1.2857142857142858,95.71428571428571,2.647681807484114,197.10520122381737,"(3.999, 24.0]",Q1
36107,2020-05-24,48560,11,0,122,54,2443,1.2857142857142858,91.71428571428571,2.647681807484114,188.8679689338668,"(3.999, 24.0]",Q1
36107,2020-05-25,48560,11,0,122,45,2488,1.2857142857142858,82.0,2.647681807484114,168.8632619439868,"(3.999, 24.0]",Q1
36107,2020-05-26,48560,11,2,124,195,2683,1.4285714285714286,94.71428571428571,2.9418686749823486,195.0458931513297,"(3.999, 24.0]",Q1
36107,2020-05-27,48560,11,2,126,132,2815,1.2857142857142858,100.85714285714286,2.647681807484114,207.69592845375382,"(3.999, 24.0]",Q1
36107,2020-05-28,48560,11,0,126,110,2925,1.1428571428571428,101.57142857142857,2.353494939985879,209.166862791245,"(3.999, 24.0]",Q1
36107,2020-05-29,48560,11,2,128,141,3066,1.0,108.0,2.059308072487644,222.40527182866558,"(3.999, 24.0]",Q1
36107,2020-05-30,48560,11,2,130,107,3173,1.1428571428571428,112.0,2.353494939985879,230.64250411861616,"(3.999, 24.0]",Q1
36107,2020-05-31,48560,11,0,130,44,3217,1.1428571428571428,110.57142857142857,2.353494939985879,227.7006354436338,"(3.999, 24.0]",Q1
36107,2020-06-01,48560,11,1,131,143,3360,1.2857142857142858,124.57142857142857,2.647681807484114,256.5309484584608,"(3.999, 24.0]",Q1
36107,2020-06-02,48560,11,2,133,123,3483,1.2857142857142858,114.28571428571429,2.647681807484114,235.34949399858792,"(3.999, 24.0]",Q1
36107,2020-06-03,48560,11,0,133,101,3584,1.0,109.85714285714286,2.059308072487644,226.22970110614264,"(3.999, 24.0]",Q1
36107,2020-06-04,48560,11,1,134,140,3724,1.1428571428571428,114.14285714285714,2.353494939985879,235.05530713108965,"(3.999, 24.0]",Q1
36107,2020-06-05,48560,11,0,134,302,4026,0.8571428571428571,137.14285714285714,1.765121204989409,282.41939279830547,"(3.999, 24.0]",Q1
36107,2020-06-06,48560,11,0,134,146,4172,0.5714285714285714,142.71428571428572,1.1767474699929394,293.89268063073666,"(3.999, 24.0]",Q1
36107,2020-06-07,48560,11,0,134,79,4251,0.5714285714285714,147.71428571428572,1.1767474699929394,304.18922099317484,"(3.999, 24.0]",Q1
36109,2020-03-02,102793,47,0,0,0,0,0.0,0.0,0.0,0.0,"(37.5, 52.0]",Q3
36109,2020-03-03,102793,47,0,0,0,0,0.0,0.0,0.0,0.0,"(37.5, 52.0]",Q3
36109,2020-03-04,102793,47,0,0,0,0,0.0,0.0,0.0,0.0,"(37.5, 52.0]",Q3
36109,2020-03-05,102793,47,0,0,0,0,0.0,0.0,0.0,0.0,"(37.5, 52.0]",Q3
36109,2020-03-06,102793,47,0,0,0,0,0.0,0.0,0.0,0.0,"(37.5, 52.0]",Q3
36109,2020-03-07,102793,47,0,0,0,0,0.0,0.0,0.0,0.0,"(37.5, 52.0]",Q3
36109,2020-03-08,102793,47,0,0,0,0,0.0,0.0,0.0,0.0,"(37.5, 52.0]",Q3
36109,2020-03-09,102793,47,0,0,1,1,0.0,0.14285714285714285,0.0,0.13897555558952734,"(37.5, 52.0]",Q3
36109,2020-03-10,102793,47,0,0,0,1,0.0,0.14285714285714285,0.0,0.13897555558952734,"(37.5, 52.0]",Q3
36109,2020-03-11,102793,47,0,0,2,3,0.0,0.42857142857142855,0.0,0.4169266667685821,"(37.5, 52.0]",Q3
36109,2020-03-12,102793,47,0,0,2,5,0.0,0.7142857142857143,0.0,0.6948777779476368,"(37.5, 52.0]",Q3
36109,2020-03-13,102793,47,1,1,5,10,0.14285714285714285,1.4285714285714286,0.13897555558952734,1.3897555558952737,"(37.5, 52.0]",Q3
36109,2020-03-14,102793,47,0,1,1,11,0.14285714285714285,1.5714285714285714,0.13897555558952734,1.528731111484801,"(37.5, 52.0]",Q3
36109,2020-03-15,102793,47,0,1,4,15,0.14285714285714285,2.142857142857143,0.13897555558952734,2.0846333338429104,"(37.5, 52.0]",Q3
36109,2020-03-16,102793,47,1,2,17,32,0.2857142857142857,4.428571428571429,0.2779511111790547,4.308242223275348,"(37.5, 52.0]",Q3
36109,2020-03-17,102793,47,1,3,11,43,0.42857142857142855,6.0,0.4169266667685821,5.836973334760149,"(37.5, 52.0]",Q3
36109,2020-03-18,102793,47,3,6,18,61,0.8571428571428571,8.285714285714286,0.8338533335371642,8.060582224192588,"(37.5, 52.0]",Q3
36109,2020-03-19,102793,47,1,7,7,68,1.0,9.0,0.9728288891266915,8.755460002140223,"(37.5, 52.0]",Q3
36109,2020-03-20,102793,47,4,11,96,164,1.4285714285714286,22.0,1.3897555558952737,21.402235560787215,"(37.5, 52.0]",Q3
36109,2020-03-21,102793,47,2,13,76,240,1.7142857142857142,32.714285714285715,1.6677066670743284,31.825402230001764,"(37.5, 52.0]",Q3
36109,2020-03-22,102793,47,2,15,115,355,2.0,48.57142857142857,1.945657778253383,47.251688900439305,"(37.5, 52.0]",Q3
36109,2020-03-23,102793,47,1,16,111,466,2.0,62.0,1.945657778253383,60.31539112585487,"(37.5, 52.0]",Q3
36109,2020-03-24,102793,47,0,16,2,468,1.8571428571428572,60.714285714285715,1.8066822226638557,59.06461112554913,"(37.5, 52.0]",Q3
36109,2020-03-25,102793,47,6,22,89,557,2.2857142857142856,70.85714285714286,2.2236088894324375,68.93187557240557,"(37.5, 52.0]",Q3
36109,2020-03-26,102793,47,4,26,109,666,2.7142857142857144,85.42857142857143,2.6405355562010198,83.10738224253737,"(37.5, 52.0]",Q3
36109,2020-03-27,102793,47,19,45,182,848,4.857142857142857,97.71428571428571,4.725168890043929,95.0592800232367,"(37.5, 52.0]",Q3
36109,2020-03-28,102793,47,7,52,128,976,5.571428571428571,105.14285714285714,5.420046667991567,102.28600891389213,"(37.5, 52.0]",Q3
36109,2020-03-29,102793,47,14,66,157,1133,7.285714285714286,111.14285714285714,7.087753335065894,108.12298224865229,"(37.5, 52.0]",Q3
36109,2020-03-30,102793,47,0,66,18,1151,7.142857142857143,97.85714285714286,6.9487777794763685,95.19825557882623,"(37.5, 52.0]",Q3
36109,2020-03-31,102793,47,2,68,15,1166,7.428571428571429,99.71428571428571,7.226728890655423,97.00493780149009,"(37.5, 52.0]",Q3
36109,2020-04-01,102793,47,6,74,126,1292,7.428571428571429,105.0,7.226728890655423,102.14703335830261,"(37.5, 52.0]",Q3
36109,2020-04-02,102793,47,10,84,160,1452,8.285714285714286,112.28571428571429,8.060582224192588,109.2347866933685,"(37.5, 52.0]",Q3
36109,2020-04-03,102793,47,1,85,81,1533,5.714285714285714,97.85714285714286,5.559022223581095,95.19825557882623,"(37.5, 52.0]",Q3
36109,2020-04-04,102793,47,3,88,52,1585,5.142857142857143,87.0,5.003120001222985,84.63611335402216,"(37.5, 52.0]",Q3
36109,2020-04-05,102793,47,6,94,94,1679,4.0,78.0,3.891315556506766,75.88065335188195,"(37.5, 52.0]",Q3
36109,2020-04-06,102793,47,3,97,23,1702,4.428571428571429,78.71428571428571,4.308242223275348,76.57553112982957,"(37.5, 52.0]",Q3
36109,2020-04-07,102793,47,2,99,85,1787,4.428571428571429,88.71428571428571,4.308242223275348,86.30382002109648,"(37.5, 52.0]",Q3
36109,2020-04-08,102793,47,6,105,299,2086,4.428571428571429,113.42857142857143,4.308242223275348,110.34659113808472,"(37.5, 52.0]",Q3
36109,2020-04-09,102793,47,0,105,24,2110,3.0,94.0,2.9184866673800745,91.445915577909,"(37.5, 52.0]",Q3
36109,2020-04-10,102793,47,3,108,135,2245,3.2857142857142856,101.71428571428571,3.196437778559129,98.95059557974348,"(37.5, 52.0]",Q3
36109,2020-04-11,102793,47,1,109,77,2322,3.0,105.28571428571429,2.9184866673800745,102.42498446948167,"(37.5, 52.0]",Q3
36109,2020-04-12,102793,47,1,110,31,2353,2.2857142857142856,96.28571428571429,2.2236088894324375,93.66952446734145,"(37.5, 52.0]",Q3
36109,2020-04-13,102793,47,2,112,104,2457,2.142857142857143,107.85714285714286,2.0846333338429104,104.92654447009316,"(37.5, 52.0]",Q3
36109,2020-04-14,102793,47,3,115,44,2501,2.2857142857142856,102.0,2.2236088894324375,99.22854669092253,"(37.5, 52.0]",Q3
36109,2020-04-15,102793,47,1,116,73,2574,1.5714285714285714,69.71428571428571,1.528731111484801,67.82007112768935,"(37.5, 52.0]",Q3
36109,2020-04-16,102793,47,1,117,36,2610,1.7142857142857142,71.42857142857143,1.6677066670743284,69.48777779476369,"(37.5, 52.0]",Q3
36109,2020-04-17,102793,47,0,117,44,2654,1.2857142857142858,58.42857142857143,1.2507800003057463,56.841002236116694,"(37.5, 52.0]",Q3
36109,2020-04-18,102793,47,0,117,41,2695,1.1428571428571428,53.285714285714285,1.1118044447162188,51.8378822348937,"(37.5, 52.0]",Q3
36109,2020-04-19,102793,47,2,119,47,2742,1.2857142857142858,55.57142857142857,1.2507800003057463,54.061491124326146,"(37.5, 52.0]",Q3
36109,2020-04-20,102793,47,0,119,4,2746,1.0,41.285714285714285,0.9728288891266915,40.16393556537341,"(37.5, 52.0]",Q3
36109,2020-04-21,102793,47,0,119,12,2758,0.5714285714285714,36.714285714285715,0.5559022223581094,35.71671778650853,"(37.5, 52.0]",Q3
36109,2020-04-22,102793,47,0,119,95,2853,0.42857142857142855,39.857142857142854,0.4169266667685821,38.77418000947813,"(37.5, 52.0]",Q3
36109,2020-04-23,102793,47,2,121,108,2961,0.5714285714285714,50.142857142857146,0.5559022223581094,48.78042001192411,"(37.5, 52.0]",Q3
36109,2020-04-24,102793,47,5,126,308,3269,1.2857142857142858,87.85714285714286,1.2507800003057463,85.46996668755932,"(37.5, 52.0]",Q3
36109,2020-04-25,102793,47,0,126,44,3313,1.2857142857142858,88.28571428571429,1.2507800003057463,85.88689335432792,"(37.5, 52.0]",Q3
36109,2020-04-26,102793,47,0,126,47,3360,1.0,88.28571428571429,0.9728288891266915,85.88689335432792,"(37.5, 52.0]",Q3
36109,2020-04-27,102793,47,0,126,13,3373,1.0,89.57142857142857,0.9728288891266915,87.13767335463365,"(37.5, 52.0]",Q3
36109,2020-04-28,102793,47,1,127,119,3492,1.1428571428571428,104.85714285714286,1.1118044447162188,102.00805780271307,"(37.5, 52.0]",Q3
36109,2020-04-29,102793,47,1,128,19,3511,1.2857142857142858,94.0,1.2507800003057463,91.445915577909,"(37.5, 52.0]",Q3
36109,2020-04-30,102793,47,0,128,61,3572,1.0,87.28571428571429,0.9728288891266915,84.91406446520122,"(37.5, 52.0]",Q3
36109,2020-05-01,102793,47,0,128,118,3690,0.2857142857142857,60.142857142857146,0.2779511111790547,58.50870890319102,"(37.5, 52.0]",Q3
36109,2020-05-02,102793,47,1,129,27,3717,0.42857142857142855,57.714285714285715,0.4169266667685821,56.14612445816905,"(37.5, 52.0]",Q3
36109,2020-05-03,102793,47,0,129,126,3843,0.42857142857142855,69.0,0.4169266667685821,67.12519334974172,"(37.5, 52.0]",Q3
36109,2020-05-04,102793,47,0,129,52,3895,0.42857142857142855,74.57142857142857,0.4169266667685821,72.54524001773328,"(37.5, 52.0]",Q3
36109,2020-05-05,102793,47,0,129,104,3999,0.2857142857142857,72.42857142857143,0.2779511111790547,70.46060668389038,"(37.5, 52.0]",Q3
36109,2020-05-06,102793,47,1,130,188,4187,0.2857142857142857,96.57142857142857,0.2779511111790547,93.9474755785205,"(37.5, 52.0]",Q3
36109,2020-05-07,102793,47,1,131,187,4374,0.42857142857142855,114.57142857142857,0.4169266667685821,111.45839558280093,"(37.5, 52.0]",Q3
36109,2020-05-08,102793,47,1,132,619,4993,0.5714285714285714,186.14285714285714,0.5559022223581094,181.08514893315416,"(37.5, 52.0]",Q3
36109,2020-05-09,102793,47,0,132,95,5088,0.42857142857142855,195.85714285714286,0.4169266667685821,190.535486713242,"(37.5, 52.0]",Q3
36109,2020-05-10,102793,47,0,132,86,5174,0.42857142857142855,190.14285714285714,0.4169266667685821,184.9764644896609,"(37.5, 52.0]",Q3
36109,2020-05-11,102793,47,0,132,91,5265,0.42857142857142855,195.71428571428572,0.4169266667685821,190.39651115765247,"(37.5, 52.0]",Q3
36109,2020-05-12,102793,47,4,136,175,5440,1.0,205.85714285714286,0.9728288891266915,200.2637756045089,"(37.5, 52.0]",Q3
36109,2020-05-13,102793,47,0,136,103,5543,0.8571428571428571,193.71428571428572,0.8338533335371642,188.4508533793991,"(37.5, 52.0]",Q3
36109,2020-05-14,102793,47,0,136,112,5655,0.7142857142857143,183.0,0.6948777779476368,178.02768671018455,"(37.5, 52.0]",Q3
36109,2020-05-15,102793,47,2,138,331,5986,0.8571428571428571,141.85714285714286,0.8338533335371642,138.00272670040067,"(37.5, 52.0]",Q3
36109,2020-05-16,102793,47,1,139,421,6407,1.0,188.42857142857142,0.9728288891266915,183.30875782258659,"(37.5, 52.0]",Q3
36109,2020-05-17,102793,47,2,141,412,6819,1.2857142857142858,235.0,1.2507800003057463,228.61478894477253,"(37.5, 52.0]",Q3
36109,2020-05-18,102793,47,1,142,446,7265,1.4285714285714286,285.7142857142857,1.3897555558952737,277.95111117905475,"(37.5, 52.0]",Q3
36109,2020-05-19,102793,47,3,145,219,7484,1.2857142857142858,292.0,1.2507800003057463,284.06603562499396,"(37.5, 52.0]",Q3
36109,2020-05-20,102793,47,0,145,199,7683,1.2857142857142858,305.7142857142857,1.2507800003057463,297.4076889615886,"(37.5, 52.0]",Q3
36109,2020-05-21,102793,47,2,147,291,7974,1.5714285714285714,331.2857142857143,1.528731111484801,322.28431341211393,"(37.5, 52.0]",Q3
36109,2020-05-22,102793,47,2,149,410,8384,1.5714285714285714,342.57142857142856,1.528731111484801,333.26338230368657,"(37.5, 52.0]",Q3
36109,2020-05-23,102793,47,2,151,246,8630,1.7142857142857142,317.57142857142856,1.6677066670743284,308.9426600755193,"(37.5, 52.0]",Q3
36109,2020-05-24,102793,47,3,154,267,8897,1.8571428571428572,296.85714285714283,1.8066822226638557,288.7912045150378,"(37.5, 52.0]",Q3
36109,2020-05-25,102793,47,0,154,48,8945,1.7142857142857142,240.0,1.6677066670743284,233.47893339040596,"(37.5, 52.0]",Q3
36109,2020-05-26,102793,47,1,155,264,9209,1.4285714285714286,246.42857142857142,1.3897555558952737,239.7328333919347,"(37.5, 52.0]",Q3
36109,2020-05-27,102793,47,1,156,110,9319,1.5714285714285714,233.71428571428572,1.528731111484801,227.36400894446678,"(37.5, 52.0]",Q3
36109,2020-05-28,102793,47,1,157,425,9744,1.4285714285714286,252.85714285714286,1.3897555558952737,245.98673339346345,"(37.5, 52.0]",Q3
36109,2020-05-29,102793,47,4,161,264,10008,1.7142857142857142,232.0,1.6677066670743284,225.69630227739242,"(37.5, 52.0]",Q3
36109,2020-05-30,102793,47,3,164,389,10397,1.8571428571428572,252.42857142857142,1.8066822226638557,245.56980672669482,"(37.5, 52.0]",Q3
36109,2020-05-31,102793,47,0,164,149,10546,1.4285714285714286,235.57142857142858,1.3897555558952737,229.17069116713063,"(37.5, 52.0]",Q3
36109,2020-06-01,102793,47,0,164,168,10714,1.4285714285714286,252.71428571428572,1.3897555558952737,245.84775783787393,"(37.5, 52.0]",Q3
36109,2020-06-02,102793,47,1,165,203,10917,1.4285714285714286,244.0,1.3897555558952737,237.3702489469127,"(37.5, 52.0]",Q3
36109,2020-06-03,102793,47,0,165,206,11123,1.2857142857142858,257.7142857142857,1.2507800003057463,250.71190228350736,"(37.5, 52.0]",Q3
36109,2020-06-04,102793,47,2,167,171,11294,1.4285714285714286,221.42857142857142,1.3897555558952737,215.4121111637674,"(37.5, 52.0]",Q3
36109,2020-06-05,102793,47,4,171,1067,12361,1.4285714285714286,336.14285714285717,1.3897555558952737,327.0094823021579,"(37.5, 52.0]",Q3
36109,2020-06-06,102793,47,0,171,518,12879,1.0,354.57142857142856,0.9728288891266915,344.9373289732069,"(37.5, 52.0]",Q3
36109,2020-06-07,102793,47,0,171,148,13027,1.0,354.42857142857144,0.9728288891266915,344.79835341761736,"(37.5, 52.0]",Q3
36111,2020-03-02,178599,34,0,0,0,0,0.0,0.0,0.0,0.0,"(24.0, 37.5]",Q2
36111,2020-03-03,178599,34,0,0,0,0,0.0,0.0,0.0,0.0,"(24.0, 37.5]",Q2
36111,2020-03-04,178599,34,0,0,0,0,0.0,0.0,0.0,0.0,"(24.0, 37.5]",Q2
36111,2020-03-05,178599,34,0,0,1,1,0.0,1.0,0.0,0.5599135493479808,"(24.0, 37.5]",Q2
36111,2020-03-06,178599,34,0,0,0,1,0.0,0.0,0.0,0.0,"(24.0, 37.5]",Q2
36111,2020-03-07,178599,34,0,0,0,1,0.0,0.0,0.0,0.0,"(24.0, 37.5]",Q2
36111,2020-03-08,178599,34,1,1,1,2,0.14285714285714285,0.2857142857142857,0.07998764990685438,0.15997529981370875,"(24.0, 37.5]",Q2
36111,2020-03-09,178599,34,0,1,0,2,0.14285714285714285,0.2857142857142857,0.07998764990685438,0.15997529981370875,"(24.0, 37.5]",Q2
36111,2020-03-10,178599,34,0,1,2,4,0.14285714285714285,0.5714285714285714,0.07998764990685438,0.3199505996274175,"(24.0, 37.5]",Q2
36111,2020-03-11,178599,34,1,2,1,5,0.2857142857142857,0.7142857142857143,0.15997529981370875,0.3999382495342719,"(24.0, 37.5]",Q2
36111,2020-03-12,178599,34,3,5,6,11,0.7142857142857143,1.4285714285714286,0.3999382495342719,0.7998764990685437,"(24.0, 37.5]",Q2
36111,2020-03-13,178599,34,0,5,3,14,0.7142857142857143,1.8571428571428572,0.3999382495342719,1.039839448789107,"(24.0, 37.5]",Q2
36111,2020-03-14,178599,34,0,5,30,44,0.7142857142857143,6.142857142857143,0.3999382495342719,3.4394689459947387,"(24.0, 37.5]",Q2
36111,2020-03-15,178599,34,2,7,16,60,0.8571428571428571,8.285714285714286,0.47992589944112624,4.639283694597554,"(24.0, 37.5]",Q2
36111,2020-03-16,178599,34,1,8,12,72,1.0,10.0,0.5599135493479808,5.599135493479807,"(24.0, 37.5]",Q2
36111,2020-03-17,178599,34,1,9,15,87,1.1428571428571428,11.857142857142858,0.639901199254835,6.638974942268914,"(24.0, 37.5]",Q2
36111,2020-03-18,178599,34,1,10,41,128,1.1428571428571428,17.571428571428573,0.639901199254835,9.83848093854309,"(24.0, 37.5]",Q2
36111,2020-03-19,178599,34,2,12,62,190,1.0,25.571428571428573,0.5599135493479808,14.317789333326933,"(24.0, 37.5]",Q2
36111,2020-03-20,178599,34,6,18,70,260,1.8571428571428572,35.142857142857146,1.039839448789107,19.67696187708618,"(24.0, 37.5]",Q2
36111,2020-03-21,178599,34,8,26,145,405,3.0,51.57142857142857,1.679740648043942,28.875541616374434,"(24.0, 37.5]",Q2
36111,2020-03-22,178599,34,9,35,54,459,4.0,57.0,2.239654197391923,31.9150723128349,"(24.0, 37.5]",Q2
36111,2020-03-23,178599,34,12,47,117,576,5.571428571428571,72.0,3.119518346367321,40.31377555305461,"(24.0, 37.5]",Q2
36111,2020-03-24,178599,34,18,65,81,657,8.0,81.42857142857143,4.479308394783846,45.592960446907,"(24.0, 37.5]",Q2
36111,2020-03-25,178599,34,13,78,71,728,9.714285714285714,85.71428571428571,5.439160193666098,47.99258994411262,"(24.0, 37.5]",Q2
36111,2020-03-26,178599,34,21,99,83,811,12.428571428571429,88.71428571428571,6.958925541896331,49.67233059215657,"(24.0, 37.5]",Q2
36111,2020-03-27,178599,34,29,128,124,935,15.714285714285714,96.42857142857143,8.798641489753981,53.99166368712671,"(24.0, 37.5]",Q2
36111,2020-03-28,178599,34,18,146,82,1017,17.142857142857142,87.42857142857143,9.598517988822525,48.952441742994885,"(24.0, 37.5]",Q2
36111,2020-03-29,178599,34,44,190,194,1211,22.142857142857142,107.42857142857143,12.398085735562429,60.1507127299545,"(24.0, 37.5]",Q2
36111,2020-03-30,178599,34,21,211,123,1334,23.428571428571427,108.28571428571429,13.117974584724118,60.63063862939563,"(24.0, 37.5]",Q2
36111,2020-03-31,178599,34,10,221,51,1385,22.285714285714285,104.0,12.478073385469283,58.23100913218999,"(24.0, 37.5]",Q2
36111,2020-04-01,178599,34,19,240,118,1503,23.142857142857142,110.71428571428571,12.957999284910409,61.99042867781215,"(24.0, 37.5]",Q2
36111,2020-04-02,178599,34,23,263,125,1628,23.428571428571427,116.71428571428571,13.117974584724118,65.34990997390003,"(24.0, 37.5]",Q2
36111,2020-04-03,178599,34,27,290,141,1769,23.142857142857142,119.14285714285714,12.957999284910409,66.70970002231655,"(24.0, 37.5]",Q2
36111,2020-04-04,178599,34,42,332,188,1957,26.571428571428573,134.28571428571428,14.877702882674916,75.18839091244311,"(24.0, 37.5]",Q2
36111,2020-04-05,178599,34,40,372,182,2139,26.0,132.57142857142858,14.557752283047497,74.22853911356087,"(24.0, 37.5]",Q2
36111,2020-04-06,178599,34,26,398,117,2256,26.714285714285715,131.71428571428572,14.95769053258177,73.74861321411974,"(24.0, 37.5]",Q2
36111,2020-04-07,178599,34,24,422,108,2364,28.714285714285715,139.85714285714286,16.07751763127773,78.30790925881044,"(24.0, 37.5]",Q2
36111,2020-04-08,178599,34,38,460,227,2591,31.428571428571427,155.42857142857142,17.597282979507963,87.02656309865756,"(24.0, 37.5]",Q2
36111,2020-04-09,178599,34,70,530,436,3027,38.142857142857146,199.85714285714286,21.35670252513012,111.9027222196893,"(24.0, 37.5]",Q2
36111,2020-04-10,178599,34,59,589,358,3385,42.714285714285715,230.85714285714286,23.91630732214946,129.2600422494767,"(24.0, 37.5]",Q2
36111,2020-04-11,178599,34,23,612,239,3624,40.0,238.14285714285714,22.396541973919227,133.33941239472625,"(24.0, 37.5]",Q2
36111,2020-04-12,178599,34,18,630,242,3866,36.857142857142854,246.71428571428572,20.63681367596843,138.1386713891375,"(24.0, 37.5]",Q2
36111,2020-04-13,178599,34,60,690,424,4290,41.714285714285715,290.57142857142856,23.356393772801482,162.6948799105418,"(24.0, 37.5]",Q2
36111,2020-04-14,178599,34,43,733,259,4549,44.42857142857143,312.14285714285717,24.876159121031716,174.77301504647684,"(24.0, 37.5]",Q2
36111,2020-04-15,178599,34,28,761,189,4738,43.0,306.7142857142857,24.07628262196317,171.73348435001637,"(24.0, 37.5]",Q2
36111,2020-04-16,178599,34,27,788,142,4880,36.857142857142854,264.7142857142857,20.63681367596843,148.21711527740118,"(24.0, 37.5]",Q2
36111,2020-04-17,178599,34,32,820,239,5119,33.0,247.71428571428572,18.47714712848336,138.6985849384855,"(24.0, 37.5]",Q2
36111,2020-04-18,178599,34,34,854,170,5289,34.57142857142857,237.85714285714286,19.357011277458756,133.17943709491254,"(24.0, 37.5]",Q2
36111,2020-04-19,178599,34,23,877,167,5456,35.285714285714285,227.14285714285714,19.756949526993033,127.18036335189846,"(24.0, 37.5]",Q2
36111,2020-04-20,178599,34,16,893,85,5541,29.0,178.71428571428572,16.237492931091438,100.06455003347483,"(24.0, 37.5]",Q2
36111,2020-04-21,178599,34,20,913,110,5651,25.714285714285715,157.42857142857142,14.39777698323379,88.14639019735353,"(24.0, 37.5]",Q2
36111,2020-04-22,178599,34,29,942,152,5803,25.857142857142858,152.14285714285714,14.477764633140643,85.18684715079992,"(24.0, 37.5]",Q2
36111,2020-04-23,178599,34,34,976,208,6011,26.857142857142858,161.57142857142858,15.037678182488625,90.46603204465231,"(24.0, 37.5]",Q2
36111,2020-04-24,178599,34,190,1166,928,6939,49.42857142857143,260.0,27.67572686777162,145.57752283047498,"(24.0, 37.5]",Q2
36111,2020-04-25,178599,34,24,1190,207,7146,48.0,265.2857142857143,26.875850368703073,148.5370658770286,"(24.0, 37.5]",Q2
36111,2020-04-26,178599,34,29,1219,198,7344,48.857142857142854,269.7142857142857,27.3557762681442,151.0166830241411,"(24.0, 37.5]",Q2
36111,2020-04-27,178599,34,11,1230,94,7438,48.142857142857146,271.0,26.955838018609928,151.73657187330275,"(24.0, 37.5]",Q2
36111,2020-04-28,178599,34,22,1252,335,7773,48.42857142857143,303.14285714285717,27.115813318423633,169.733793102345,"(24.0, 37.5]",Q2
36111,2020-04-29,178599,34,27,1279,309,8082,48.142857142857146,325.57142857142856,26.955838018609928,182.29185413772112,"(24.0, 37.5]",Q2
36111,2020-04-30,178599,34,19,1298,336,8418,46.0,343.85714285714283,25.756023270007113,192.53027332579848,"(24.0, 37.5]",Q2
36111,2020-05-01,178599,34,29,1327,362,8780,23.0,263.0,12.878011635003556,147.25726347851892,"(24.0, 37.5]",Q2
36111,2020-05-02,178599,34,14,1341,256,9036,21.571428571428573,270.0,12.078135135935012,151.1766583239548,"(24.0, 37.5]",Q2
36111,2020-05-03,178599,34,13,1354,198,9234,19.285714285714285,270.0,10.79833273742534,151.1766583239548,"(24.0, 37.5]",Q2
36111,2020-05-04,178599,34,3,1357,104,9338,18.142857142857142,271.42857142857144,10.158431538170507,151.97653482302331,"(24.0, 37.5]",Q2
36111,2020-05-05,178599,34,26,1383,272,9610,18.714285714285715,262.42857142857144,10.478382137797924,146.9373128788915,"(24.0, 37.5]",Q2
36111,2020-05-06,178599,34,33,1416,298,9908,19.571428571428573,260.85714285714283,10.958308037239052,146.0574487299161,"(24.0, 37.5]",Q2
36111,2020-05-07,178599,34,13,1429,276,10184,18.714285714285715,252.28571428571428,10.478382137797924,141.25818973550483,"(24.0, 37.5]",Q2
36111,2020-05-08,178599,34,11,1440,195,10379,16.142857142857142,228.42857142857142,9.038604439474545,127.90025220106014,"(24.0, 37.5]",Q2
36111,2020-05-09,178599,34,10,1450,210,10589,15.571428571428571,221.85714285714286,8.718653839847127,124.22082030534484,"(24.0, 37.5]",Q2
36111,2020-05-10,178599,34,4,1454,135,10724,14.285714285714286,212.85714285714286,7.998764990685438,119.18159836121302,"(24.0, 37.5]",Q2
36111,2020-05-11,178599,34,11,1465,96,10820,15.428571428571429,211.71428571428572,8.638666189940272,118.5416971619582,"(24.0, 37.5]",Q2
36111,2020-05-12,178599,34,16,1481,314,11134,14.0,217.71428571428572,7.838789690871729,121.90117845804608,"(24.0, 37.5]",Q2
36111,2020-05-13,178599,34,14,1495,536,11670,11.285714285714286,251.71428571428572,6.319024342641497,140.9382391358774,"(24.0, 37.5]",Q2
36111,2020-05-14,178599,34,16,1511,431,12101,11.714285714285714,273.85714285714283,6.558987292362059,153.33632487143984,"(24.0, 37.5]",Q2
36111,2020-05-15,178599,34,26,1537,398,12499,13.857142857142858,302.85714285714283,7.758802040964874,169.5738178025313,"(24.0, 37.5]",Q2
36111,2020-05-16,178599,34,15,1552,345,12844,14.571428571428571,322.14285714285717,8.158740290499146,180.37215053995664,"(24.0, 37.5]",Q2
36111,2020-05-17,178599,34,5,1557,227,13071,14.714285714285714,335.2857142857143,8.238727940406001,187.73101433138723,"(24.0, 37.5]",Q2
36111,2020-05-18,178599,34,8,1565,177,13248,14.285714285714286,346.85714285714283,7.998764990685438,194.21001397384242,"(24.0, 37.5]",Q2
36111,2020-05-19,178599,34,6,1571,284,13532,12.857142857142858,342.57142857142856,7.198888491616895,191.81038447663678,"(24.0, 37.5]",Q2
36111,2020-05-20,178599,34,13,1584,799,14331,12.714285714285714,380.14285714285717,7.118900841710039,212.84713640213954,"(24.0, 37.5]",Q2
36111,2020-05-21,178599,34,11,1595,552,14883,12.0,397.42857142857144,6.718962592175768,222.5256420408689,"(24.0, 37.5]",Q2
36111,2020-05-22,178599,34,11,1606,418,15301,9.857142857142858,400.2857142857143,5.519147843572952,224.12539503900595,"(24.0, 37.5]",Q2
36111,2020-05-23,178599,34,11,1617,470,15771,9.285714285714286,418.14285714285717,5.199197243945536,234.1238512773628,"(24.0, 37.5]",Q2
36111,2020-05-24,178599,34,15,1632,590,16361,10.714285714285714,470.0,5.999073743014078,263.1593681935509,"(24.0, 37.5]",Q2
36111,2020-05-25,178599,34,6,1638,162,16523,10.428571428571429,467.85714285714283,5.8390984432003705,261.9595534449481,"(24.0, 37.5]",Q2
36111,2020-05-26,178599,34,7,1645,355,16878,10.571428571428571,478.0,5.919086093107224,267.63867658833476,"(24.0, 37.5]",Q2
36111,2020-05-27,178599,34,13,1658,556,17434,10.571428571428571,443.2857142857143,5.919086093107224,248.20167766096915,"(24.0, 37.5]",Q2
36111,2020-05-28,178599,34,5,1663,683,18117,9.714285714285714,462.0,5.439160193666098,258.6800597987671,"(24.0, 37.5]",Q2
36111,2020-05-29,178599,34,15,1678,746,18863,10.285714285714286,508.85714285714283,5.759110793293516,284.9160089682153,"(24.0, 37.5]",Q2
36111,2020-05-30,178599,34,7,1685,529,19392,9.714285714285714,517.2857142857143,5.439160193666098,289.6352803127198,"(24.0, 37.5]",Q2
36111,2020-05-31,178599,34,6,1691,538,19930,8.428571428571429,509.85714285714283,4.719271344504409,285.4759225175633,"(24.0, 37.5]",Q2
36111,2020-06-01,178599,34,5,1696,327,20257,8.285714285714286,533.4285714285714,4.639283694597554,298.6738847521943,"(24.0, 37.5]",Q2
36111,2020-06-02,178599,34,5,1701,504,20761,8.0,554.7142857142857,4.479308394783846,310.59204458831556,"(24.0, 37.5]",Q2
36111,2020-06-03,178599,34,3,1704,617,21378,6.571428571428571,563.4285714285714,3.6794318957153016,315.4712912326337,"(24.0, 37.5]",Q2
36111,2020-06-04,178599,34,7,1711,1121,22499,6.857142857142857,626.0,3.83940719552901,350.5058818918359,"(24.0, 37.5]",Q2
36111,2020-06-05,178599,34,3,1714,776,23275,5.142857142857143,630.2857142857143,2.879555396646758,352.9055113890415,"(24.0, 37.5]",Q2
36111,2020-06-06,178599,34,4,1718,600,23875,4.714285714285714,640.4285714285714,2.6395924469261947,358.5846345324282,"(24.0, 37.5]",Q2
36111,2020-06-07,178599,34,3,1721,644,24519,4.285714285714286,655.5714285714286,2.3996294972056313,367.0633254225548,"(24.0, 37.5]",Q2
36113,2020-03-02,64265,22,0,0,0,0,0.0,0.0,0.0,0.0,"(3.999, 24.0]",Q1
36113,2020-03-03,64265,22,0,0,0,0,0.0,0.0,0.0,0.0,"(3.999, 24.0]",Q1
36113,2020-03-04,64265,22,0,0,0,0,0.0,0.0,0.0,0.0,"(3.999, 24.0]",Q1
36113,2020-03-05,64265,22,0,0,0,0,0.0,0.0,0.0,0.0,"(3.999, 24.0]",Q1
36113,2020-03-06,64265,22,0,0,0,0,0.0,0.0,0.0,0.0,"(3.999, 24.0]",Q1
36113,2020-03-07,64265,22,0,0,1,1,0.0,1.0,0.0,1.5560569516844316,"(3.999, 24.0]",Q1
36113,2020-03-08,64265,22,0,0,0,1,0.0,0.14285714285714285,0.0,0.22229385024063306,"(3.999, 24.0]",Q1
36113,2020-03-09,64265,22,0,0,0,1,0.0,0.14285714285714285,0.0,0.22229385024063306,"(3.999, 24.0]",Q1
36113,2020-03-10,64265,22,0,0,2,3,0.0,0.42857142857142855,0.0,0.6668815507218993,"(3.999, 24.0]",Q1
36113,2020-03-11,64265,22,0,0,1,4,0.0,0.5714285714285714,0.0,0.8891754009625322,"(3.999, 24.0]",Q1
36113,2020-03-12,64265,22,0,0,0,4,0.0,0.5714285714285714,0.0,0.8891754009625322,"(3.999, 24.0]",Q1
36113,2020-03-13,64265,22,0,0,2,6,0.0,0.8571428571428571,0.0,1.3337631014437985,"(3.999, 24.0]",Q1
36113,2020-03-14,64265,22,0,0,13,19,0.0,2.5714285714285716,0.0,4.0012893043313955,"(3.999, 24.0]",Q1
36113,2020-03-15,64265,22,0,0,12,31,0.0,4.285714285714286,0.0,6.6688155072189925,"(3.999, 24.0]",Q1
36113,2020-03-16,64265,22,0,0,14,45,0.0,6.285714285714286,0.0,9.780929410587856,"(3.999, 24.0]",Q1
36113,2020-03-17,64265,22,1,1,16,61,0.14285714285714285,8.285714285714286,0.22229385024063306,12.89304331395672,"(3.999, 24.0]",Q1
36113,2020-03-18,64265,22,0,1,8,69,0.14285714285714285,9.285714285714286,0.22229385024063306,14.449100265641153,"(3.999, 24.0]",Q1
36113,2020-03-19,64265,22,0,1,17,86,0.14285714285714285,11.714285714285714,0.22229385024063306,18.22809571973191,"(3.999, 24.0]",Q1
36113,2020-03-20,64265,22,0,1,31,117,0.14285714285714285,15.857142857142858,0.22229385024063306,24.674617376710277,"(3.999, 24.0]",Q1
36113,2020-03-21,64265,22,0,1,28,145,0.14285714285714285,18.0,0.22229385024063306,28.00902513031977,"(3.999, 24.0]",Q1
36113,2020-03-22,64265,22,1,2,81,226,0.2857142857142857,27.857142857142858,0.4445877004812661,43.34730079692345,"(3.999, 24.0]",Q1
36113,2020-03-23,64265,22,0,2,8,234,0.2857142857142857,27.0,0.4445877004812661,42.013537695479656,"(3.999, 24.0]",Q1
36113,2020-03-24,64265,22,0,2,52,286,0.14285714285714285,32.142857142857146,0.22229385024063306,50.01611630414245,"(3.999, 24.0]",Q1
36113,2020-03-25,64265,22,0,2,16,302,0.14285714285714285,33.285714285714285,0.22229385024063306,51.794467106067515,"(3.999, 24.0]",Q1
36113,2020-03-26,64265,22,6,8,54,356,1.0,38.57142857142857,1.5560569516844316,60.019339564970934,"(3.999, 24.0]",Q1
36113,2020-03-27,64265,22,5,13,59,415,1.7142857142857142,42.57142857142857,2.667526202887597,66.24356737170866,"(3.999, 24.0]",Q1
36113,2020-03-28,64265,22,5,18,38,453,2.4285714285714284,44.0,3.778995454090762,68.466505874115,"(3.999, 24.0]",Q1
36113,2020-03-29,64265,22,0,18,3,456,2.2857142857142856,32.857142857142854,3.556701603850129,51.127585555345604,"(3.999, 24.0]",Q1
36113,2020-03-30,64265,22,0,18,6,462,2.2857142857142856,32.57142857142857,3.556701603850129,50.68299785486435,"(3.999, 24.0]",Q1
36113,2020-03-31,64265,22,0,18,7,469,2.2857142857142856,26.142857142857142,3.556701603850129,40.679774594035855,"(3.999, 24.0]",Q1
36113,2020-04-01,64265,22,0,18,9,478,2.2857142857142856,25.142857142857142,3.556701603850129,39.12371764235142,"(3.999, 24.0]",Q1
36113,2020-04-02,64265,22,1,19,11,489,1.5714285714285714,19.0,2.445232352646964,29.565082082004203,"(3.999, 24.0]",Q1
36113,2020-04-03,64265,22,1,20,7,496,1.0,11.571428571428571,1.5560569516844316,18.005801869491282,"(3.999, 24.0]",Q1
36113,2020-04-04,64265,22,5,25,13,509,1.0,8.0,1.5560569516844316,12.448455613475453,"(3.999, 24.0]",Q1
36113,2020-04-05,64265,22,1,26,12,521,1.1428571428571428,9.285714285714286,1.7783508019250645,14.449100265641153,"(3.999, 24.0]",Q1
36113,2020-04-06,64265,22,5,31,15,536,1.8571428571428572,10.571428571428571,2.8898200531282305,16.44974491780685,"(3.999, 24.0]",Q1
36113,2020-04-07,64265,22,2,33,14,550,2.142857142857143,11.571428571428571,3.3344077536094963,18.005801869491282,"(3.999, 24.0]",Q1
36113,2020-04-08,64265,22,7,40,31,581,3.142857142857143,14.714285714285714,4.890464705293928,22.896266574785205,"(3.999, 24.0]",Q1
36113,2020-04-09,64265,22,3,43,21,602,3.4285714285714284,16.142857142857142,5.335052405775194,25.119205077191538,"(3.999, 24.0]",Q1
36113,2020-04-10,64265,22,1,44,17,619,3.4285714285714284,17.571428571428573,5.335052405775194,27.34214357959787,"(3.999, 24.0]",Q1
36113,2020-04-11,64265,22,2,46,20,639,3.0,18.571428571428573,4.668170855053296,28.898200531282306,"(3.999, 24.0]",Q1
36113,2020-04-12,64265,22,2,48,18,657,3.142857142857143,19.428571428571427,4.890464705293928,30.231963632726096,"(3.999, 24.0]",Q1
36113,2020-04-13,64265,22,29,77,67,724,6.571428571428571,26.857142857142858,10.225517111069122,41.79124384523902,"(3.999, 24.0]",Q1
36113,2020-04-14,64265,22,0,77,7,731,6.285714285714286,25.857142857142858,9.780929410587856,40.23518689355459,"(3.999, 24.0]",Q1
36113,2020-04-15,64265,22,4,81,35,766,5.857142857142857,26.428571428571427,9.114047859865956,41.12436229451712,"(3.999, 24.0]",Q1
36113,2020-04-16,64265,22,10,91,41,807,6.857142857142857,29.285714285714285,10.670104811550388,45.570239299329785,"(3.999, 24.0]",Q1
36113,2020-04-17,64265,22,3,94,38,845,7.142857142857143,32.285714285714285,11.114692512031656,50.238410154383075,"(3.999, 24.0]",Q1
36113,2020-04-18,64265,22,2,96,27,872,7.142857142857143,33.285714285714285,11.114692512031656,51.794467106067515,"(3.999, 24.0]",Q1
36113,2020-04-19,64265,22,5,101,20,892,7.571428571428571,33.57142857142857,11.781574062753553,52.23905480654877,"(3.999, 24.0]",Q1
36113,2020-04-20,64265,22,1,102,13,905,3.5714285714285716,25.857142857142858,5.557346256015828,40.23518689355459,"(3.999, 24.0]",Q1
36113,2020-04-21,64265,22,6,108,33,938,4.428571428571429,29.571428571428573,6.8911093574596265,46.01482699981105,"(3.999, 24.0]",Q1
36113,2020-04-22,64265,22,11,119,40,978,5.428571428571429,30.285714285714285,8.447166309144057,47.12629625101421,"(3.999, 24.0]",Q1
36113,2020-04-23,64265,22,3,122,38,1016,4.428571428571429,29.857142857142858,6.8911093574596265,46.459414700292314,"(3.999, 24.0]",Q1
36113,2020-04-24,64265,22,10,132,94,1110,5.428571428571429,37.857142857142854,8.447166309144057,58.907870313767766,"(3.999, 24.0]",Q1
36113,2020-04-25,64265,22,3,135,61,1171,5.571428571428571,42.714285714285715,8.66946015938469,66.4658612219493,"(3.999, 24.0]",Q1
36113,2020-04-26,64265,22,12,147,60,1231,6.571428571428571,48.42857142857143,10.225517111069122,75.35761523157463,"(3.999, 24.0]",Q1
36113,2020-04-27,64265,22,3,150,25,1256,6.857142857142857,50.142857142857146,10.670104811550388,78.02514143446223,"(3.999, 24.0]",Q1
36113,2020-04-28,64265,22,2,152,12,1268,6.285714285714286,47.142857142857146,9.780929410587856,73.35697057940892,"(3.999, 24.0]",Q1
36113,2020-04-29,64265,22,24,176,105,1373,8.142857142857142,56.42857142857143,12.670749463716087,87.80607084505009,"(3.999, 24.0]",Q1
36113,2020-04-30,64265,22,6,182,94,1467,8.571428571428571,64.42857142857143,13.337631014437985,100.25452645852553,"(3.999, 24.0]",Q1
36113,2020-05-01,64265,22,3,185,66,1533,7.571428571428571,60.42857142857143,11.781574062753553,94.0302986517878,"(3.999, 24.0]",Q1
36113,2020-05-02,64265,22,3,188,43,1576,7.571428571428571,57.857142857142854,11.781574062753553,90.0290093474564,"(3.999, 24.0]",Q1
36113,2020-05-03,64265,22,4,192,53,1629,6.428571428571429,56.857142857142854,10.00322326082849,88.47295239577197,"(3.999, 24.0]",Q1
36113,2020-05-04,64265,22,0,192,34,1663,6.0,58.142857142857146,9.336341710106591,90.47359704793767,"(3.999, 24.0]",Q1
36113,2020-05-05,64265,22,1,193,22,1685,5.857142857142857,59.57142857142857,9.114047859865956,92.696535550344,"(3.999, 24.0]",Q1
36113,2020-05-06,64265,22,0,193,44,1729,2.4285714285714284,50.857142857142854,3.778995454090762,79.13661068566537,"(3.999, 24.0]",Q1
36113,2020-05-07,64265,22,6,199,72,1801,2.4285714285714284,47.714285714285715,3.778995454090762,74.24614598037145,"(3.999, 24.0]",Q1
36113,2020-05-08,64265,22,3,202,97,1898,2.4285714285714284,52.142857142857146,3.778995454090762,81.13725533783108,"(3.999, 24.0]",Q1
36113,2020-05-09,64265,22,5,207,149,2047,2.7142857142857144,67.28571428571429,4.223583154572029,104.70040346333819,"(3.999, 24.0]",Q1
36113,2020-05-10,64265,22,10,217,90,2137,3.5714285714285716,72.57142857142857,5.557346256015828,112.92527592224161,"(3.999, 24.0]",Q1
36113,2020-05-11,64265,22,4,221,40,2177,4.142857142857143,73.42857142857143,6.44652165697836,114.2590390236854,"(3.999, 24.0]",Q1
36113,2020-05-12,64265,22,2,223,127,2304,4.285714285714286,88.42857142857143,6.6688155072189925,137.59989329895188,"(3.999, 24.0]",Q1
36113,2020-05-13,64265,22,4,227,192,2496,4.857142857142857,109.57142857142857,7.557990908181524,170.4993831345656,"(3.999, 24.0]",Q1
36113,2020-05-14,64265,22,1,228,137,2633,4.142857142857143,118.85714285714286,6.44652165697836,184.94848340020675,"(3.999, 24.0]",Q1
36113,2020-05-15,64265,22,0,228,116,2749,3.7142857142857144,121.57142857142857,5.779640106256461,189.17206655477875,"(3.999, 24.0]",Q1
36113,2020-05-16,64265,22,4,232,205,2954,3.5714285714285716,129.57142857142858,5.557346256015828,201.6205221682542,"(3.999, 24.0]",Q1
36113,2020-05-17,64265,22,2,234,130,3084,2.4285714285714284,135.28571428571428,3.778995454090762,210.5122761778795,"(3.999, 24.0]",Q1
36113,2020-05-18,64265,22,1,235,52,3136,2.0,137.0,3.112113903368863,213.17980238076714,"(3.999, 24.0]",Q1
36113,2020-05-19,64265,22,0,235,102,3238,1.7142857142857142,133.42857142857142,2.667526202887597,207.6224561247513,"(3.999, 24.0]",Q1
36113,2020-05-20,64265,22,6,241,213,3451,2.0,136.42857142857142,3.112113903368863,212.29062697980459,"(3.999, 24.0]",Q1
36113,2020-05-21,64265,22,5,246,234,3685,2.5714285714285716,150.28571428571428,4.0012893043313955,233.853130453146,"(3.999, 24.0]",Q1
36113,2020-05-22,64265,22,3,249,114,3799,3.0,150.0,4.668170855053296,233.40854275266474,"(3.999, 24.0]",Q1
36113,2020-05-23,64265,22,1,250,159,3958,2.5714285714285716,143.42857142857142,4.0012893043313955,223.1830256415956,"(3.999, 24.0]",Q1
36113,2020-05-24,64265,22,1,251,65,4023,2.4285714285714284,134.14285714285714,3.778995454090762,208.73392537595447,"(3.999, 24.0]",Q1
36113,2020-05-25,64265,22,0,251,56,4079,2.2857142857142856,134.71428571428572,3.556701603850129,209.62310077691703,"(3.999, 24.0]",Q1
36113,2020-05-26,64265,22,1,252,111,4190,2.4285714285714284,136.0,3.778995454090762,211.6237454290827,"(3.999, 24.0]",Q1
36113,2020-05-27,64265,22,1,253,116,4306,1.7142857142857142,122.14285714285714,2.667526202887597,190.06124195574128,"(3.999, 24.0]",Q1
36113,2020-05-28,64265,22,1,254,205,4511,1.1428571428571428,118.0,1.7783508019250645,183.61472029876293,"(3.999, 24.0]",Q1
36113,2020-05-29,64265,22,1,255,235,4746,0.8571428571428571,135.28571428571428,1.3337631014437985,210.5122761778795,"(3.999, 24.0]",Q1
36113,2020-05-30,64265,22,0,255,255,5001,0.7142857142857143,149.0,1.1114692512031654,231.8524858009803,"(3.999, 24.0]",Q1
36113,2020-05-31,64265,22,0,255,112,5113,0.5714285714285714,155.71428571428572,0.8891754009625322,242.30029676229006,"(3.999, 24.0]",Q1
36113,2020-06-01,64265,22,0,255,139,5252,0.5714285714285714,167.57142857142858,0.8891754009625322,260.75068633226266,"(3.999, 24.0]",Q1
36113,2020-06-02,64265,22,1,256,156,5408,0.5714285714285714,174.0,0.8891754009625322,270.75390959309107,"(3.999, 24.0]",Q1
36113,2020-06-03,64265,22,0,256,344,5752,0.42857142857142855,206.57142857142858,0.6668815507218993,321.4369074479555,"(3.999, 24.0]",Q1
36113,2020-06-04,64265,22,0,256,235,5987,0.2857142857142857,210.85714285714286,0.4445877004812661,328.10572295517443,"(3.999, 24.0]",Q1
36113,2020-06-05,64265,22,1,257,137,6124,0.2857142857142857,196.85714285714286,0.4445877004812661,306.3209256315924,"(3.999, 24.0]",Q1
36113,2020-06-06,64265,22,0,257,256,6380,0.2857142857142857,197.0,0.4445877004812661,306.54321948183303,"(3.999, 24.0]",Q1
36113,2020-06-07,64265,22,0,257,204,6584,0.2857142857142857,210.14285714285714,0.4445877004812661,326.99425370397125,"(3.999, 24.0]",Q1
36115,2020-03-02,61197,36,0,0,0,0,0.0,0.0,0.0,0.0,"(24.0, 37.5]",Q2
36115,2020-03-03,61197,36,0,0,0,0,0.0,0.0,0.0,0.0,"(24.0, 37.5]",Q2
36115,2020-03-04,61197,36,0,0,0,0,0.0,0.0,0.0,0.0,"(24.0, 37.5]",Q2
36115,2020-03-05,61197,36,0,0,0,0,0.0,0.0,0.0,0.0,"(24.0, 37.5]",Q2
36115,2020-03-06,61197,36,0,0,0,0,0.0,0.0,0.0,0.0,"(24.0, 37.5]",Q2
36115,2020-03-07,61197,36,0,0,0,0,0.0,0.0,0.0,0.0,"(24.0, 37.5]",Q2
36115,2020-03-08,61197,36,0,0,2,2,0.0,0.2857142857142857,0.0,0.4668762941227278,"(24.0, 37.5]",Q2
36115,2020-03-09,61197,36,0,0,0,2,0.0,0.2857142857142857,0.0,0.4668762941227278,"(24.0, 37.5]",Q2
36115,2020-03-10,61197,36,0,0,1,3,0.0,0.42857142857142855,0.0,0.7003144411840916,"(24.0, 37.5]",Q2
36115,2020-03-11,61197,36,0,0,4,7,0.0,1.0,0.0,1.634067029429547,"(24.0, 37.5]",Q2
36115,2020-03-12,61197,36,0,0,0,7,0.0,1.0,0.0,1.634067029429547,"(24.0, 37.5]",Q2
36115,2020-03-13,61197,36,0,0,1,8,0.0,1.1428571428571428,0.0,1.8675051764909112,"(24.0, 37.5]",Q2
36115,2020-03-14,61197,36,0,0,1,9,0.0,1.2857142857142858,0.0,2.100943323552275,"(24.0, 37.5]",Q2
36115,2020-03-15,61197,36,0,0,5,14,0.0,1.7142857142857142,0.0,2.8012577647363663,"(24.0, 37.5]",Q2
36115,2020-03-16,61197,36,0,0,4,18,0.0,2.2857142857142856,0.0,3.7350103529818224,"(24.0, 37.5]",Q2
36115,2020-03-17,61197,36,1,1,9,27,0.14285714285714285,3.4285714285714284,0.2334381470613639,5.602515529472733,"(24.0, 37.5]",Q2
36115,2020-03-18,61197,36,0,1,5,32,0.14285714285714285,3.5714285714285716,0.2334381470613639,5.835953676534098,"(24.0, 37.5]",Q2
36115,2020-03-19,61197,36,0,1,8,40,0.14285714285714285,4.714285714285714,0.2334381470613639,7.703458853025008,"(24.0, 37.5]",Q2
36115,2020-03-20,61197,36,0,1,10,50,0.14285714285714285,6.0,0.2334381470613639,9.804402176577282,"(24.0, 37.5]",Q2
36115,2020-03-21,61197,36,0,1,18,68,0.14285714285714285,8.428571428571429,0.2334381470613639,13.77285067662047,"(24.0, 37.5]",Q2
36115,2020-03-22,61197,36,2,3,52,120,0.42857142857142855,15.142857142857142,0.7003144411840916,24.74444358850457,"(24.0, 37.5]",Q2
36115,2020-03-23,61197,36,0,3,7,127,0.42857142857142855,15.571428571428571,0.7003144411840916,25.444758029688664,"(24.0, 37.5]",Q2
36115,2020-03-24,61197,36,1,4,25,152,0.42857142857142855,17.857142857142858,0.7003144411840916,29.179768382670485,"(24.0, 37.5]",Q2
36115,2020-03-25,61197,36,0,4,18,170,0.42857142857142855,19.714285714285715,0.7003144411840916,32.21446429446822,"(24.0, 37.5]",Q2
36115,2020-03-26,61197,36,2,6,19,189,0.7142857142857143,21.285714285714285,1.1671907353068194,34.78228391214322,"(24.0, 37.5]",Q2
36115,2020-03-27,61197,36,0,6,40,229,0.7142857142857143,25.571428571428573,1.1671907353068194,41.785428323984135,"(24.0, 37.5]",Q2
36115,2020-03-28,61197,36,1,7,20,249,0.8571428571428571,25.857142857142858,1.4006288823681832,42.25230461810686,"(24.0, 37.5]",Q2
36115,2020-03-29,61197,36,0,7,10,259,0.5714285714285714,19.857142857142858,0.9337525882454556,32.44790244152958,"(24.0, 37.5]",Q2
36115,2020-03-30,61197,36,3,10,7,266,1.0,19.857142857142858,1.634067029429547,32.44790244152958,"(24.0, 37.5]",Q2
36115,2020-03-31,61197,36,0,10,5,271,0.8571428571428571,17.0,1.4006288823681832,27.779139500302303,"(24.0, 37.5]",Q2
36115,2020-04-01,61197,36,2,12,9,280,1.1428571428571428,15.714285714285714,1.8675051764909112,25.678196176750024,"(24.0, 37.5]",Q2
36115,2020-04-02,61197,36,3,15,13,293,1.2857142857142858,14.857142857142858,2.100943323552275,24.277567294381846,"(24.0, 37.5]",Q2
36115,2020-04-03,61197,36,1,16,9,302,1.4285714285714286,10.428571428571429,2.3343814706136388,17.040984735479565,"(24.0, 37.5]",Q2
36115,2020-04-04,61197,36,2,18,15,317,1.5714285714285714,9.714285714285714,2.5678196176750028,15.873794000172744,"(24.0, 37.5]",Q2
36115,2020-04-05,61197,36,1,19,2,319,1.7142857142857142,8.571428571428571,2.8012577647363663,14.006288823681832,"(24.0, 37.5]",Q2
36115,2020-04-06,61197,36,0,19,13,332,1.2857142857142858,9.428571428571429,2.100943323552275,15.406917706050017,"(24.0, 37.5]",Q2
36115,2020-04-07,61197,36,1,20,27,359,1.4285714285714286,12.571428571428571,2.3343814706136388,20.542556941400022,"(24.0, 37.5]",Q2
36115,2020-04-08,61197,36,5,25,24,383,1.8571428571428572,14.714285714285714,3.034695911797731,24.04412914732048,"(24.0, 37.5]",Q2
36115,2020-04-09,61197,36,1,26,14,397,1.5714285714285714,14.857142857142858,2.5678196176750028,24.277567294381846,"(24.0, 37.5]",Q2
36115,2020-04-10,61197,36,5,31,16,413,2.142857142857143,15.857142857142858,3.501572205920458,25.91163432381139,"(24.0, 37.5]",Q2
36115,2020-04-11,61197,36,3,34,18,431,2.2857142857142856,16.285714285714285,3.7350103529818224,26.611948764995482,"(24.0, 37.5]",Q2
36115,2020-04-12,61197,36,3,37,15,446,2.5714285714285716,18.142857142857142,4.20188664710455,29.646644676793212,"(24.0, 37.5]",Q2
36115,2020-04-13,61197,36,3,40,36,482,3.0,21.428571428571427,4.902201088288641,35.01572205920458,"(24.0, 37.5]",Q2
36115,2020-04-14,61197,36,2,42,8,490,3.142857142857143,18.714285714285715,5.1356392353500055,30.580397265038673,"(24.0, 37.5]",Q2
36115,2020-04-15,61197,36,4,46,24,514,3.0,18.714285714285715,4.902201088288641,30.580397265038673,"(24.0, 37.5]",Q2
36115,2020-04-16,61197,36,2,48,19,533,3.142857142857143,19.428571428571427,5.1356392353500055,31.747588000345488,"(24.0, 37.5]",Q2
36115,2020-04-17,61197,36,4,52,25,558,3.0,20.714285714285715,4.902201088288641,33.84853132389777,"(24.0, 37.5]",Q2
36115,2020-04-18,61197,36,11,63,35,593,4.142857142857143,23.142857142857142,6.769706264779553,37.81697982394095,"(24.0, 37.5]",Q2
36115,2020-04-19,61197,36,2,65,9,602,4.0,22.285714285714285,6.536268117718188,36.41635094157276,"(24.0, 37.5]",Q2
36115,2020-04-20,61197,36,3,68,12,614,4.0,18.857142857142858,6.536268117718188,30.813835412100033,"(24.0, 37.5]",Q2
36115,2020-04-21,61197,36,5,73,17,631,4.428571428571429,20.142857142857142,7.236582558902281,32.91477873565231,"(24.0, 37.5]",Q2
36115,2020-04-22,61197,36,7,80,36,667,4.857142857142857,21.857142857142858,7.936897000086372,35.716036500388675,"(24.0, 37.5]",Q2
36115,2020-04-23,61197,36,3,83,26,693,5.0,22.857142857142858,8.170335147147735,37.35010352981822,"(24.0, 37.5]",Q2
36115,2020-04-24,61197,36,30,113,134,827,8.714285714285714,38.42857142857143,14.239726970743195,62.794861559506884,"(24.0, 37.5]",Q2
36115,2020-04-25,61197,36,14,127,51,878,9.142857142857142,40.714285714285715,14.94004141192729,66.5298719124887,"(24.0, 37.5]",Q2
36115,2020-04-26,61197,36,3,130,37,915,9.285714285714286,44.714285714285715,15.173479558988653,73.0661400302069,"(24.0, 37.5]",Q2
36115,2020-04-27,61197,36,1,131,13,928,9.0,44.857142857142854,14.706603264865926,73.29957817726826,"(24.0, 37.5]",Q2
36115,2020-04-28,61197,36,3,134,19,947,8.714285714285714,45.142857142857146,14.239726970743195,73.76645447139099,"(24.0, 37.5]",Q2
36115,2020-04-29,61197,36,14,148,58,1005,9.714285714285714,48.285714285714285,15.873794000172744,78.90209370674098,"(24.0, 37.5]",Q2
36115,2020-04-30,61197,36,22,170,88,1093,12.428571428571429,57.142857142857146,20.30911879433866,93.37525882454557,"(24.0, 37.5]",Q2
36115,2020-05-01,61197,36,14,184,63,1156,10.142857142857142,47.0,16.574108441356834,76.80115038318873,"(24.0, 37.5]",Q2
36115,2020-05-02,61197,36,2,186,63,1219,8.428571428571429,48.714285714285715,13.77285067662047,79.60240814792509,"(24.0, 37.5]",Q2
36115,2020-05-03,61197,36,2,188,31,1250,8.285714285714286,47.857142857142854,13.539412529559106,78.2017792655569,"(24.0, 37.5]",Q2
36115,2020-05-04,61197,36,0,188,22,1272,8.142857142857142,49.142857142857146,13.305974382497741,80.30272258910918,"(24.0, 37.5]",Q2
36115,2020-05-05,61197,36,1,189,25,1297,7.857142857142857,50.0,12.839098088375012,81.70335147147736,"(24.0, 37.5]",Q2
36115,2020-05-06,61197,36,1,190,20,1317,6.0,44.57142857142857,9.804402176577282,72.83270188314552,"(24.0, 37.5]",Q2
36115,2020-05-07,61197,36,11,201,106,1423,4.428571428571429,47.142857142857146,7.236582558902281,77.03458853025009,"(24.0, 37.5]",Q2
36115,2020-05-08,61197,36,3,204,86,1509,2.857142857142857,50.42857142857143,4.6687629412272775,82.40366591266145,"(24.0, 37.5]",Q2
36115,2020-05-09,61197,36,2,206,60,1569,2.857142857142857,50.0,4.6687629412272775,81.70335147147736,"(24.0, 37.5]",Q2
36115,2020-05-10,61197,36,4,210,39,1608,3.142857142857143,51.142857142857146,5.1356392353500055,83.57085664796827,"(24.0, 37.5]",Q2
36115,2020-05-11,61197,36,0,210,24,1632,3.142857142857143,51.42857142857143,5.1356392353500055,84.03773294209101,"(24.0, 37.5]",Q2
36115,2020-05-12,61197,36,4,214,66,1698,3.5714285714285716,57.285714285714285,5.835953676534098,93.60869697160692,"(24.0, 37.5]",Q2
36115,2020-05-13,61197,36,1,215,77,1775,3.5714285714285716,65.42857142857143,5.835953676534098,106.91467135410466,"(24.0, 37.5]",Q2
36115,2020-05-14,61197,36,2,217,65,1840,2.2857142857142856,59.57142857142857,3.7350103529818224,97.34370732458873,"(24.0, 37.5]",Q2
36115,2020-05-15,61197,36,1,218,75,1915,2.0,58.0,3.268134058859094,94.77588770691374,"(24.0, 37.5]",Q2
36115,2020-05-16,61197,36,1,219,70,1985,1.8571428571428572,59.42857142857143,3.034695911797731,97.11026917752739,"(24.0, 37.5]",Q2
36115,2020-05-17,61197,36,0,219,47,2032,1.2857142857142858,60.57142857142857,2.100943323552275,98.97777435401828,"(24.0, 37.5]",Q2
36115,2020-05-18,61197,36,1,220,41,2073,1.4285714285714286,63.0,2.3343814706136388,102.94622285406147,"(24.0, 37.5]",Q2
36115,2020-05-19,61197,36,1,221,66,2139,1.0,63.0,1.634067029429547,102.94622285406147,"(24.0, 37.5]",Q2
36115,2020-05-20,61197,36,1,222,87,2226,1.0,64.42857142857143,1.634067029429547,105.28060432467511,"(24.0, 37.5]",Q2
36115,2020-05-21,61197,36,2,224,100,2326,1.0,69.42857142857143,1.634067029429547,113.45093947182285,"(24.0, 37.5]",Q2
36115,2020-05-22,61197,36,1,225,70,2396,1.0,68.71428571428571,1.634067029429547,112.28374873651602,"(24.0, 37.5]",Q2
36115,2020-05-23,61197,36,1,226,213,2609,1.0,89.14285714285714,1.634067029429547,145.66540376629104,"(24.0, 37.5]",Q2
36115,2020-05-24,61197,36,2,228,51,2660,1.2857142857142858,89.71428571428571,2.100943323552275,146.59915635453652,"(24.0, 37.5]",Q2
36115,2020-05-25,61197,36,0,228,106,2766,1.1428571428571428,99.0,1.8675051764909112,161.7726359135252,"(24.0, 37.5]",Q2
36115,2020-05-26,61197,36,0,228,107,2873,1.0,104.85714285714286,1.634067029429547,171.34359994304108,"(24.0, 37.5]",Q2
36115,2020-05-27,61197,36,3,231,293,3166,1.2857142857142858,134.28571428571428,2.100943323552275,219.43185823768206,"(24.0, 37.5]",Q2
36115,2020-05-28,61197,36,1,232,340,3506,1.1428571428571428,168.57142857142858,1.8675051764909112,275.4570135324094,"(24.0, 37.5]",Q2
36115,2020-05-29,61197,36,3,235,240,3746,1.4285714285714286,192.85714285714286,2.3343814706136388,315.14149853284124,"(24.0, 37.5]",Q2
36115,2020-05-30,61197,36,0,235,222,3968,1.2857142857142858,194.14285714285714,2.100943323552275,317.24244185639355,"(24.0, 37.5]",Q2
36115,2020-05-31,61197,36,0,235,99,4067,1.0,201.0,1.634067029429547,328.447472915339,"(24.0, 37.5]",Q2
36115,2020-06-01,61197,36,2,237,81,4148,1.2857142857142858,197.42857142857142,2.100943323552275,322.6115192388049,"(24.0, 37.5]",Q2
36115,2020-06-02,61197,36,1,238,270,4418,1.4285714285714286,220.71428571428572,2.3343814706136388,360.6619372098072,"(24.0, 37.5]",Q2
36115,2020-06-03,61197,36,0,238,354,4772,1.0,229.42857142857142,1.634067029429547,374.90166418055037,"(24.0, 37.5]",Q2
36115,2020-06-04,61197,36,2,240,158,4930,1.1428571428571428,203.42857142857142,1.8675051764909112,332.4159214153822,"(24.0, 37.5]",Q2
36115,2020-06-05,61197,36,0,240,254,5184,0.7142857142857143,205.42857142857142,1.1671907353068194,335.68405547424123,"(24.0, 37.5]",Q2
36115,2020-06-06,61197,36,0,240,243,5427,0.7142857142857143,208.42857142857142,1.1671907353068194,340.58625656252985,"(24.0, 37.5]",Q2
36115,2020-06-07,61197,36,0,240,211,5638,0.7142857142857143,224.42857142857142,1.1671907353068194,366.73132903340263,"(24.0, 37.5]",Q2
36117,2020-03-02,90064,22,0,0,0,0,0.0,0.0,0.0,0.0,"(3.999, 24.0]",Q1
36117,2020-03-03,90064,22,0,0,0,0,0.0,0.0,0.0,0.0,"(3.999, 24.0]",Q1
36117,2020-03-04,90064,22,0,0,0,0,0.0,0.0,0.0,0.0,"(3.999, 24.0]",Q1
36117,2020-03-05,90064,22,0,0,0,0,0.0,0.0,0.0,0.0,"(3.999, 24.0]",Q1
36117,2020-03-06,90064,22,0,0,0,0,0.0,0.0,0.0,0.0,"(3.999, 24.0]",Q1
36117,2020-03-07,90064,22,0,0,0,0,0.0,0.0,0.0,0.0,"(3.999, 24.0]",Q1
36117,2020-03-08,90064,22,0,0,0,0,0.0,0.0,0.0,0.0,"(3.999, 24.0]",Q1
36117,2020-03-09,90064,22,0,0,0,0,0.0,0.0,0.0,0.0,"(3.999, 24.0]",Q1
36117,2020-03-10,90064,22,0,0,0,0,0.0,0.0,0.0,0.0,"(3.999, 24.0]",Q1
36117,2020-03-11,90064,22,0,0,0,0,0.0,0.0,0.0,0.0,"(3.999, 24.0]",Q1
36117,2020-03-12,90064,22,0,0,0,0,0.0,0.0,0.0,0.0,"(3.999, 24.0]",Q1
36117,2020-03-13,90064,22,0,0,2,2,0.0,0.2857142857142857,0.0,0.3172347283201786,"(3.999, 24.0]",Q1
36117,2020-03-14,90064,22,0,0,1,3,0.0,0.42857142857142855,0.0,0.475852092480268,"(3.999, 24.0]",Q1
36117,2020-03-15,90064,22,0,0,3,6,0.0,0.8571428571428571,0.0,0.951704184960536,"(3.999, 24.0]",Q1
36117,2020-03-16,90064,22,0,0,3,9,0.0,1.2857142857142858,0.0,1.4275562774408042,"(3.999, 24.0]",Q1
36117,2020-03-17,90064,22,0,0,10,19,0.0,2.7142857142857144,0.0,3.0137299190416975,"(3.999, 24.0]",Q1
36117,2020-03-18,90064,22,1,1,15,34,0.14285714285714285,4.857142857142857,0.1586173641600893,5.392990381443036,"(3.999, 24.0]",Q1
36117,2020-03-19,90064,22,0,1,21,55,0.14285714285714285,7.857142857142857,0.1586173641600893,8.723955028804914,"(3.999, 24.0]",Q1
36117,2020-03-20,90064,22,2,3,13,68,0.42857142857142855,9.428571428571429,0.475852092480268,10.468746034565896,"(3.999, 24.0]",Q1
36117,2020-03-21,90064,22,0,3,9,77,0.42857142857142855,10.571428571428571,0.475852092480268,11.737684947846612,"(3.999, 24.0]",Q1
36117,2020-03-22,90064,22,3,6,14,91,0.8571428571428571,12.142857142857142,0.951704184960536,13.482475953607594,"(3.999, 24.0]",Q1
36117,2020-03-23,90064,22,0,6,17,108,0.8571428571428571,14.142857142857142,0.951704184960536,15.703119051848843,"(3.999, 24.0]",Q1
36117,2020-03-24,90064,22,1,7,15,123,1.0,14.857142857142858,1.1103215491206253,16.49620587264929,"(3.999, 24.0]",Q1
36117,2020-03-25,90064,22,1,8,37,160,1.0,18.0,1.1103215491206253,19.98578788417126,"(3.999, 24.0]",Q1
36117,2020-03-26,90064,22,3,11,27,187,1.4285714285714286,18.857142857142858,1.5861736416008931,20.937492069131793,"(3.999, 24.0]",Q1
36117,2020-03-27,90064,22,1,12,32,219,1.2857142857142858,21.571428571428573,1.4275562774408042,23.95122198817349,"(3.999, 24.0]",Q1
36117,2020-03-28,90064,22,0,12,13,232,1.2857142857142858,22.142857142857142,1.4275562774408042,24.585691444813843,"(3.999, 24.0]",Q1
36117,2020-03-29,90064,22,3,15,24,256,1.2857142857142858,23.571428571428573,1.4275562774408042,26.171865086414744,"(3.999, 24.0]",Q1
36117,2020-03-30,90064,22,4,19,28,284,1.8571428571428572,25.142857142857142,2.0620257340811614,27.916656092175725,"(3.999, 24.0]",Q1
36117,2020-03-31,90064,22,5,24,33,317,2.4285714285714284,27.714285714285715,2.696495190721518,30.771768647057332,"(3.999, 24.0]",Q1
36117,2020-04-01,90064,22,3,27,28,345,2.7142857142857144,26.428571428571427,3.0137299190416975,29.34421236961653,"(3.999, 24.0]",Q1
36117,2020-04-02,90064,22,3,30,28,373,2.7142857142857144,26.571428571428573,3.0137299190416975,29.50282973377662,"(3.999, 24.0]",Q1
36117,2020-04-03,90064,22,0,30,35,408,2.5714285714285716,27.0,2.8551125548816083,29.978681826256885,"(3.999, 24.0]",Q1
36117,2020-04-04,90064,22,2,32,24,432,2.857142857142857,28.571428571428573,3.1723472832017863,31.72347283201787,"(3.999, 24.0]",Q1
36117,2020-04-05,90064,22,2,34,15,447,2.7142857142857144,27.285714285714285,3.0137299190416975,30.29591655457706,"(3.999, 24.0]",Q1
36117,2020-04-06,90064,22,1,35,31,478,2.2857142857142856,27.714285714285715,2.537877826561429,30.771768647057332,"(3.999, 24.0]",Q1
36117,2020-04-07,90064,22,4,39,46,524,2.142857142857143,29.571428571428573,2.37926046240134,32.833794381138496,"(3.999, 24.0]",Q1
36117,2020-04-08,90064,22,0,39,34,558,1.7142857142857142,30.428571428571427,1.903408369921072,33.78549856609903,"(3.999, 24.0]",Q1
36117,2020-04-09,90064,22,2,41,34,592,1.5714285714285714,31.285714285714285,1.7447910057609828,34.73720275105956,"(3.999, 24.0]",Q1
36117,2020-04-10,90064,22,1,42,17,609,1.7142857142857142,28.714285714285715,1.903408369921072,31.882090196177955,"(3.999, 24.0]",Q1
36117,2020-04-11,90064,22,0,42,7,616,1.4285714285714286,26.285714285714285,1.5861736416008931,29.185595005456435,"(3.999, 24.0]",Q1
36117,2020-04-12,90064,22,0,42,8,624,1.1428571428571428,25.285714285714285,1.2689389132807145,28.07527345633581,"(3.999, 24.0]",Q1
36117,2020-04-13,90064,22,6,48,39,663,1.8571428571428572,26.428571428571427,2.0620257340811614,29.34421236961653,"(3.999, 24.0]",Q1
36117,2020-04-14,90064,22,0,48,20,683,1.2857142857142858,22.714285714285715,1.4275562774408042,25.220160901454204,"(3.999, 24.0]",Q1
36117,2020-04-15,90064,22,1,49,12,695,1.4285714285714286,19.571428571428573,1.5861736416008931,21.73057888993224,"(3.999, 24.0]",Q1
36117,2020-04-16,90064,22,0,49,7,702,1.1428571428571428,15.714285714285714,1.2689389132807145,17.44791005760983,"(3.999, 24.0]",Q1
36117,2020-04-17,90064,22,0,49,7,709,1.0,14.285714285714286,1.1103215491206253,15.861736416008934,"(3.999, 24.0]",Q1
36117,2020-04-18,90064,22,1,50,6,715,1.1428571428571428,14.142857142857142,1.2689389132807145,15.703119051848843,"(3.999, 24.0]",Q1
36117,2020-04-19,90064,22,0,50,2,717,1.1428571428571428,13.285714285714286,1.2689389132807145,14.75141486688831,"(3.999, 24.0]",Q1
36117,2020-04-20,90064,22,1,51,8,725,0.42857142857142855,8.857142857142858,0.475852092480268,9.83427657792554,"(3.999, 24.0]",Q1
36117,2020-04-21,90064,22,1,52,16,741,0.5714285714285714,8.285714285714286,0.6344694566403573,9.199807121285183,"(3.999, 24.0]",Q1
36117,2020-04-22,90064,22,1,53,13,754,0.5714285714285714,8.428571428571429,0.6344694566403573,9.358424485445271,"(3.999, 24.0]",Q1
36117,2020-04-23,90064,22,0,53,12,766,0.5714285714285714,9.142857142857142,0.6344694566403573,10.151511306245716,"(3.999, 24.0]",Q1
36117,2020-04-24,90064,22,12,65,257,1023,2.2857142857142856,44.857142857142854,2.537877826561429,49.80585234626805,"(3.999, 24.0]",Q1
36117,2020-04-25,90064,22,0,65,36,1059,2.142857142857143,49.142857142857146,2.37926046240134,54.564373271070735,"(3.999, 24.0]",Q1
36117,2020-04-26,90064,22,4,69,28,1087,2.7142857142857144,52.857142857142854,3.0137299190416975,58.68842473923306,"(3.999, 24.0]",Q1
36117,2020-04-27,90064,22,1,70,53,1140,2.7142857142857144,59.285714285714285,3.0137299190416975,65.82620612643707,"(3.999, 24.0]",Q1
36117,2020-04-28,90064,22,0,70,45,1185,2.5714285714285716,63.42857142857143,2.8551125548816083,70.42610968707966,"(3.999, 24.0]",Q1
36117,2020-04-29,90064,22,1,71,54,1239,2.5714285714285716,69.28571428571429,2.8551125548816083,76.92942161764333,"(3.999, 24.0]",Q1
36117,2020-04-30,90064,22,0,71,56,1295,2.5714285714285716,75.57142857142857,2.8551125548816083,83.90858564068725,"(3.999, 24.0]",Q1
36117,2020-05-01,90064,22,2,73,43,1338,1.1428571428571428,45.0,1.2689389132807145,49.96446971042813,"(3.999, 24.0]",Q1
36117,2020-05-02,90064,22,2,75,86,1424,1.4285714285714286,52.142857142857146,1.5861736416008931,57.89533791843261,"(3.999, 24.0]",Q1
36117,2020-05-03,90064,22,1,76,88,1512,1.0,60.714285714285715,1.1103215491206253,67.41237976803797,"(3.999, 24.0]",Q1
36117,2020-05-04,90064,22,2,78,66,1578,1.1428571428571428,62.57142857142857,1.2689389132807145,69.47440550211913,"(3.999, 24.0]",Q1
36117,2020-05-05,90064,22,0,78,93,1671,1.1428571428571428,69.42857142857143,1.2689389132807145,77.08803898180342,"(3.999, 24.0]",Q1
36117,2020-05-06,90064,22,0,78,93,1764,1.0,75.0,1.1103215491206253,83.2741161840469,"(3.999, 24.0]",Q1
36117,2020-05-07,90064,22,1,79,95,1859,1.1428571428571428,80.57142857142857,1.2689389132807145,89.46019338629038,"(3.999, 24.0]",Q1
36117,2020-05-08,90064,22,0,79,63,1922,0.8571428571428571,83.42857142857143,0.951704184960536,92.63254066949217,"(3.999, 24.0]",Q1
36117,2020-05-09,90064,22,1,80,101,2023,0.7142857142857143,85.57142857142857,0.7930868208004466,95.0118011318935,"(3.999, 24.0]",Q1
36117,2020-05-10,90064,22,1,81,72,2095,0.7142857142857143,83.28571428571429,0.7930868208004466,92.47392330533208,"(3.999, 24.0]",Q1
36117,2020-05-11,90064,22,2,83,64,2159,0.7142857142857143,83.0,0.7930868208004466,92.1566885770119,"(3.999, 24.0]",Q1
36117,2020-05-12,90064,22,1,84,168,2327,0.8571428571428571,93.71428571428571,0.951704184960536,104.05299088901859,"(3.999, 24.0]",Q1
36117,2020-05-13,90064,22,5,89,120,2447,1.5714285714285714,97.57142857142857,1.7447910057609828,108.33565972134102,"(3.999, 24.0]",Q1
36117,2020-05-14,90064,22,2,91,110,2557,1.7142857142857142,99.71428571428571,1.903408369921072,110.71492018374235,"(3.999, 24.0]",Q1
36117,2020-05-15,90064,22,1,92,86,2643,1.8571428571428572,103.0,2.0620257340811614,114.36311955942442,"(3.999, 24.0]",Q1
36117,2020-05-16,90064,22,4,96,118,2761,2.2857142857142856,105.42857142857143,2.537877826561429,117.05961475014593,"(3.999, 24.0]",Q1
36117,2020-05-17,90064,22,1,97,114,2875,2.2857142857142856,111.42857142857143,2.537877826561429,123.72154404486969,"(3.999, 24.0]",Q1
36117,2020-05-18,90064,22,1,98,128,3003,2.142857142857143,120.57142857142857,2.37926046240134,133.8730553511154,"(3.999, 24.0]",Q1
36117,2020-05-19,90064,22,5,103,187,3190,2.7142857142857144,123.28571428571429,3.0137299190416975,136.8867852701571,"(3.999, 24.0]",Q1
36117,2020-05-20,90064,22,0,103,155,3345,2.0,128.28571428571428,2.2206430982412506,142.43839301576023,"(3.999, 24.0]",Q1
36117,2020-05-21,90064,22,1,104,104,3449,1.8571428571428572,127.42857142857143,2.0620257340811614,141.4866888307997,"(3.999, 24.0]",Q1
36117,2020-05-22,90064,22,3,107,163,3612,2.142857142857143,138.42857142857142,2.37926046240134,153.70022587112655,"(3.999, 24.0]",Q1
36117,2020-05-23,90064,22,1,108,107,3719,1.7142857142857142,136.85714285714286,1.903408369921072,151.9554348653656,"(3.999, 24.0]",Q1
36117,2020-05-24,90064,22,1,109,106,3825,1.7142857142857142,135.71428571428572,1.903408369921072,150.68649595208487,"(3.999, 24.0]",Q1
36117,2020-05-25,90064,22,1,110,170,3995,1.7142857142857142,141.71428571428572,1.903408369921072,157.34842524680863,"(3.999, 24.0]",Q1
36117,2020-05-26,90064,22,0,110,339,4334,1.0,163.42857142857142,1.1103215491206253,181.45826459914218,"(3.999, 24.0]",Q1
36117,2020-05-27,90064,22,2,112,303,4637,1.2857142857142858,184.57142857142858,1.4275562774408042,204.93363449483542,"(3.999, 24.0]",Q1
36117,2020-05-28,90064,22,1,113,290,4927,1.2857142857142858,211.14285714285714,1.4275562774408042,234.43646422861204,"(3.999, 24.0]",Q1
36117,2020-05-29,90064,22,0,113,299,5226,0.8571428571428571,230.57142857142858,0.951704184960536,256.0084257543842,"(3.999, 24.0]",Q1
36117,2020-05-30,90064,22,2,115,284,5510,1.0,255.85714285714286,1.1103215491206253,284.08369921072,"(3.999, 24.0]",Q1
36117,2020-05-31,90064,22,1,116,228,5738,1.0,273.2857142857143,1.1103215491206253,303.4350176382509,"(3.999, 24.0]",Q1
36117,2020-06-01,90064,22,0,116,216,5954,0.8571428571428571,279.85714285714283,0.951704184960536,310.73141638961494,"(3.999, 24.0]",Q1
36117,2020-06-02,90064,22,4,120,396,6350,1.4285714285714286,288.0,1.5861736416008931,319.77260614674015,"(3.999, 24.0]",Q1
36117,2020-06-03,90064,22,1,121,468,6818,1.2857142857142858,311.57142857142856,1.4275562774408042,345.94447123315484,"(3.999, 24.0]",Q1
36117,2020-06-04,90064,22,1,122,323,7141,1.2857142857142858,316.2857142857143,1.4275562774408042,351.1788442504378,"(3.999, 24.0]",Q1
36117,2020-06-05,90064,22,1,123,409,7550,1.4285714285714286,332.0,1.5861736416008931,368.6267543080476,"(3.999, 24.0]",Q1
36117,2020-06-06,90064,22,1,124,362,7912,1.2857142857142858,343.14285714285717,1.4275562774408042,380.9989087125346,"(3.999, 24.0]",Q1
36117,2020-06-07,90064,22,1,125,322,8234,1.2857142857142858,356.57142857142856,1.4275562774408042,395.908940943583,"(3.999, 24.0]",Q1
36119,2020-03-02,967612,47,1,1,1,1,1.0,1.0,0.10334720941865128,0.10334720941865128,"(37.5, 52.0]",Q3
36119,2020-03-03,967612,47,0,1,1,2,0.0,1.0,0.0,0.10334720941865128,"(37.5, 52.0]",Q3
36119,2020-03-04,967612,47,0,1,0,2,0.0,0.0,0.0,0.0,"(37.5, 52.0]",Q3
36119,2020-03-05,967612,47,19,20,42,44,19.0,42.0,1.9635969789543741,4.340582795583353,"(37.5, 52.0]",Q3
36119,2020-03-06,967612,47,0,20,9,53,0.0,9.0,0.0,0.9301248847678615,"(37.5, 52.0]",Q3
36119,2020-03-07,967612,47,22,42,110,163,22.0,110.0,2.273638607210328,11.368193036051641,"(37.5, 52.0]",Q3
36119,2020-03-08,967612,47,18,60,207,370,8.571428571428571,52.857142857142854,0.8858332235884395,5.46263821212871,"(37.5, 52.0]",Q3
36119,2020-03-09,967612,47,42,102,222,592,14.428571428571429,84.42857142857143,1.4911525930405398,8.72545725234613,"(37.5, 52.0]",Q3
36119,2020-03-10,967612,47,9,111,177,769,15.714285714285714,109.57142857142857,1.6240275765788057,11.323901374872218,"(37.5, 52.0]",Q3
36119,2020-03-11,967612,47,21,132,183,952,18.714285714285715,135.71428571428572,1.9340692048347599,14.02569270681696,"(37.5, 52.0]",Q3
36119,2020-03-12,967612,47,19,151,108,1060,18.714285714285715,145.14285714285714,1.9340692048347599,15.000109252764242,"(37.5, 52.0]",Q3
36119,2020-03-13,967612,47,20,171,209,1269,21.571428571428573,173.71428571428572,2.229346946030906,17.952886664725707,"(37.5, 52.0]",Q3
36119,2020-03-14,967612,47,11,182,220,1489,20.0,189.42857142857142,2.0669441883730255,19.576914241304515,"(37.5, 52.0]",Q3
36119,2020-03-15,967612,47,41,223,372,1861,23.285714285714285,213.0,2.406513590748594,22.01295560617272,"(37.5, 52.0]",Q3
36119,2020-03-16,967612,47,157,380,1219,3080,39.714285714285715,355.42857142857144,4.1043606026264365,36.73255100480063,"(37.5, 52.0]",Q3
36119,2020-03-17,967612,47,158,538,1026,4106,61.0,476.7142857142857,6.304179774537728,49.26709111857704,"(37.5, 52.0]",Q3
36119,2020-03-18,967612,47,261,799,1588,5694,95.28571428571429,677.4285714285714,9.847512668891486,70.01035243760634,"(37.5, 52.0]",Q3
36119,2020-03-19,967612,47,292,1091,1483,7177,134.28571428571428,873.8571428571429,13.878053836218886,90.31069714484141,"(37.5, 52.0]",Q3
36119,2020-03-20,967612,47,296,1387,1459,8636,173.71428571428572,1052.4285714285713,17.952886664725707,108.76555596960056,"(37.5, 52.0]",Q3
36119,2020-03-21,967612,47,486,1873,2011,10647,241.57142857142858,1308.2857142857142,24.965733018134188,135.20767769371548,"(37.5, 52.0]",Q3
36119,2020-03-22,967612,47,1021,2894,4037,14684,381.57142857142856,1831.857142857143,39.43434233674537,189.31732376790933,"(37.5, 52.0]",Q3
36119,2020-03-23,967612,47,997,3891,3282,17966,501.57142857142856,2126.5714285714284,51.83600746698352,219.77522277229184,"(37.5, 52.0]",Q3
36119,2020-03-24,967612,47,800,4691,2371,20337,593.2857142857143,2318.714285714286,61.31442295937982,239.6326508677327,"(37.5, 52.0]",Q3
36119,2020-03-25,967612,47,1253,5944,5951,26288,735.0,2942.0,75.96019892270868,304.0474901096721,"(37.5, 52.0]",Q3
36119,2020-03-26,967612,47,1243,7187,3227,29515,870.8571428571429,3191.1428571428573,90.00065551658545,329.79570914197603,"(37.5, 52.0]",Q3
36119,2020-03-27,967612,47,688,7875,1588,31103,926.8571428571429,3209.5714285714284,95.78809924402992,331.7002505726912,"(37.5, 52.0]",Q3
36119,2020-03-28,967612,47,644,8519,1410,32513,949.4285714285714,3123.714285714286,98.1207933994795,322.82715444974696,"(37.5, 52.0]",Q3
36119,2020-03-29,967612,47,807,9326,1595,34108,918.8571428571429,2774.8571428571427,94.96132156868072,286.7737422496975,"(37.5, 52.0]",Q3
36119,2020-03-30,967612,47,641,9967,1515,35623,868.0,2522.4285714285716,89.70537777538931,260.6859538150179,"(37.5, 52.0]",Q3
36119,2020-03-31,967612,47,716,10683,1567,37190,856.0,2407.5714285714284,88.4652112623655,248.81578861893286,"(37.5, 52.0]",Q3
36119,2020-04-01,967612,47,884,11567,1891,39081,803.2857142857143,1827.5714285714287,83.01733693729659,188.87440715611513,"(37.5, 52.0]",Q3
36119,2020-04-02,967612,47,784,12351,1632,40713,737.7142857142857,1599.7142857142858,76.24071277684502,165.32600729572243,"(37.5, 52.0]",Q3
36119,2020-04-03,967612,47,730,13081,1621,42334,743.7142857142857,1604.4285714285713,76.86079603335693,165.81321556869605,"(37.5, 52.0]",Q3
36119,2020-04-04,967612,47,642,13723,1621,43955,743.4285714285714,1634.5714285714287,76.83126825923732,168.92839573831543,"(37.5, 52.0]",Q3
36119,2020-04-05,967612,47,571,14294,1398,45353,709.7142857142857,1606.4285714285713,73.3469909131228,166.01990998753337,"(37.5, 52.0]",Q3
36119,2020-04-06,967612,47,510,14804,1348,46701,691.0,1582.5714285714287,71.41292170828802,163.55434084854556,"(37.5, 52.0]",Q3
36119,2020-04-07,967612,47,1083,15887,2647,49348,743.4285714285714,1736.857142857143,76.83126825923732,179.49933887313748,"(37.5, 52.0]",Q3
36119,2020-04-08,967612,47,1117,17004,2889,52237,776.7142857142857,1879.4285714285713,80.27125394417243,194.23369815882518,"(37.5, 52.0]",Q3
36119,2020-04-09,967612,47,1073,18077,2911,55148,818.0,2062.1428571428573,84.53801730445674,213.11670970831875,"(37.5, 52.0]",Q3
36119,2020-04-10,967612,47,652,18729,1679,56827,806.8571428571429,2070.4285714285716,83.38643411379178,213.9730151577876,"(37.5, 52.0]",Q3
36119,2020-04-11,967612,47,584,19313,1472,58299,798.5714285714286,2049.1428571428573,82.53012866432294,211.7731959858763,"(37.5, 52.0]",Q3
36119,2020-04-12,967612,47,473,19786,1163,59462,784.5714285714286,2015.5714285714287,81.08326773246183,208.30368252682158,"(37.5, 52.0]",Q3
36119,2020-04-13,967612,47,405,20191,1145,60607,769.5714285714286,1986.5714285714287,79.53305959118205,205.30661345368068,"(37.5, 52.0]",Q3
36119,2020-04-14,967612,47,756,20947,2019,62626,722.8571428571429,1896.857142857143,74.70526852262508,196.03489238012168,"(37.5, 52.0]",Q3
36119,2020-04-15,967612,47,881,21828,2642,65268,689.1428571428571,1861.5714285714287,71.22099117651054,192.38821227634926,"(37.5, 52.0]",Q3
36119,2020-04-16,967612,47,648,22476,2042,67310,628.4285714285714,1737.4285714285713,64.94633917609242,179.55839442137668,"(37.5, 52.0]",Q3
36119,2020-04-17,967612,47,703,23179,2298,69608,635.7142857142857,1825.857142857143,65.69929741614258,188.69724051139744,"(37.5, 52.0]",Q3
36119,2020-04-18,967612,47,624,23803,2133,71741,641.4285714285714,1920.2857142857142,66.28985289853489,198.45616985793004,"(37.5, 52.0]",Q3
36119,2020-04-19,967612,47,503,24306,1599,73340,645.7142857142857,1982.5714285714287,66.7327695103291,204.89322461600608,"(37.5, 52.0]",Q3
36119,2020-04-20,967612,47,350,24656,1208,74548,637.8571428571429,1991.5714285714287,65.92075572203971,205.82334950077393,"(37.5, 52.0]",Q3
36119,2020-04-21,967612,47,620,25276,2016,76564,618.4285714285714,1991.142857142857,63.912867081905915,205.77905783959451,"(37.5, 52.0]",Q3
36119,2020-04-22,967612,47,683,25959,2317,78881,590.1428571428571,1944.7142857142858,60.98961744406406,200.98079454515712,"(37.5, 52.0]",Q3
36119,2020-04-23,967612,47,674,26633,2672,81553,593.8571428571429,2034.7142857142858,61.373478507619055,210.28204339283573,"(37.5, 52.0]",Q3
36119,2020-04-24,967612,47,598,27231,2468,84021,578.8571428571429,2059.0,59.82327036633928,212.791904193003,"(37.5, 52.0]",Q3
36119,2020-04-25,967612,47,433,27664,1951,85972,551.5714285714286,2033.0,57.00336793791608,210.10487674811804,"(37.5, 52.0]",Q3
36119,2020-04-26,967612,47,343,28007,1764,87736,528.7142857142857,2056.5714285714284,54.64114600834691,212.54091811298625,"(37.5, 52.0]",Q3
36119,2020-04-27,967612,47,238,28245,1408,89144,512.7142857142857,2085.1428571428573,52.98759065764848,215.49369552494773,"(37.5, 52.0]",Q3
36119,2020-04-28,967612,47,381,28626,1843,90987,478.57142857142856,2060.4285714285716,49.459021650354536,212.9395430636011,"(37.5, 52.0]",Q3
36119,2020-04-29,967612,47,344,28970,1842,92829,430.14285714285717,1992.5714285714287,44.45406393707986,205.9266967101926,"(37.5, 52.0]",Q3
36119,2020-04-30,967612,47,262,29232,1613,94442,371.2857142857143,1841.2857142857142,38.37134246843924,190.2917403138566,"(37.5, 52.0]",Q3
36119,2020-05-01,967612,47,394,29626,2359,96801,342.14285714285717,1825.7142857142858,35.35950950823855,188.68247662433762,"(37.5, 52.0]",Q3
36119,2020-05-02,967612,47,258,29884,1809,98610,317.14285714285717,1805.4285714285713,32.77582927277226,186.58600466184498,"(37.5, 52.0]",Q3
36119,2020-05-03,967612,47,213,30097,1662,100272,298.57142857142856,1790.857142857143,30.856523954997307,185.08008818174463,"(37.5, 52.0]",Q3
36119,2020-05-04,967612,47,143,30240,1225,101497,285.0,1764.7142857142858,29.45395468431561,182.37829684979988,"(37.5, 52.0]",Q3
36119,2020-05-05,967612,47,186,30426,1434,102931,257.14285714285717,1706.2857142857142,26.574996707653188,176.33986704233868,"(37.5, 52.0]",Q3
36119,2020-05-06,967612,47,282,30708,2311,105242,248.28571428571428,1773.2857142857142,25.659635709945128,183.26413007338832,"(37.5, 52.0]",Q3
36119,2020-05-07,967612,47,197,30905,2224,107466,239.0,1860.5714285714287,24.699983051057657,192.28486506693062,"(37.5, 52.0]",Q3
36119,2020-05-08,967612,47,182,31087,1936,109402,208.71428571428572,1800.142857142857,21.570038994378503,186.0397408406321,"(37.5, 52.0]",Q3
36119,2020-05-09,967612,47,207,31294,1940,111342,201.42857142857142,1818.857142857143,20.817080754328327,187.97381004546685,"(37.5, 52.0]",Q3
36119,2020-05-10,967612,47,90,31384,1321,112663,183.85714285714286,1770.142857142857,19.00112264597203,182.93932455807257,"(37.5, 52.0]",Q3
36119,2020-05-11,967612,47,88,31472,984,113647,176.0,1735.7142857142858,18.189108857682623,179.381227776659,"(37.5, 52.0]",Q3
36119,2020-05-12,967612,47,139,31611,1925,115572,169.28571428571428,1805.857142857143,17.49520616587168,186.6302963230244,"(37.5, 52.0]",Q3
36119,2020-05-13,967612,47,181,31792,2450,118022,154.85714285714286,1825.7142857142858,16.004053572831143,188.68247662433762,"(37.5, 52.0]",Q3
36119,2020-05-14,967612,47,151,31943,2024,120046,148.28571428571428,1797.142857142857,15.324914768080005,185.72969921237615,"(37.5, 52.0]",Q3
36119,2020-05-15,967612,47,154,32097,2059,122105,144.28571428571428,1814.7142857142858,14.911525930405398,187.54565732073246,"(37.5, 52.0]",Q3
36119,2020-05-16,967612,47,127,32224,1940,124045,132.85714285714286,1814.7142857142858,13.730414965620811,187.54565732073246,"(37.5, 52.0]",Q3
36119,2020-05-17,967612,47,99,32323,1326,125371,134.14285714285714,1815.4285714285713,13.863289949159077,187.61947675603147,"(37.5, 52.0]",Q3
36119,2020-05-18,967612,47,79,32402,1125,126496,132.85714285714286,1835.5714285714287,13.730414965620811,189.70118483146433,"(37.5, 52.0]",Q3
36119,2020-05-19,967612,47,115,32517,1867,128363,129.42857142857142,1827.2857142857142,13.376081676185436,188.8448793819955,"(37.5, 52.0]",Q3
36119,2020-05-20,967612,47,156,32673,2671,131034,125.85714285714286,1858.857142857143,13.006984499690255,192.10769842221293,"(37.5, 52.0]",Q3
36119,2020-05-21,967612,47,94,32767,2350,133384,117.71428571428571,1905.4285714285713,12.165442937281236,196.9207256037101,"(37.5, 52.0]",Q3
36119,2020-05-22,967612,47,114,32881,3234,136618,112.0,2073.285714285714,11.574887454888943,214.26829289898373,"(37.5, 52.0]",Q3
36119,2020-05-23,967612,47,87,32968,2542,139160,106.28571428571429,2159.285714285714,10.984331972496651,223.15615290898774,"(37.5, 52.0]",Q3
36119,2020-05-24,967612,47,81,33049,2323,141483,103.71428571428571,2301.714285714286,10.718582005420117,237.87574830761562,"(37.5, 52.0]",Q3
36119,2020-05-25,967612,47,58,33107,1695,143178,100.71428571428571,2383.1428571428573,10.408540377164163,246.29116393170585,"(37.5, 52.0]",Q3
36119,2020-05-26,967612,47,79,33186,2207,145385,95.57142857142857,2431.714285714286,9.8770404430111,251.31088553204032,"(37.5, 52.0]",Q3
36119,2020-05-27,967612,47,107,33293,3266,148651,88.57142857142857,2516.714285714286,9.153609977080542,260.0953983326256,"(37.5, 52.0]",Q3
36119,2020-05-28,967612,47,56,33349,3203,151854,83.14285714285714,2638.5714285714284,8.592582268807863,272.6889939946413,"(37.5, 52.0]",Q3
36119,2020-05-29,967612,47,80,33429,3388,155242,78.28571428571429,2660.5714285714284,8.090610108774415,274.9626326018516,"(37.5, 52.0]",Q3
36119,2020-05-30,967612,47,52,33481,3290,158532,73.28571428571429,2767.4285714285716,7.573874061681159,286.00602012258753,"(37.5, 52.0]",Q3
36119,2020-05-31,967612,47,71,33552,3376,161908,71.85714285714286,2917.8571428571427,7.4262351910830855,301.5523931965646,"(37.5, 52.0]",Q3
36119,2020-06-01,967612,47,81,33633,3183,165091,75.14285714285714,3130.4285714285716,7.765804593458653,323.52105714155795,"(37.5, 52.0]",Q3
36119,2020-06-02,967612,47,58,33691,3253,168344,72.14285714285714,3279.8571428571427,7.455762965202699,338.96408300611637,"(37.5, 52.0]",Q3
36119,2020-06-03,967612,47,76,33767,3524,171868,67.71428571428571,3316.714285714286,6.998082466348671,342.7731658675467,"(37.5, 52.0]",Q3
36119,2020-06-04,967612,47,87,33854,4216,176084,72.14285714285714,3461.4285714285716,7.455762965202699,357.7289834591315,"(37.5, 52.0]",Q3
36119,2020-06-05,967612,47,70,33924,3979,180063,70.71428571428571,3545.8571428571427,7.308124094604625,366.4544407114776,"(37.5, 52.0]",Q3
36119,2020-06-06,967612,47,30,33954,3162,183225,67.57142857142857,3527.5714285714284,6.983318579288865,364.56466316782223,"(37.5, 52.0]",Q3
36119,2020-06-07,967612,47,46,34000,3336,186561,64.0,3521.8571428571427,6.614221402793682,363.97410768542994,"(37.5, 52.0]",Q3
36121,2020-03-02,40085,23,0,0,0,0,0.0,0.0,0.0,0.0,"(3.999, 24.0]",Q1
36121,2020-03-03,40085,23,0,0,0,0,0.0,0.0,0.0,0.0,"(3.999, 24.0]",Q1
36121,2020-03-04,40085,23,0,0,0,0,0.0,0.0,0.0,0.0,"(3.999, 24.0]",Q1
36121,2020-03-05,40085,23,0,0,0,0,0.0,0.0,0.0,0.0,"(3.999, 24.0]",Q1
36121,2020-03-06,40085,23,0,0,0,0,0.0,0.0,0.0,0.0,"(3.999, 24.0]",Q1
36121,2020-03-07,40085,23,0,0,0,0,0.0,0.0,0.0,0.0,"(3.999, 24.0]",Q1
36121,2020-03-08,40085,23,0,0,0,0,0.0,0.0,0.0,0.0,"(3.999, 24.0]",Q1
36121,2020-03-09,40085,23,0,0,0,0,0.0,0.0,0.0,0.0,"(3.999, 24.0]",Q1
36121,2020-03-10,40085,23,0,0,0,0,0.0,0.0,0.0,0.0,"(3.999, 24.0]",Q1
36121,2020-03-11,40085,23,0,0,0,0,0.0,0.0,0.0,0.0,"(3.999, 24.0]",Q1
36121,2020-03-12,40085,23,0,0,0,0,0.0,0.0,0.0,0.0,"(3.999, 24.0]",Q1
36121,2020-03-13,40085,23,0,0,0,0,0.0,0.0,0.0,0.0,"(3.999, 24.0]",Q1
36121,2020-03-14,40085,23,0,0,0,0,0.0,0.0,0.0,0.0,"(3.999, 24.0]",Q1
36121,2020-03-15,40085,23,1,1,3,3,0.14285714285714285,0.42857142857142855,0.35638553787487304,1.0691566136246191,"(3.999, 24.0]",Q1
36121,2020-03-16,40085,23,0,1,0,3,0.14285714285714285,0.42857142857142855,0.35638553787487304,1.0691566136246191,"(3.999, 24.0]",Q1
36121,2020-03-17,40085,23,0,1,2,5,0.14285714285714285,0.7142857142857143,0.35638553787487304,1.7819276893743652,"(3.999, 24.0]",Q1
36121,2020-03-18,40085,23,1,2,6,11,0.2857142857142857,1.5714285714285714,0.7127710757497461,3.920240916623603,"(3.999, 24.0]",Q1
36121,2020-03-19,40085,23,0,2,3,14,0.2857142857142857,2.0,0.7127710757497461,4.9893975302482225,"(3.999, 24.0]",Q1
36121,2020-03-20,40085,23,0,2,0,14,0.2857142857142857,2.0,0.7127710757497461,4.9893975302482225,"(3.999, 24.0]",Q1
36121,2020-03-21,40085,23,0,2,4,18,0.2857142857142857,2.5714285714285716,0.7127710757497461,6.414939681747715,"(3.999, 24.0]",Q1
36121,2020-03-22,40085,23,2,4,11,29,0.42857142857142855,3.7142857142857144,1.0691566136246191,9.266023984746699,"(3.999, 24.0]",Q1
36121,2020-03-23,40085,23,0,4,8,37,0.42857142857142855,4.857142857142857,1.0691566136246191,12.117108287745681,"(3.999, 24.0]",Q1
36121,2020-03-24,40085,23,0,4,7,44,0.42857142857142855,5.571428571428571,1.0691566136246191,13.899035977120048,"(3.999, 24.0]",Q1
36121,2020-03-25,40085,23,3,7,9,53,0.7142857142857143,6.0,1.7819276893743652,14.968192590744668,"(3.999, 24.0]",Q1
36121,2020-03-26,40085,23,0,7,14,67,0.7142857142857143,7.571428571428571,1.7819276893743652,18.88843350736827,"(3.999, 24.0]",Q1
36121,2020-03-27,40085,23,0,7,15,82,0.7142857142857143,9.714285714285714,1.7819276893743652,24.234216575491363,"(3.999, 24.0]",Q1
36121,2020-03-28,40085,23,1,8,13,95,0.8571428571428571,11.0,2.1383132272492382,27.441686416365226,"(3.999, 24.0]",Q1
36121,2020-03-29,40085,23,0,8,7,102,0.5714285714285714,10.428571428571429,1.4255421514994921,26.016144264865734,"(3.999, 24.0]",Q1
36121,2020-03-30,40085,23,1,9,13,115,0.7142857142857143,11.142857142857142,1.7819276893743652,27.798071954240097,"(3.999, 24.0]",Q1
36121,2020-03-31,40085,23,1,10,10,125,0.8571428571428571,11.571428571428571,2.1383132272492382,28.867228567864714,"(3.999, 24.0]",Q1
36121,2020-04-01,40085,23,4,14,12,137,1.0,12.0,2.4946987651241113,29.936385181489335,"(3.999, 24.0]",Q1
36121,2020-04-02,40085,23,1,15,11,148,1.1428571428571428,11.571428571428571,2.8510843029989843,28.867228567864714,"(3.999, 24.0]",Q1
36121,2020-04-03,40085,23,3,18,11,159,1.5714285714285714,11.0,3.920240916623603,27.441686416365226,"(3.999, 24.0]",Q1
36121,2020-04-04,40085,23,4,22,16,175,2.0,11.428571428571429,4.9893975302482225,28.510843029989843,"(3.999, 24.0]",Q1
36121,2020-04-05,40085,23,1,23,6,181,2.142857142857143,11.285714285714286,5.345783068123096,28.154457492114968,"(3.999, 24.0]",Q1
36121,2020-04-06,40085,23,0,23,7,188,2.0,10.428571428571429,4.9893975302482225,26.016144264865734,"(3.999, 24.0]",Q1
36121,2020-04-07,40085,23,4,27,18,206,2.4285714285714284,11.571428571428571,6.058554143872841,28.867228567864714,"(3.999, 24.0]",Q1
36121,2020-04-08,40085,23,2,29,12,218,2.142857142857143,11.571428571428571,5.345783068123096,28.867228567864714,"(3.999, 24.0]",Q1
36121,2020-04-09,40085,23,1,30,13,231,2.142857142857143,11.857142857142858,5.345783068123096,29.579999643614467,"(3.999, 24.0]",Q1
36121,2020-04-10,40085,23,1,31,12,243,1.8571428571428572,12.0,4.6330119923733495,29.936385181489335,"(3.999, 24.0]",Q1
36121,2020-04-11,40085,23,0,31,2,245,1.2857142857142858,10.0,3.2074698408738573,24.946987651241116,"(3.999, 24.0]",Q1
36121,2020-04-12,40085,23,0,31,2,247,1.1428571428571428,9.428571428571429,2.8510843029989843,23.52144549974162,"(3.999, 24.0]",Q1
36121,2020-04-13,40085,23,1,32,21,268,1.2857142857142858,11.428571428571429,3.2074698408738573,28.510843029989843,"(3.999, 24.0]",Q1
36121,2020-04-14,40085,23,2,34,9,277,1.0,10.142857142857142,2.4946987651241113,25.30337318911598,"(3.999, 24.0]",Q1
36121,2020-04-15,40085,23,0,34,8,285,0.7142857142857143,9.571428571428571,1.7819276893743652,23.877831037616495,"(3.999, 24.0]",Q1
36121,2020-04-16,40085,23,1,35,11,296,0.7142857142857143,9.285714285714286,1.7819276893743652,23.16505996186675,"(3.999, 24.0]",Q1
36121,2020-04-17,40085,23,1,36,6,302,0.7142857142857143,8.428571428571429,1.7819276893743652,21.026746734617507,"(3.999, 24.0]",Q1
36121,2020-04-18,40085,23,0,36,6,308,0.7142857142857143,9.0,1.7819276893743652,22.452288886117,"(3.999, 24.0]",Q1
36121,2020-04-19,40085,23,0,36,4,312,0.7142857142857143,9.285714285714286,1.7819276893743652,23.16505996186675,"(3.999, 24.0]",Q1
36121,2020-04-20,40085,23,0,36,6,318,0.5714285714285714,7.142857142857143,1.4255421514994921,17.819276893743655,"(3.999, 24.0]",Q1
36121,2020-04-21,40085,23,4,40,14,332,0.8571428571428571,7.857142857142857,2.1383132272492382,19.601204583118015,"(3.999, 24.0]",Q1
36121,2020-04-22,40085,23,1,41,15,347,1.0,8.857142857142858,2.4946987651241113,22.09590334824213,"(3.999, 24.0]",Q1
36121,2020-04-23,40085,23,2,43,18,365,1.1428571428571428,9.857142857142858,2.8510843029989843,24.59060211336624,"(3.999, 24.0]",Q1
36121,2020-04-24,40085,23,14,57,117,482,3.0,25.714285714285715,7.484096295372334,64.14939681747715,"(3.999, 24.0]",Q1
36121,2020-04-25,40085,23,2,59,19,501,3.2857142857142856,27.571428571428573,8.19686737112208,68.78240880985051,"(3.999, 24.0]",Q1
36121,2020-04-26,40085,23,4,63,15,516,3.857142857142857,29.142857142857142,9.622409522621572,72.70264972647409,"(3.999, 24.0]",Q1
36121,2020-04-27,40085,23,0,63,9,525,3.857142857142857,29.571428571428573,9.622409522621572,73.77180634009872,"(3.999, 24.0]",Q1
36121,2020-04-28,40085,23,2,65,26,551,3.5714285714285716,31.285714285714285,8.909638446871828,78.04843279459719,"(3.999, 24.0]",Q1
36121,2020-04-29,40085,23,2,67,17,568,3.7142857142857144,31.571428571428573,9.266023984746699,78.76120387034695,"(3.999, 24.0]",Q1
36121,2020-04-30,40085,23,1,68,16,584,3.5714285714285716,31.285714285714285,8.909638446871828,78.04843279459719,"(3.999, 24.0]",Q1
36121,2020-05-01,40085,23,1,69,32,616,1.7142857142857142,19.142857142857142,4.2766264544984764,47.75566207523299,"(3.999, 24.0]",Q1
36121,2020-05-02,40085,23,0,69,15,631,1.4285714285714286,18.571428571428573,3.5638553787487304,46.3301199237335,"(3.999, 24.0]",Q1
36121,2020-05-03,40085,23,0,69,16,647,0.8571428571428571,18.714285714285715,2.1383132272492382,46.68650546160837,"(3.999, 24.0]",Q1
36121,2020-05-04,40085,23,1,70,24,671,1.0,20.857142857142858,2.4946987651241113,52.03228852973147,"(3.999, 24.0]",Q1
36121,2020-05-05,40085,23,0,70,42,713,0.7142857142857143,23.142857142857142,1.7819276893743652,57.73445713572943,"(3.999, 24.0]",Q1
36121,2020-05-06,40085,23,1,71,22,735,0.5714285714285714,23.857142857142858,1.4255421514994921,59.5163848251038,"(3.999, 24.0]",Q1
36121,2020-05-07,40085,23,2,73,130,865,0.7142857142857143,40.142857142857146,1.7819276893743652,100.14433614283934,"(3.999, 24.0]",Q1
36121,2020-05-08,40085,23,2,75,187,1052,0.8571428571428571,62.285714285714285,2.1383132272492382,155.38409451344467,"(3.999, 24.0]",Q1
36121,2020-05-09,40085,23,2,77,26,1078,1.1428571428571428,63.857142857142854,2.8510843029989843,159.30433543006825,"(3.999, 24.0]",Q1
36121,2020-05-10,40085,23,0,77,39,1117,1.1428571428571428,67.14285714285714,2.8510843029989843,167.50120280119032,"(3.999, 24.0]",Q1
36121,2020-05-11,40085,23,0,77,24,1141,1.0,67.14285714285714,2.4946987651241113,167.50120280119032,"(3.999, 24.0]",Q1
36121,2020-05-12,40085,23,0,77,63,1204,1.0,70.14285714285714,2.4946987651241113,174.98529909656264,"(3.999, 24.0]",Q1
36121,2020-05-13,40085,23,0,77,41,1245,0.8571428571428571,72.85714285714286,2.1383132272492382,181.75662431618528,"(3.999, 24.0]",Q1
36121,2020-05-14,40085,23,0,77,106,1351,0.5714285714285714,69.42857142857143,1.4255421514994921,173.2033714071883,"(3.999, 24.0]",Q1
36121,2020-05-15,40085,23,1,78,28,1379,0.42857142857142855,46.714285714285715,1.0691566136246191,116.5380708850835,"(3.999, 24.0]",Q1
36121,2020-05-16,40085,23,0,78,43,1422,0.14285714285714285,49.142857142857146,0.35638553787487304,122.59662502895634,"(3.999, 24.0]",Q1
36121,2020-05-17,40085,23,1,79,56,1478,0.2857142857142857,51.57142857142857,0.7127710757497461,128.65517917282915,"(3.999, 24.0]",Q1
36121,2020-05-18,40085,23,0,79,27,1505,0.2857142857142857,52.0,0.7127710757497461,129.7243357864538,"(3.999, 24.0]",Q1
36121,2020-05-19,40085,23,0,79,60,1565,0.2857142857142857,51.57142857142857,0.7127710757497461,128.65517917282915,"(3.999, 24.0]",Q1
36121,2020-05-20,40085,23,0,79,64,1629,0.2857142857142857,54.857142857142854,0.7127710757497461,136.85204654395125,"(3.999, 24.0]",Q1
36121,2020-05-21,40085,23,0,79,46,1675,0.2857142857142857,46.285714285714285,0.7127710757497461,115.46891427145886,"(3.999, 24.0]",Q1
36121,2020-05-22,40085,23,1,80,150,1825,0.2857142857142857,63.714285714285715,0.7127710757497461,158.94794989219338,"(3.999, 24.0]",Q1
36121,2020-05-23,40085,23,1,81,113,1938,0.42857142857142855,73.71428571428571,1.0691566136246191,183.89493754343448,"(3.999, 24.0]",Q1
36121,2020-05-24,40085,23,1,82,42,1980,0.42857142857142855,71.71428571428571,1.0691566136246191,178.90554001318625,"(3.999, 24.0]",Q1
36121,2020-05-25,40085,23,0,82,29,2009,0.42857142857142855,72.0,1.0691566136246191,179.618311088936,"(3.999, 24.0]",Q1
36121,2020-05-26,40085,23,0,82,42,2051,0.42857142857142855,69.42857142857143,1.0691566136246191,173.2033714071883,"(3.999, 24.0]",Q1
36121,2020-05-27,40085,23,0,82,77,2128,0.42857142857142855,71.28571428571429,1.0691566136246191,177.83638339956164,"(3.999, 24.0]",Q1
36121,2020-05-28,40085,23,0,82,66,2194,0.42857142857142855,74.14285714285714,1.0691566136246191,184.9640941570591,"(3.999, 24.0]",Q1
36121,2020-05-29,40085,23,2,84,90,2284,0.5714285714285714,65.57142857142857,1.4255421514994921,163.58096188456673,"(3.999, 24.0]",Q1
36121,2020-05-30,40085,23,2,86,45,2329,0.7142857142857143,55.857142857142854,1.7819276893743652,139.34674530907535,"(3.999, 24.0]",Q1
36121,2020-05-31,40085,23,0,86,85,2414,0.5714285714285714,62.0,1.4255421514994921,154.6713234376949,"(3.999, 24.0]",Q1
36121,2020-06-01,40085,23,0,86,229,2643,0.5714285714285714,90.57142857142857,1.4255421514994921,225.94843101266952,"(3.999, 24.0]",Q1
36121,2020-06-02,40085,23,1,87,91,2734,0.7142857142857143,97.57142857142857,1.7819276893743652,243.41132236853826,"(3.999, 24.0]",Q1
36121,2020-06-03,40085,23,0,87,122,2856,0.7142857142857143,104.0,1.7819276893743652,259.4486715729076,"(3.999, 24.0]",Q1
36121,2020-06-04,40085,23,1,88,67,2923,0.8571428571428571,104.14285714285714,2.1383132272492382,259.80505711078246,"(3.999, 24.0]",Q1
36121,2020-06-05,40085,23,1,89,129,3052,0.7142857142857143,109.71428571428571,1.7819276893743652,273.7040930879025,"(3.999, 24.0]",Q1
36121,2020-06-06,40085,23,0,89,124,3176,0.42857142857142855,121.0,1.0691566136246191,301.85855058001744,"(3.999, 24.0]",Q1
36121,2020-06-07,40085,23,1,90,127,3303,0.5714285714285714,127.0,1.4255421514994921,316.82674317076214,"(3.999, 24.0]",Q1
36123,2020-03-02,24841,35,0,0,0,0,0.0,0.0,0.0,0.0,"(24.0, 37.5]",Q2
36123,2020-03-03,24841,35,0,0,0,0,0.0,0.0,0.0,0.0,"(24.0, 37.5]",Q2
36123,2020-03-04,24841,35,0,0,0,0,0.0,0.0,0.0,0.0,"(24.0, 37.5]",Q2
36123,2020-03-05,24841,35,0,0,0,0,0.0,0.0,0.0,0.0,"(24.0, 37.5]",Q2
36123,2020-03-06,24841,35,0,0,0,0,0.0,0.0,0.0,0.0,"(24.0, 37.5]",Q2
36123,2020-03-07,24841,35,0,0,0,0,0.0,0.0,0.0,0.0,"(24.0, 37.5]",Q2
36123,2020-03-08,24841,35,0,0,0,0,0.0,0.0,0.0,0.0,"(24.0, 37.5]",Q2
36123,2020-03-09,24841,35,0,0,0,0,0.0,0.0,0.0,0.0,"(24.0, 37.5]",Q2
36123,2020-03-10,24841,35,0,0,0,0,0.0,0.0,0.0,0.0,"(24.0, 37.5]",Q2
36123,2020-03-11,24841,35,0,0,0,0,0.0,0.0,0.0,0.0,"(24.0, 37.5]",Q2
36123,2020-03-12,24841,35,0,0,0,0,0.0,0.0,0.0,0.0,"(24.0, 37.5]",Q2
36123,2020-03-13,24841,35,0,0,1,1,0.0,0.14285714285714285,0.0,0.5750861191463422,"(24.0, 37.5]",Q2
36123,2020-03-14,24841,35,0,0,2,3,0.0,0.42857142857142855,0.0,1.7252583574390266,"(24.0, 37.5]",Q2
36123,2020-03-15,24841,35,0,0,1,4,0.0,0.5714285714285714,0.0,2.300344476585369,"(24.0, 37.5]",Q2
36123,2020-03-16,24841,35,0,0,0,4,0.0,0.5714285714285714,0.0,2.300344476585369,"(24.0, 37.5]",Q2
36123,2020-03-17,24841,35,0,0,0,4,0.0,0.5714285714285714,0.0,2.300344476585369,"(24.0, 37.5]",Q2
36123,2020-03-18,24841,35,0,0,3,7,0.0,1.0,0.0,4.0256028340243954,"(24.0, 37.5]",Q2
36123,2020-03-19,24841,35,0,0,1,8,0.0,1.1428571428571428,0.0,4.600688953170738,"(24.0, 37.5]",Q2
36123,2020-03-20,24841,35,0,0,2,10,0.0,1.2857142857142858,0.0,5.17577507231708,"(24.0, 37.5]",Q2
36123,2020-03-21,24841,35,0,0,3,13,0.0,1.4285714285714286,0.0,5.750861191463422,"(24.0, 37.5]",Q2
36123,2020-03-22,24841,35,0,0,3,16,0.0,1.7142857142857142,0.0,6.901033429756106,"(24.0, 37.5]",Q2
36123,2020-03-23,24841,35,0,0,3,19,0.0,2.142857142857143,0.0,8.626291787195132,"(24.0, 37.5]",Q2
36123,2020-03-24,24841,35,0,0,3,22,0.0,2.5714285714285716,0.0,10.35155014463416,"(24.0, 37.5]",Q2
36123,2020-03-25,24841,35,0,0,1,23,0.0,2.2857142857142856,0.0,9.201377906341476,"(24.0, 37.5]",Q2
36123,2020-03-26,24841,35,0,0,2,25,0.0,2.4285714285714284,0.0,9.776464025487817,"(24.0, 37.5]",Q2
36123,2020-03-27,24841,35,0,0,10,35,0.0,3.5714285714285716,0.0,14.377152978658554,"(24.0, 37.5]",Q2
36123,2020-03-28,24841,35,0,0,7,42,0.0,4.142857142857143,0.0,16.677497455243923,"(24.0, 37.5]",Q2
36123,2020-03-29,24841,35,0,0,2,44,0.0,4.0,0.0,16.102411336097582,"(24.0, 37.5]",Q2
36123,2020-03-30,24841,35,0,0,3,47,0.0,4.0,0.0,16.102411336097582,"(24.0, 37.5]",Q2
36123,2020-03-31,24841,35,0,0,7,54,0.0,4.571428571428571,0.0,18.40275581268295,"(24.0, 37.5]",Q2
36123,2020-04-01,24841,35,1,1,8,62,0.14285714285714285,5.571428571428571,0.5750861191463422,22.42835864670734,"(24.0, 37.5]",Q2
36123,2020-04-02,24841,35,0,1,7,69,0.14285714285714285,6.285714285714286,0.5750861191463422,25.303789242439052,"(24.0, 37.5]",Q2
36123,2020-04-03,24841,35,0,1,3,72,0.14285714285714285,5.285714285714286,0.5750861191463422,21.27818640841466,"(24.0, 37.5]",Q2
36123,2020-04-04,24841,35,0,1,6,78,0.14285714285714285,5.142857142857143,0.5750861191463422,20.70310028926832,"(24.0, 37.5]",Q2
36123,2020-04-05,24841,35,0,1,2,80,0.14285714285714285,5.142857142857143,0.5750861191463422,20.70310028926832,"(24.0, 37.5]",Q2
36123,2020-04-06,24841,35,0,1,3,83,0.14285714285714285,5.142857142857143,0.5750861191463422,20.70310028926832,"(24.0, 37.5]",Q2
36123,2020-04-07,24841,35,0,1,5,88,0.14285714285714285,4.857142857142857,0.5750861191463422,19.552928050975634,"(24.0, 37.5]",Q2
36123,2020-04-08,24841,35,0,1,7,95,0.0,4.714285714285714,0.0,18.977841931829293,"(24.0, 37.5]",Q2
36123,2020-04-09,24841,35,1,2,3,98,0.14285714285714285,4.142857142857143,0.5750861191463422,16.677497455243923,"(24.0, 37.5]",Q2
36123,2020-04-10,24841,35,0,2,5,103,0.14285714285714285,4.428571428571429,0.5750861191463422,17.827669693536606,"(24.0, 37.5]",Q2
36123,2020-04-11,24841,35,1,3,6,109,0.2857142857142857,4.428571428571429,1.1501722382926844,17.827669693536606,"(24.0, 37.5]",Q2
36123,2020-04-12,24841,35,1,4,4,113,0.42857142857142855,4.714285714285714,1.7252583574390266,18.977841931829293,"(24.0, 37.5]",Q2
36123,2020-04-13,24841,35,2,6,5,118,0.7142857142857143,5.0,2.875430595731711,20.128014170121975,"(24.0, 37.5]",Q2
36123,2020-04-14,24841,35,0,6,5,123,0.7142857142857143,5.0,2.875430595731711,20.128014170121975,"(24.0, 37.5]",Q2
36123,2020-04-15,24841,35,1,7,2,125,0.8571428571428571,4.285714285714286,3.450516714878053,17.252583574390265,"(24.0, 37.5]",Q2
36123,2020-04-16,24841,35,1,8,10,135,0.8571428571428571,5.285714285714286,3.450516714878053,21.27818640841466,"(24.0, 37.5]",Q2
36123,2020-04-17,24841,35,1,9,28,163,1.0,8.571428571428571,4.0256028340243954,34.50516714878053,"(24.0, 37.5]",Q2
36123,2020-04-18,24841,35,0,9,2,165,0.8571428571428571,8.0,3.450516714878053,32.204822672195164,"(24.0, 37.5]",Q2
36123,2020-04-19,24841,35,1,10,13,178,0.8571428571428571,9.285714285714286,3.450516714878053,37.380597744512244,"(24.0, 37.5]",Q2
36123,2020-04-20,24841,35,0,10,1,179,0.5714285714285714,8.714285714285714,2.300344476585369,35.08025326792687,"(24.0, 37.5]",Q2
36123,2020-04-21,24841,35,1,11,1,180,0.7142857142857143,8.142857142857142,2.875430595731711,32.779908791341505,"(24.0, 37.5]",Q2
36123,2020-04-22,24841,35,0,11,8,188,0.5714285714285714,9.0,2.300344476585369,36.23042550621956,"(24.0, 37.5]",Q2
36123,2020-04-23,24841,35,0,11,5,193,0.42857142857142855,8.285714285714286,1.7252583574390266,33.35499491048785,"(24.0, 37.5]",Q2
36123,2020-04-24,24841,35,5,16,41,234,1.0,10.142857142857142,4.0256028340243954,40.83111445939029,"(24.0, 37.5]",Q2
36123,2020-04-25,24841,35,1,17,4,238,1.1428571428571428,10.428571428571429,4.600688953170738,41.981286697682975,"(24.0, 37.5]",Q2
36123,2020-04-26,24841,35,0,17,3,241,1.0,9.0,4.0256028340243954,36.23042550621956,"(24.0, 37.5]",Q2
36123,2020-04-27,24841,35,0,17,3,244,1.0,9.285714285714286,4.0256028340243954,37.380597744512244,"(24.0, 37.5]",Q2
36123,2020-04-28,24841,35,0,17,8,252,0.8571428571428571,10.285714285714286,3.450516714878053,41.40620057853664,"(24.0, 37.5]",Q2
36123,2020-04-29,24841,35,1,18,10,262,1.0,10.571428571428571,4.0256028340243954,42.55637281682932,"(24.0, 37.5]",Q2
36123,2020-04-30,24841,35,0,18,12,274,1.0,11.571428571428571,4.0256028340243954,46.581975650853714,"(24.0, 37.5]",Q2
36123,2020-05-01,24841,35,0,18,13,287,0.2857142857142857,7.571428571428571,1.1501722382926844,30.479564314756132,"(24.0, 37.5]",Q2
36123,2020-05-02,24841,35,1,19,23,310,0.2857142857142857,10.285714285714286,1.1501722382926844,41.40620057853664,"(24.0, 37.5]",Q2
36123,2020-05-03,24841,35,0,19,9,319,0.2857142857142857,11.142857142857142,1.1501722382926844,44.85671729341468,"(24.0, 37.5]",Q2
36123,2020-05-04,24841,35,0,19,7,326,0.2857142857142857,11.714285714285714,1.1501722382926844,47.157061770000055,"(24.0, 37.5]",Q2
36123,2020-05-05,24841,35,0,19,13,339,0.2857142857142857,12.428571428571429,1.1501722382926844,50.03249236573178,"(24.0, 37.5]",Q2
36123,2020-05-06,24841,35,0,19,13,352,0.14285714285714285,12.857142857142858,0.5750861191463422,51.7577507231708,"(24.0, 37.5]",Q2
36123,2020-05-07,24841,35,1,20,12,364,0.2857142857142857,12.857142857142858,1.1501722382926844,51.7577507231708,"(24.0, 37.5]",Q2
36123,2020-05-08,24841,35,0,20,24,388,0.2857142857142857,14.428571428571429,1.1501722382926844,58.08369803378056,"(24.0, 37.5]",Q2
36123,2020-05-09,24841,35,1,21,27,415,0.2857142857142857,15.0,1.1501722382926844,60.38404251036593,"(24.0, 37.5]",Q2
36123,2020-05-10,24841,35,0,21,15,430,0.2857142857142857,15.857142857142858,1.1501722382926844,63.83455922524398,"(24.0, 37.5]",Q2
36123,2020-05-11,24841,35,0,21,15,445,0.2857142857142857,17.0,1.1501722382926844,68.43524817841471,"(24.0, 37.5]",Q2
36123,2020-05-12,24841,35,1,22,23,468,0.42857142857142855,18.428571428571427,1.7252583574390266,74.18610936987812,"(24.0, 37.5]",Q2
36123,2020-05-13,24841,35,0,22,51,519,0.42857142857142855,23.857142857142858,1.7252583574390266,96.03938189743914,"(24.0, 37.5]",Q2
36123,2020-05-14,24841,35,0,22,16,535,0.2857142857142857,24.428571428571427,1.1501722382926844,98.33972637402451,"(24.0, 37.5]",Q2
36123,2020-05-15,24841,35,0,22,15,550,0.2857142857142857,23.142857142857142,1.1501722382926844,93.16395130170743,"(24.0, 37.5]",Q2
36123,2020-05-16,24841,35,1,23,14,564,0.2857142857142857,21.285714285714285,1.1501722382926844,85.68783175280498,"(24.0, 37.5]",Q2
36123,2020-05-17,24841,35,2,25,22,586,0.5714285714285714,22.285714285714285,2.300344476585369,89.71343458682937,"(24.0, 37.5]",Q2
36123,2020-05-18,24841,35,1,26,25,611,0.7142857142857143,23.714285714285715,2.875430595731711,95.46429577829281,"(24.0, 37.5]",Q2
36123,2020-05-19,24841,35,8,34,67,678,1.7142857142857142,30.0,6.901033429756106,120.76808502073186,"(24.0, 37.5]",Q2
36123,2020-05-20,24841,35,0,34,62,740,1.7142857142857142,31.571428571428573,6.901033429756106,127.09403233134164,"(24.0, 37.5]",Q2
36123,2020-05-21,24841,35,0,34,107,847,1.7142857142857142,44.57142857142857,6.901033429756106,179.42686917365873,"(24.0, 37.5]",Q2
36123,2020-05-22,24841,35,3,37,22,869,2.142857142857143,45.57142857142857,8.626291787195132,183.45247200768316,"(24.0, 37.5]",Q2
36123,2020-05-23,24841,35,0,37,58,927,2.0,51.857142857142854,8.051205668048791,208.75626125012218,"(24.0, 37.5]",Q2
36123,2020-05-24,24841,35,0,37,28,955,1.7142857142857142,52.714285714285715,6.901033429756106,212.20677796500027,"(24.0, 37.5]",Q2
36123,2020-05-25,24841,35,0,37,67,1022,1.5714285714285714,58.714285714285715,6.325947310609763,236.36039496914663,"(24.0, 37.5]",Q2
36123,2020-05-26,24841,35,2,39,28,1050,0.7142857142857143,53.142857142857146,2.875430595731711,213.9320363224393,"(24.0, 37.5]",Q2
36123,2020-05-27,24841,35,0,39,50,1100,0.7142857142857143,51.42857142857143,2.875430595731711,207.0310028926832,"(24.0, 37.5]",Q2
36123,2020-05-28,24841,35,0,39,130,1230,0.7142857142857143,54.714285714285715,2.875430595731711,220.25798363304907,"(24.0, 37.5]",Q2
36123,2020-05-29,24841,35,0,39,31,1261,0.2857142857142857,56.0,1.1501722382926844,225.43375870536613,"(24.0, 37.5]",Q2
36123,2020-05-30,24841,35,0,39,87,1348,0.2857142857142857,60.142857142857146,1.1501722382926844,242.11125616061005,"(24.0, 37.5]",Q2
36123,2020-05-31,24841,35,0,39,77,1425,0.2857142857142857,67.14285714285714,1.1501722382926844,270.2904759987808,"(24.0, 37.5]",Q2
36123,2020-06-01,24841,35,0,39,48,1473,0.2857142857142857,64.42857142857143,1.1501722382926844,259.36383973500034,"(24.0, 37.5]",Q2
36123,2020-06-02,24841,35,0,39,108,1581,0.0,75.85714285714286,0.0,305.3707292667077,"(24.0, 37.5]",Q2
36123,2020-06-03,24841,35,0,39,78,1659,0.0,79.85714285714286,0.0,321.4731406028053,"(24.0, 37.5]",Q2
36123,2020-06-04,24841,35,0,39,113,1772,0.0,77.42857142857143,0.0,311.6966765773175,"(24.0, 37.5]",Q2
36123,2020-06-05,24841,35,0,39,109,1881,0.0,88.57142857142857,0.0,356.5533938707321,"(24.0, 37.5]",Q2
36123,2020-06-06,24841,35,0,39,73,1954,0.0,86.57142857142857,0.0,348.5021882026833,"(24.0, 37.5]",Q2
36123,2020-06-07,24841,35,0,39,110,2064,0.0,91.28571428571429,0.0,367.4800301345127,"(24.0, 37.5]",Q2
